TrainA,TrainB,TrainC,TrainHC,Crews,Crew Wages,Demurrage Fees,Total Cost
20,8,17,-1,2,246000,15000,261000
13,12,19,-1,2,270000,60000,330000
13,8,12,-1,2,264000,75000,339000
8,11,7,-1,2,261000,90000,351000
10,7,13,12,2,270000,345000,615000
18,20,17,-1,2,189000,90000,279000
5,15,20,-1,2,225000,15000,240000
12,19,6,-1,2,234000,15000,249000
17,18,14,-1,2,201000,90000,291000
11,10,8,-1,2,243000,45000,288000
8,19,6,-1,2,201000,15000,216000
14,12,17,11,2,231000,45000,276000
13,9,9,-1,2,189000,15000,204000
11,10,10,-1,2,168000,30000,198000
6,12,15,-1,2,222000,30000,252000
15,5,16,-1,2,231000,30000,261000
11,12,20,-1,2,240000,45000,285000
15,18,5,-1,2,237000,15000,252000
11,19,17,13,2,267000,220000,487000
16,13,17,-1,2,213000,90000,303000
5,9,19,-1,2,255000,30000,285000
18,5,20,-1,2,201000,15000,216000
15,16,11,-1,2,255000,75000,330000
17,15,7,-1,2,237000,15000,252000
11,10,15,-1,2,261000,60000,321000
18,11,17,11,2,279000,245000,524000
11,20,15,-1,2,180000,15000,195000
12,10,9,-1,2,279000,105000,384000
10,17,9,-1,2,240000,45000,285000
10,13,6,-1,2,255000,45000,300000
16,8,11,-1,2,240000,45000,285000
6,18,10,-1,2,207000,15000,222000
13,7,15,13,2,234000,160000,394000
15,10,9,-1,2,279000,60000,339000
8,5,11,-1,2,258000,45000,303000
6,11,5,-1,2,252000,60000,312000
5,12,18,-1,2,207000,15000,222000
17,14,12,-1,2,222000,45000,267000
14,7,9,-1,2,276000,45000,321000
6,20,5,11,2,282000,190000,472000
18,16,7,-1,2,228000,15000,243000
17,8,12,-1,2,252000,30000,282000
5,7,12,-1,2,258000,45000,303000
19,10,12,-1,2,210000,30000,240000
12,16,19,-1,2,219000,45000,264000
5,10,17,-1,2,252000,15000,267000
11,14,19,13,2,249000,265000,514000
19,7,13,-1,2,207000,15000,222000
5,15,10,-1,2,270000,30000,300000
16,14,15,-1,2,198000,90000,288000
6,18,12,-1,2,252000,15000,267000
13,11,12,-1,2,252000,90000,342000
19,5,7,-1,2,228000,15000,243000
19,12,10,11,2,300000,205000,505000
9,11,14,-1,2,285000,45000,330000
16,11,14,-1,2,222000,75000,297000
17,19,8,-1,2,219000,15000,234000
15,8,14,-1,2,261000,45000,306000
11,14,5,-1,2,258000,30000,288000
18,10,8,-1,2,201000,15000,216000
10,9,16,13,2,294000,355000,649000
14,5,12,-1,2,228000,15000,243000
14,17,12,-1,2,204000,45000,249000
11,20,14,-1,2,237000,30000,267000
6,20,19,-1,2,210000,30000,240000
16,19,15,-1,2,201000,30000,231000
12,15,6,-1,2,267000,30000,297000
8,13,19,12,2,270000,235000,505000
20,15,7,-1,2,189000,15000,204000
5,18,13,-1,2,243000,15000,258000
14,10,16,-1,2,228000,45000,273000
6,8,12,-1,2,267000,45000,312000
20,13,9,-1,2,171000,15000,186000
18,16,14,-1,2,240000,75000,315000
17,15,16,12,2,231000,90000,321000
17,8,16,-1,2,204000,30000,234000
20,7,15,-1,2,225000,15000,240000
18,5,19,-1,2,222000,30000,252000
17,15,14,-1,2,252000,105000,357000
6,19,20,-1,2,219000,30000,249000
15,16,12,-1,2,216000,45000,261000
19,13,11,12,2,279000,235000,514000
20,16,19,-1,2,156000,45000,201000
12,15,17,-1,2,213000,75000,288000
19,9,12,-1,2,264000,30000,294000
19,16,20,-1,2,159000,75000,234000
18,20,18,-1,2,138000,15000,153000
18,10,11,-1,2,276000,45000,321000
19,13,16,11,2,222000,45000,267000
10,19,17,-1,2,240000,30000,270000
17,20,19,-1,2,168000,75000,243000
7,18,8,-1,2,249000,30000,279000
19,18,5,-1,2,213000,30000,243000
12,18,5,-1,2,252000,15000,267000
6,10,19,-1,2,225000,15000,240000
6,10,13,11,2,309000,360000,669000
5,19,6,-1,2,270000,45000,315000
15,6,5,-1,2,258000,30000,288000
20,9,13,-1,2,180000,15000,195000
13,12,19,-1,2,270000,60000,330000
6,11,5,-1,2,288000,60000,348000
14,7,8,-1,2,252000,60000,312000
13,6,19,13,2,207000,155000,362000
13,7,5,-1,2,273000,30000,303000
7,15,5,-1,2,219000,15000,234000
16,13,20,-1,2,204000,45000,249000
10,20,9,-1,2,249000,30000,279000
14,19,15,-1,2,243000,60000,303000
19,10,11,-1,2,276000,45000,321000
19,7,18,13,2,258000,245000,503000
17,16,19,-1,2,174000,105000,279000
13,19,16,-1,2,213000,45000,258000
13,5,11,-1,2,291000,45000,336000
15,5,6,-1,2,231000,30000,261000
20,14,17,-1,2,183000,45000,228000
14,20,17,-1,2,174000,30000,204000
13,10,7,11,2,285000,315000,600000
13,11,17,-1,2,249000,45000,294000
20,12,8,-1,2,207000,15000,222000
15,12,19,-1,2,249000,45000,294000
8,16,6,-1,2,255000,15000,270000
16,7,6,-1,2,240000,30000,270000
7,8,20,-1,2,222000,30000,252000
9,12,11,12,2,261000,240000,501000
16,13,17,-1,2,222000,90000,312000
14,10,13,-1,2,276000,90000,366000
10,18,6,-1,2,225000,15000,240000
17,15,18,-1,2,192000,90000,282000
5,10,13,-1,2,237000,15000,252000
18,10,16,-1,2,186000,30000,216000
14,16,8,13,2,276000,280000,556000
17,5,12,-1,2,225000,15000,240000
11,20,8,-1,2,210000,15000,225000
8,5,7,-1,2,285000,90000,375000
8,20,12,-1,2,180000,15000,195000
19,13,12,-1,2,261000,60000,321000
12,17,19,-1,2,228000,45000,273000
16,13,9,11,2,318000,250000,568000
13,8,14,-1,2,282000,75000,357000
10,16,9,-1,2,252000,60000,312000
5,19,20,-1,2,174000,30000,204000
5,19,11,-1,1,189000,0,189000
7,13,10,-1,2,276000,45000,321000
5,19,9,-1,2,198000,15000,213000
11,8,10,11,2,261000,240000,501000
13,17,18,-1,2,201000,75000,276000
8,16,19,-1,2,246000,15000,261000
15,9,17,-1,2,240000,30000,270000
9,13,18,-1,2,243000,30000,273000
15,19,9,-1,2,210000,30000,240000
16,10,20,-1,2,219000,30000,249000
19,6,14,12,2,306000,220000,526000
12,13,11,-1,2,237000,45000,282000
10,12,9,-1,2,252000,105000,357000
16,14,13,-1,2,216000,105000,321000
19,14,15,-1,2,243000,60000,303000
9,16,20,-1,2,237000,30000,267000
7,15,12,-1,2,282000,45000,327000
7,13,16,11,2,273000,250000,523000
15,20,17,-1,2,219000,45000,264000
15,9,8,-1,2,243000,15000,258000
13,9,19,-1,2,207000,30000,237000
10,18,12,-1,2,237000,30000,267000
18,9,13,-1,2,234000,30000,264000
20,9,6,-1,2,228000,15000,243000
19,7,16,13,2,267000,235000,502000
11,17,9,-1,2,237000,30000,267000
15,17,18,-1,2,183000,90000,273000
15,12,18,-1,2,204000,30000,234000
15,19,16,-1,2,213000,90000,303000
17,16,10,-1,2,204000,30000,234000
16,17,12,-1,2,228000,75000,303000
12,10,16,11,2,318000,265000,583000
9,17,8,-1,2,294000,45000,339000
5,12,16,-1,2,228000,30000,258000
16,15,12,-1,2,213000,90000,303000
16,14,17,-1,2,231000,90000,321000
6,9,7,-1,2,306000,105000,411000
9,17,14,-1,2,219000,45000,264000
16,5,6,13,2,300000,185000,485000
17,8,6,-1,2,246000,15000,261000
12,18,19,-1,2,186000,45000,231000
17,7,19,-1,2,183000,15000,198000
17,16,7,-1,2,249000,30000,279000
13,19,6,-1,2,234000,15000,249000
6,18,10,-1,2,225000,15000,240000
9,20,6,13,2,294000,205000,499000
15,17,7,-1,2,255000,15000,270000
18,7,5,-1,2,237000,15000,252000
20,5,7,-1,2,210000,15000,225000
10,8,16,-1,2,264000,30000,294000
11,20,19,-1,2,174000,30000,204000
19,14,17,-1,2,186000,30000,216000
6,12,14,13,2,285000,360000,645000
10,12,8,-1,2,258000,75000,333000
19,20,6,-1,2,165000,30000,195000
20,11,16,-1,2,180000,15000,195000
7,13,14,-1,2,270000,45000,315000
18,12,8,-1,2,234000,30000,264000
18,20,7,-1,2,192000,15000,207000
15,6,17,13,2,285000,250000,535000
16,6,12,-1,2,228000,30000,258000
8,16,12,-1,2,246000,45000,291000
7,18,15,-1,2,210000,15000,225000
8,14,6,-1,2,273000,30000,303000
13,10,6,-1,2,237000,45000,282000
7,18,10,-1,2,201000,15000,216000
11,7,12,13,2,297000,400000,697000
14,12,17,-1,2,204000,30000,234000
13,19,7,-1,2,225000,15000,240000
5,9,13,-1,2,273000,45000,318000
13,16,7,-1,2,213000,30000,243000
9,15,6,-1,2,273000,30000,303000
12,20,19,-1,2,156000,45000,201000
14,16,19,11,2,195000,45000,240000
19,9,10,-1,2,249000,30000,279000
13,18,8,-1,2,261000,30000,291000
13,15,16,-1,2,213000,90000,303000
9,8,17,-1,2,285000,45000,330000
8,17,10,-1,2,237000,30000,267000
16,9,5,-1,2,216000,15000,231000
7,6,20,11,2,291000,190000,481000
9,16,8,-1,2,285000,45000,330000
17,9,20,-1,2,192000,15000,207000
14,11,19,-1,2,267000,45000,312000
10,12,15,-1,2,258000,45000,303000
10,14,11,-1,2,252000,90000,342000
19,18,8,-1,2,204000,30000,234000
5,15,17,11,2,327000,220000,547000
14,5,9,-1,2,291000,45000,336000
9,5,14,-1,2,234000,30000,264000
9,7,12,-1,2,240000,45000,285000
15,11,9,-1,2,231000,45000,276000
15,16,10,-1,2,219000,75000,294000
17,6,15,-1,2,228000,15000,243000
7,12,20,13,2,267000,300000,567000
19,18,6,-1,2,204000,30000,234000
8,7,20,-1,2,258000,30000,288000
7,12,16,-1,2,261000,30000,291000
8,15,6,-1,2,246000,30000,276000
13,6,16,-1,2,222000,30000,252000
5,9,17,-1,2,225000,15000,240000
12,14,9,13,2,258000,360000,618000
19,16,18,-1,2,162000,90000,252000
20,17,15,-1,2,183000,45000,228000
11,15,18,-1,2,201000,15000,216000
11,18,17,-1,2,225000,45000,270000
13,14,16,-1,2,261000,105000,366000
13,11,19,-1,2,246000,30000,276000
9,8,14,13,2,303000,280000,583000
11,9,12,-1,2,285000,90000,375000
20,13,7,-1,2,198000,15000,213000
13,5,11,-1,2,267000,30000,297000
13,7,14,-1,2,225000,45000,270000
10,20,15,-1,2,216000,30000,246000
12,9,14,-1,2,267000,75000,342000
18,11,19,11,2,267000,200000,467000
20,14,7,-1,1,162000,0,162000
14,16,7,-1,2,267000,30000,297000
11,13,12,-1,2,243000,90000,333000
17,10,6,-1,2,225000,15000,240000
6,14,16,-1,2,237000,15000,252000
19,20,10,-1,2,183000,30000,213000
18,13,19,12,2,186000,30000,216000
11,9,7,-1,2,294000,75000,369000
11,15,13,-1,2,213000,75000,288000
12,14,19,-1,2,231000,45000,276000
15,18,11,-1,2,237000,45000,282000
10,15,5,-1,2,270000,30000,300000
8,20,17,-1,2,183000,15000,198000
6,16,10,12,2,324000,315000,639000
8,7,5,-1,2,297000,120000,417000
8,7,17,-1,2,213000,30000,243000
5,8,13,-1,2,276000,45000,321000
19,6,17,-1,2,183000,15000,198000
17,5,10,-1,2,252000,15000,267000
10,14,9,-1,2,261000,60000,321000
20,10,16,12,2,261000,160000,421000
16,13,20,-1,2,183000,30000,213000
11,8,6,-1,2,285000,45000,330000
7,13,11,-1,2,237000,45000,282000
7,17,10,-1,2,237000,30000,267000
15,17,14,-1,2,207000,105000,312000
16,15,19,-1,2,231000,90000,321000
15,19,20,12,2,165000,30000,195000
8,20,19,-1,2,165000,30000,195000
16,7,19,-1,2,192000,15000,207000
14,7,6,-1,2,294000,45000,339000
10,14,15,-1,2,210000,75000,285000
11,8,5,-1,2,276000,45000,321000
18,20,13,-1,2,171000,45000,216000
7,15,11,13,2,264000,200000,464000
6,11,16,-1,2,279000,30000,309000
16,6,20,-1,2,180000,15000,195000
15,13,9,-1,2,264000,45000,309000
8,11,8,-1,2,183000,15000,198000
11,16,9,-1,2,231000,45000,276000
10,16,19,-1,2,195000,30000,225000
6,11,15,12,2,315000,345000,660000
6,18,11,-1,1,189000,0,189000
11,15,20,-1,2,216000,30000,246000
8,17,9,-1,2,285000,45000,330000
7,16,15,-1,2,222000,30000,252000
13,9,6,-1,2,276000,45000,321000
14,18,10,-1,2,210000,45000,255000
12,5,13,11,2,300000,255000,555000
15,11,14,-1,2,267000,90000,357000
17,18,12,-1,2,228000,75000,303000
17,8,20,-1,2,228000,15000,243000
18,19,14,-1,2,216000,75000,291000
11,6,17,-1,1,189000,0,189000
14,20,12,-1,2,219000,30000,249000
7,9,18,11,2,324000,285000,609000
19,13,7,-1,2,234000,15000,249000
20,5,17,-1,2,219000,15000,234000
20,5,18,-1,2,228000,15000,243000
6,9,17,-1,2,264000,15000,279000
14,11,16,-1,2,240000,75000,315000
19,13,10,-1,2,246000,30000,276000
19,8,5,12,2,312000,205000,517000
12,14,16,-1,2,249000,75000,324000
8,15,11,-1,2,276000,45000,321000
11,12,9,-1,2,240000,90000,330000
18,14,20,-1,2,171000,45000,216000
17,9,18,-1,2,195000,30000,225000
5,17,10,-1,2,252000,15000,267000
14,18,20,11,2,180000,45000,225000
18,16,9,-1,2,192000,15000,207000
12,15,14,-1,2,240000,90000,330000
15,5,19,-1,2,225000,15000,240000
8,9,5,-1,2,285000,90000,375000
18,6,7,-1,2,222000,30000,252000
7,18,8,-1,2,231000,30000,261000
9,18,13,11,2,300000,220000,520000
15,12,8,-1,2,282000,45000,327000
17,6,11,-1,2,207000,15000,222000
10,13,16,-1,2,249000,45000,294000
16,5,6,-1,2,258000,30000,288000
9,8,7,-1,2,261000,90000,351000
20,10,5,-1,2,189000,15000,204000
13,7,8,12,2,312000,280000,592000
8,6,7,-1,2,297000,90000,387000
15,8,10,-1,2,240000,45000,285000
5,13,10,-1,2,237000,45000,282000
9,13,10,-1,2,243000,90000,333000
18,11,12,-1,2,234000,60000,294000
8,20,18,-1,2,201000,15000,216000
16,5,12,11,2,327000,265000,592000
18,17,8,-1,2,249000,30000,279000
18,20,5,-1,2,219000,15000,234000
16,15,12,-1,2,258000,90000,348000
8,7,20,-1,2,249000,30000,279000
14,9,7,-1,2,276000,45000,321000
8,19,20,-1,2,165000,30000,195000
17,19,6,11,2,285000,170000,455000
13,17,20,-1,2,219000,45000,264000
15,7,20,-1,2,243000,15000,258000
7,19,5,-1,2,237000,15000,252000
8,17,16,-1,2,231000,30000,261000
20,17,16,-1,2,192000,90000,282000
8,6,5,-1,2,270000,105000,375000
5,8,15,11,2,288000,340000,628000
6,7,17,-1,2,267000,30000,297000
13,12,10,-1,2,240000,90000,330000
5,10,19,-1,2,216000,15000,231000
16,5,9,-1,2,234000,15000,249000
20,14,6,-1,1,180000,0,180000
9,14,5,-1,2,291000,45000,336000
10,14,7,13,2,258000,370000,628000
9,13,20,-1,1,171000,0,171000
10,9,15,-1,2,288000,60000,348000
8,20,14,-1,2,189000,15000,204000
20,13,9,-1,2,216000,15000,231000
20,8,11,-1,2,246000,15000,261000
13,16,13,-1,2,192000,15000,207000
16,20,17,12,2,174000,90000,264000
17,8,14,-1,2,222000,30000,252000
20,11,5,-1,1,207000,0,207000
8,6,10,-1,2,285000,75000,360000
12,10,6,-1,2,237000,45000,282000
17,5,12,-1,2,207000,15000,222000
10,18,20,-1,2,192000,15000,207000
8,16,9,12,2,333000,340000,673000
20,12,15,-1,2,258000,45000,303000
14,19,17,-1,2,219000,75000,294000
5,14,6,-1,2,234000,0,234000
8,15,9,-1,2,252000,60000,312000
5,16,12,-1,2,219000,30000,249000
14,13,12,-1,2,225000,90000,315000
14,16,5,11,2,309000,235000,544000
18,9,7,-1,2,255000,15000,270000
9,19,16,-1,2,222000,30000,252000
20,14,15,-1,2,243000,60000,303000
15,13,20,-1,2,249000,45000,294000
14,17,20,-1,2,219000,45000,264000
6,19,18,-1,2,186000,30000,216000
8,14,12,11,2,327000,280000,607000
16,17,5,-1,2,258000,30000,288000
14,15,18,-1,2,234000,90000,324000
17,16,15,-1,2,231000,90000,321000
6,8,19,-1,1,189000,0,189000
6,16,17,-1,2,231000,30000,261000
16,14,10,-1,2,246000,45000,291000
14,15,20,11,2,225000,60000,285000
12,7,13,-1,2,291000,75000,366000
18,13,19,-1,2,171000,75000,246000
16,15,18,-1,2,192000,30000,222000
17,10,19,-1,2,231000,30000,261000
13,9,5,-1,2,282000,45000,327000
16,15,17,-1,2,177000,90000,267000
20,16,7,11,2,273000,155000,428000
10,13,19,-1,2,255000,30000,285000
6,19,12,-1,2,234000,15000,249000
11,5,13,-1,2,258000,30000,288000
9,7,6,-1,2,252000,105000,357000
13,17,15,-1,2,195000,75000,270000
17,5,18,-1,2,240000,30000,270000
20,17,11,13,2,276000,190000,466000
20,10,9,-1,2,213000,30000,243000
12,20,9,-1,2,228000,15000,243000
5,19,11,-1,2,252000,15000,267000
19,6,13,-1,2,225000,15000,240000
11,9,6,-1,2,276000,75000,351000
9,16,18,-1,2,195000,30000,225000
5,6,8,12,2,342000,215000,557000
17,15,17,-1,2,147000,15000,162000
6,20,17,-1,2,210000,15000,225000
9,20,17,-1,2,237000,15000,252000
11,10,16,-1,2,288000,60000,348000
12,6,19,-1,2,216000,15000,231000
17,11,9,-1,2,246000,30000,276000
10,17,9,13,2,276000,340000,616000
5,6,18,-1,2,216000,0,216000
19,13,20,-1,2,165000,45000,210000
13,12,20,-1,2,222000,45000,267000
20,13,12,-1,2,249000,45000,294000
15,7,13,-1,2,258000,30000,288000
8,10,12,-1,2,258000,75000,333000
16,11,8,13,2,249000,330000,579000
19,15,16,-1,2,201000,30000,231000
15,6,12,-1,2,267000,30000,297000
10,20,11,-1,2,204000,30000,234000
13,16,8,-1,2,282000,45000,327000
9,13,5,-1,2,246000,45000,291000
18,13,6,-1,2,198000,15000,213000
5,18,15,12,2,279000,235000,514000
16,5,15,-1,2,213000,30000,243000
6,7,13,-1,2,279000,60000,339000
14,20,7,-1,2,189000,15000,204000
9,8,13,-1,2,288000,60000,348000
14,6,12,-1,2,222000,30000,252000
16,10,5,-1,2,216000,15000,231000
6,11,17,13,2,267000,315000,582000
20,8,13,-1,1,171000,0,171000
6,14,17,-1,2,255000,15000,270000
14,16,18,-1,2,213000,75000,288000
17,19,7,-1,2,237000,15000,252000
9,7,13,-1,2,285000,45000,330000
15,12,17,-1,2,204000,75000,279000
11,16,19,13,2,276000,235000,511000
13,7,10,-1,2,267000,45000,312000
18,10,17,-1,2,198000,45000,243000
13,17,14,-1,2,252000,90000,342000
16,13,20,-1,2,240000,45000,285000
8,15,12,-1,2,282000,45000,327000
13,14,16,-1,2,216000,105000,321000
18,7,5,11,2,330000,205000,535000
6,15,14,-1,2,258000,30000,288000
5,19,20,-1,2,183000,30000,213000
14,12,6,-1,2,228000,15000,243000
20,19,15,-1,2,141000,75000,216000
6,9,18,-1,2,228000,15000,243000
11,17,18,-1,2,216000,45000,261000
19,14,11,13,2,285000,265000,550000
17,18,13,-1,2,201000,75000,276000
5,11,15,-1,2,288000,30000,318000
18,17,10,-1,2,198000,45000,243000
15,19,6,-1,2,234000,15000,249000
15,10,20,-1,2,234000,30000,264000
17,20,12,-1,2,228000,45000,273000
14,11,15,12,2,297000,225000,522000
16,7,14,-1,2,210000,15000,225000
11,7,16,-1,2,243000,30000,273000
17,20,8,-1,2,192000,15000,207000
16,17,13,-1,2,249000,90000,339000
10,8,12,-1,2,294000,75000,369000
12,7,6,-1,2,252000,60000,312000
6,19,12,11,2,273000,205000,478000
13,10,5,-1,2,291000,45000,336000
12,20,7,-1,2,189000,15000,204000
18,8,7,-1,2,249000,30000,279000
18,9,8,-1,2,231000,30000,261000
5,6,8,-1,2,288000,105000,393000
17,13,10,-1,2,222000,45000,267000
12,16,18,13,2,258000,235000,493000
16,7,10,-1,2,255000,30000,285000
8,14,18,-1,2,201000,30000,231000
15,16,12,-1,2,240000,90000,330000
5,7,18,-1,2,255000,15000,270000
7,9,12,-1,2,258000,45000,303000
5,11,12,-1,2,243000,45000,288000
19,8,17,11,2,261000,215000,476000
17,19,16,-1,2,183000,30000,213000
7,19,20,-1,2,219000,30000,249000
11,13,16,-1,2,213000,30000,243000
14,5,17,-1,2,237000,15000,252000
5,10,15,-1,2,261000,30000,291000
6,16,9,-1,2,246000,30000,276000
20,9,17,13,2,231000,190000,421000
13,15,6,-1,2,240000,30000,270000
6,12,7,-1,2,261000,60000,321000
16,12,11,-1,2,225000,60000,285000
19,13,15,-1,2,222000,45000,267000
8,10,20,-1,2,237000,15000,252000
6,16,12,-1,2,246000,30000,276000
6,15,16,13,2,249000,225000,474000
7,9,16,-1,2,255000,30000,285000
17,15,7,-1,2,201000,15000,216000
14,8,6,-1,2,264000,30000,294000
6,14,18,-1,2,198000,15000,213000
13,15,11,-1,2,240000,75000,315000
11,8,18,-1,2,255000,30000,285000
10,20,7,11,2,300000,270000,570000
5,17,12,-1,2,264000,30000,294000
13,10,13,-1,2,183000,15000,198000
8,18,13,-1,2,216000,30000,246000
8,20,16,-1,2,198000,15000,213000
9,5,14,-1,2,279000,30000,309000
20,16,7,-1,2,180000,15000,195000
10,13,5,11,2,327000,360000,687000
9,6,10,-1,2,303000,90000,393000
11,5,8,-1,2,249000,45000,294000
12,18,6,-1,2,198000,15000,213000
6,9,12,-1,2,276000,45000,321000
16,16,12,-1,2,144000,15000,159000
20,13,10,-1,2,219000,30000,249000
15,12,5,11,2,309000,265000,574000
19,16,11,-1,2,255000,45000,300000
11,20,19,-1,2,201000,30000,231000
8,17,14,-1,2,210000,15000,225000
19,15,8,-1,2,219000,30000,249000
11,7,6,-1,2,288000,60000,348000
5,14,5,-1,1,144000,0,144000
8,20,10,13,2,258000,295000,553000
20,13,18,-1,2,174000,15000,189000
12,7,13,-1,2,291000,75000,366000
8,9,11,-1,2,252000,105000,357000
8,9,7,-1,2,252000,90000,342000
19,17,15,-1,2,165000,75000,240000
5,18,11,-1,1,189000,0,189000
19,15,10,12,2,279000,205000,484000
6,7,11,-1,2,246000,30000,276000
11,12,5,-1,2,243000,45000,288000
12,5,16,-1,2,219000,30000,249000
8,14,7,-1,2,261000,60000,321000
9,7,8,-1,2,252000,90000,342000
11,5,7,-1,2,240000,45000,285000
12,16,18,11,2,192000,45000,237000
19,5,6,-1,2,258000,30000,288000
11,17,13,-1,2,240000,45000,285000
6,16,13,-1,2,249000,30000,279000
13,9,20,-1,2,189000,15000,204000
12,7,18,-1,2,243000,15000,258000
19,7,15,-1,2,225000,15000,240000
15,6,16,11,2,309000,220000,529000
10,8,14,-1,2,294000,45000,339000
13,10,12,-1,2,222000,90000,312000
11,14,6,-1,2,255000,45000,300000
14,8,15,-1,2,216000,45000,261000
14,20,13,-1,2,234000,60000,294000
19,11,6,-1,2,243000,15000,258000
9,13,12,12,2,243000,175000,418000
17,6,5,-1,2,258000,30000,288000
8,5,17,-1,2,228000,15000,243000
11,18,20,-1,2,183000,30000,213000
15,7,9,-1,2,216000,15000,231000
15,17,9,-1,2,195000,30000,225000
10,15,16,-1,2,246000,75000,321000
8,13,9,11,2,306000,345000,651000
10,6,17,-1,2,243000,15000,258000
8,20,16,-1,2,207000,15000,222000
15,18,10,-1,2,255000,45000,300000
12,5,18,-1,2,234000,15000,249000
13,7,12,-1,2,255000,75000,330000
15,19,13,-1,2,195000,45000,240000
19,15,18,13,2,198000,90000,288000
19,13,20,-1,2,165000,45000,210000
5,13,11,-1,2,249000,30000,279000
20,18,10,-1,2,174000,15000,189000
12,14,15,-1,2,258000,90000,348000
6,8,16,-1,2,246000,15000,261000
5,20,9,-1,2,207000,15000,222000
10,6,18,11,2,318000,300000,618000
5,16,20,-1,2,234000,15000,249000
19,9,14,-1,2,252000,30000,282000
16,9,7,-1,2,264000,30000,294000
7,20,19,-1,2,165000,30000,195000
9,10,8,-1,2,246000,45000,291000
12,15,13,-1,2,216000,105000,321000
11,16,6,12,2,297000,330000,627000
12,6,20,-1,1,180000,0,180000
18,9,10,-1,2,267000,45000,312000
11,9,17,-1,2,237000,30000,267000
9,18,14,-1,2,225000,30000,255000
9,17,20,-1,2,210000,15000,225000
14,13,5,-1,2,288000,45000,333000
14,11,10,13,2,258000,345000,603000
17,8,6,-1,1,198000,0,198000
11,17,18,-1,2,207000,45000,252000
14,6,19,-1,2,252000,15000,267000
10,13,14,-1,2,249000,90000,339000
13,10,14,-1,2,249000,90000,339000
18,5,8,-1,2,246000,15000,261000
10,5,6,13,2,312000,215000,527000
16,9,16,-1,1,162000,0,162000
6,18,12,-1,2,207000,15000,222000
20,16,17,-1,2,183000,90000,273000
19,14,7,-1,2,207000,15000,222000
19,7,13,-1,2,225000,15000,240000
12,10,16,-1,2,258000,45000,303000
6,5,17,11,2,312000,180000,492000
14,11,13,-1,2,240000,90000,330000
12,7,13,-1,2,264000,75000,339000
17,18,11,-1,2,189000,45000,234000
14,19,11,-1,2,267000,45000,312000
12,8,6,-1,2,276000,45000,321000
10,14,13,-1,2,222000,90000,312000
6,19,5,11,2,309000,190000,499000
17,5,13,-1,2,243000,15000,258000
5,8,6,-1,2,270000,105000,375000
19,16,10,-1,2,186000,30000,216000
6,11,5,-1,2,309000,75000,384000
12,11,19,-1,2,213000,45000,258000
17,20,16,-1,2,192000,90000,282000
20,17,18,13,2,153000,90000,243000
10,8,18,-1,2,228000,15000,243000
7,14,16,-1,2,249000,30000,279000
19,10,9,-1,2,213000,30000,243000
13,14,7,-1,2,270000,45000,315000
10,9,7,-1,2,258000,90000,348000
5,13,17,-1,2,207000,15000,222000
14,13,19,11,2,225000,60000,285000
15,14,9,-1,2,264000,75000,339000
20,5,7,-1,2,210000,15000,225000
12,20,6,-1,1,198000,0,198000
15,13,8,-1,2,282000,45000,327000
18,12,14,-1,2,213000,45000,258000
15,10,16,-1,2,246000,75000,321000
17,16,7,11,2,300000,245000,545000
19,5,17,-1,2,237000,15000,252000
12,15,19,-1,2,249000,45000,294000
5,8,15,-1,2,291000,30000,321000
11,19,9,-1,2,183000,15000,198000
13,11,5,-1,2,276000,30000,306000
5,10,6,-1,2,252000,60000,312000
19,5,7,11,2,285000,205000,490000
14,19,13,-1,2,243000,60000,303000
13,19,14,-1,2,252000,60000,312000
8,7,13,-1,2,297000,60000,357000
5,9,20,-1,2,189000,15000,204000
15,16,8,-1,2,252000,45000,297000
19,8,12,-1,2,207000,15000,222000
10,12,9,11,2,327000,360000,687000
10,5,16,-1,2,288000,30000,318000
14,16,13,-1,2,207000,105000,312000
5,11,12,-1,2,288000,45000,333000
16,11,9,-1,2,231000,45000,276000
10,16,5,-1,2,216000,15000,231000
14,17,19,-1,2,192000,75000,267000
19,18,9,12,2,276000,185000,461000
17,15,16,-1,2,222000,90000,312000
20,10,5,-1,1,180000,0,180000
18,12,9,-1,2,255000,30000,285000
19,5,14,-1,2,225000,15000,240000
8,6,12,-1,2,267000,45000,312000
10,19,12,-1,2,210000,30000,240000
11,10,14,13,2,276000,345000,621000
10,14,19,-1,2,198000,15000,213000
14,15,12,-1,2,231000,90000,321000
12,15,18,-1,2,240000,45000,285000
13,17,5,-1,2,252000,15000,267000
15,11,8,-1,2,258000,45000,303000
13,16,15,-1,2,204000,90000,294000
16,17,14,13,2,231000,90000,321000
14,20,17,-1,2,228000,45000,273000
6,20,14,-1,1,162000,0,162000
9,18,9,-1,1,180000,0,180000
10,20,17,-1,2,192000,30000,222000
5,14,10,-1,2,216000,15000,231000
17,11,18,-1,2,189000,45000,234000
10,16,18,13,2,285000,235000,520000
9,18,7,-1,2,219000,15000,234000
16,17,8,-1,2,231000,30000,261000
7,15,12,-1,2,273000,45000,318000
17,9,7,-1,2,201000,15000,216000
18,16,13,-1,2,222000,75000,297000
20,12,13,-1,2,258000,45000,303000
9,8,17,12,2,324000,325000,649000
10,9,12,-1,2,297000,105000,402000
9,14,20,-1,2,180000,15000,195000
8,10,9,-1,2,306000,90000,396000
5,15,11,-1,2,219000,30000,249000
12,13,17,-1,2,225000,60000,285000
19,11,9,-1,2,219000,15000,234000
5,6,14,12,2,327000,200000,527000
15,19,16,-1,2,213000,90000,303000
13,18,17,-1,2,195000,30000,225000
18,20,10,-1,2,219000,15000,234000
6,16,20,-1,2,234000,15000,249000
16,20,19,-1,2,177000,75000,252000
8,16,7,-1,2,285000,45000,330000
7,15,8,13,2,276000,265000,541000
18,16,19,-1,2,189000,90000,279000
14,7,10,-1,2,267000,45000,312000
20,15,11,-1,2,189000,30000,219000
11,15,12,-1,2,270000,90000,360000
7,12,11,-1,2,264000,75000,339000
20,11,7,-1,2,189000,15000,204000
8,9,18,12,2,315000,310000,625000
14,8,19,-1,2,246000,30000,276000
7,10,6,-1,2,288000,90000,378000
12,9,14,-1,2,231000,75000,306000
15,9,17,-1,2,213000,30000,243000
10,13,15,-1,2,258000,75000,333000
18,14,17,-1,2,201000,90000,291000
20,10,8,12,2,270000,165000,435000
14,8,9,-1,2,297000,60000,357000
20,11,19,-1,2,165000,30000,195000
15,5,19,-1,2,189000,15000,204000
9,16,15,-1,2,243000,45000,288000
16,6,12,-1,2,246000,30000,276000
17,15,7,-1,2,219000,15000,234000
5,17,19,11,2,288000,215000,503000
12,8,15,-1,2,219000,15000,234000
20,6,11,-1,2,198000,15000,213000
15,11,5,-1,2,255000,30000,285000
14,8,10,-1,2,249000,45000,294000
13,16,17,-1,2,195000,90000,285000
16,19,5,-1,2,246000,15000,261000
6,12,13,11,2,318000,255000,573000
16,11,5,-1,2,288000,30000,318000
15,17,9,-1,2,195000,30000,225000
19,14,8,-1,2,228000,30000,258000
13,15,10,-1,2,258000,75000,333000
8,10,16,-1,2,255000,30000,285000
11,15,20,-1,2,198000,30000,228000
18,14,13,12,2,252000,60000,312000
10,16,8,-1,2,273000,30000,303000
15,18,7,-1,2,210000,15000,225000
14,18,20,-1,2,198000,45000,243000
12,16,20,-1,2,180000,15000,195000
7,16,15,-1,2,258000,30000,288000
8,20,15,-1,2,207000,15000,222000
9,14,15,12,2,297000,225000,522000
5,8,11,-1,2,240000,30000,270000
11,18,12,-1,2,225000,60000,285000
19,7,13,-1,2,216000,15000,231000
7,10,8,-1,2,288000,105000,393000
8,19,12,-1,2,180000,15000,195000
7,13,15,-1,2,258000,30000,288000
14,7,16,13,2,249000,280000,529000
8,17,16,-1,2,222000,30000,252000
12,10,6,-1,2,273000,45000,318000
13,18,6,-1,2,198000,15000,213000
12,16,14,-1,2,231000,75000,306000
13,12,14,-1,2,252000,90000,342000
5,12,10,-1,2,273000,45000,318000
9,7,8,13,2,300000,310000,610000
6,11,6,-1,2,189000,15000,204000
17,6,15,-1,2,201000,15000,216000
7,6,15,-1,2,276000,45000,321000
10,5,9,-1,2,237000,75000,312000
20,12,11,-1,2,213000,45000,258000
12,14,9,-1,2,267000,75000,342000
16,14,8,11,2,291000,235000,526000
10,17,20,-1,2,228000,30000,258000
7,10,15,-1,2,216000,15000,231000
19,7,8,-1,2,213000,30000,243000
17,18,19,-1,2,162000,75000,237000
8,15,9,-1,2,288000,60000,348000
15,11,10,-1,2,234000,60000,294000
10,19,9,12,2,288000,285000,573000
5,13,19,-1,2,252000,15000,267000
5,16,10,-1,2,234000,15000,249000
16,12,11,-1,2,243000,60000,303000
6,5,9,-1,2,279000,90000,369000
11,16,6,-1,2,234000,30000,264000
19,12,20,-1,2,156000,45000,201000
11,17,8,12,2,270000,315000,585000
20,12,6,-1,1,180000,0,180000
10,20,7,-1,2,237000,15000,252000
18,7,10,-1,2,237000,15000,252000
7,9,13,-1,2,276000,45000,321000
12,19,14,-1,2,204000,45000,249000
18,7,14,-1,2,237000,30000,267000
13,7,14,12,2,279000,255000,534000
10,13,16,-1,2,222000,30000,252000
11,15,8,-1,2,258000,45000,303000
5,9,16,-1,2,216000,15000,231000
6,8,17,-1,2,228000,15000,243000
20,19,5,-1,2,183000,30000,213000
13,5,6,-1,2,234000,0,234000
7,20,12,11,2,273000,205000,478000
7,14,17,-1,2,267000,30000,297000
13,11,5,-1,2,258000,30000,288000
11,15,20,-1,2,189000,30000,219000
16,20,9,-1,2,228000,30000,258000
13,16,7,-1,2,258000,30000,288000
6,14,9,-1,2,276000,45000,321000
10,6,14,13,2,258000,370000,628000
5,7,14,-1,2,225000,15000,240000
10,20,10,-1,1,108000,0,108000
13,17,6,-1,2,246000,30000,276000
12,14,9,-1,2,249000,75000,324000
15,20,14,-1,2,216000,60000,276000
13,18,19,-1,2,225000,75000,300000
10,18,6,12,2,273000,180000,453000
7,11,8,-1,2,288000,90000,378000
13,7,18,-1,2,201000,30000,231000
15,19,7,-1,2,216000,15000,231000
8,6,18,-1,2,246000,15000,261000
15,16,10,-1,2,228000,75000,303000
12,13,7,-1,2,264000,75000,339000
6,12,9,13,2,279000,295000,574000
14,9,7,-1,2,294000,45000,339000
17,20,11,-1,2,165000,30000,195000
7,15,9,-1,2,225000,15000,240000
15,10,9,-1,2,243000,60000,303000
11,18,8,-1,2,237000,30000,267000
6,7,14,-1,2,267000,45000,312000
6,10,8,13,2,288000,295000,583000
8,7,18,-1,2,249000,30000,279000
13,18,11,-1,2,240000,45000,285000
11,7,18,-1,2,216000,15000,231000
8,6,14,-1,2,273000,30000,303000
15,13,14,-1,2,207000,90000,297000
15,12,7,-1,2,282000,45000,327000
13,6,19,11,2,273000,190000,463000
15,18,8,-1,2,258000,30000,288000
10,16,7,-1,2,273000,30000,303000
13,5,12,-1,2,252000,45000,297000
20,10,12,-1,2,174000,15000,189000
14,6,5,-1,2,306000,60000,366000
17,7,5,-1,2,219000,15000,234000
17,14,11,11,2,282000,235000,517000
12,15,18,-1,2,258000,45000,303000
15,19,7,-1,2,234000,15000,249000
8,19,7,-1,2,249000,30000,279000
6,12,7,-1,2,279000,60000,339000
18,8,10,-1,2,192000,15000,207000
14,11,5,-1,2,267000,30000,297000
6,18,7,11,2,294000,205000,499000
6,12,17,-1,2,246000,30000,276000
10,17,16,-1,2,216000,45000,261000
12,13,20,-1,2,249000,45000,294000
12,9,7,-1,2,285000,45000,330000
11,13,10,-1,2,234000,105000,339000
15,18,11,-1,2,219000,45000,264000
11,12,15,13,2,276000,360000,636000
13,9,11,-1,2,249000,75000,324000
13,20,8,-1,2,189000,15000,204000
19,8,11,-1,2,237000,15000,252000
17,10,6,-1,2,243000,15000,258000
19,7,18,-1,2,213000,30000,243000
9,15,18,-1,2,249000,30000,279000
20,7,5,12,2,318000,190000,508000
19,20,5,-1,2,210000,30000,240000
7,6,5,-1,2,246000,45000,291000
5,15,17,-1,2,201000,15000,216000
5,16,20,-1,2,207000,15000,222000
19,5,13,-1,1,216000,0,216000
19,5,9,-1,2,243000,15000,258000
11,16,10,13,2,276000,330000,606000
9,13,11,-1,2,231000,30000,261000
19,5,11,-1,1,171000,0,171000
14,20,10,-1,2,243000,30000,273000
14,5,13,-1,2,267000,30000,297000
19,16,8,-1,2,201000,15000,216000
10,5,17,-1,2,252000,15000,267000
9,17,12,11,2,291000,265000,556000
13,18,7,-1,2,255000,30000,285000
11,19,12,-1,2,240000,45000,285000
7,11,16,-1,2,261000,30000,291000
14,5,13,-1,2,240000,30000,270000
17,9,7,-1,2,210000,15000,225000
20,14,13,-1,2,234000,60000,294000
19,17,20,11,2,168000,75000,243000
17,19,16,-1,2,192000,105000,297000
20,7,12,-1,2,207000,15000,222000
14,12,11,-1,2,261000,105000,366000
17,9,12,-1,2,258000,45000,303000
8,15,11,-1,2,258000,45000,303000
10,11,5,-1,2,246000,75000,321000
16,17,19,12,2,156000,105000,261000
7,12,17,-1,2,243000,30000,273000
5,11,14,-1,2,240000,30000,270000
7,16,17,-1,2,213000,30000,243000
17,5,12,-1,2,243000,15000,258000
14,15,19,-1,2,216000,60000,276000
13,18,20,-1,2,225000,45000,270000
6,18,17,13,2,258000,175000,433000
11,10,7,-1,2,303000,90000,393000
19,10,6,-1,2,198000,15000,213000
6,11,17,-1,2,225000,15000,240000
18,16,20,-1,2,171000,75000,246000
10,17,7,-1,2,255000,30000,285000
6,15,19,-1,2,198000,15000,213000
19,9,11,13,2,285000,300000,585000
13,14,12,-1,2,228000,45000,273000
9,5,13,-1,2,255000,45000,300000
12,11,13,-1,2,225000,90000,315000
7,14,18,-1,2,228000,30000,258000
6,12,11,-1,2,264000,75000,339000
18,19,15,-1,2,153000,90000,243000
5,13,8,12,2,294000,280000,574000
9,9,17,-1,1,180000,0,180000
8,13,19,-1,2,189000,15000,204000
6,12,5,-1,2,297000,60000,357000
14,9,7,-1,2,240000,45000,285000
14,6,11,-1,2,237000,45000,282000
6,5,17,-1,2,231000,30000,261000
12,10,8,11,2,291000,360000,651000
10,18,14,-1,2,264000,45000,309000
19,17,20,-1,2,150000,75000,225000
9,20,14,-1,2,207000,15000,222000
16,18,8,-1,2,246000,15000,261000
8,20,7,-1,2,240000,30000,270000
6,20,15,-1,2,225000,15000,240000
14,20,9,12,2,288000,190000,478000
20,11,17,-1,2,183000,15000,198000
12,17,18,-1,2,246000,75000,321000
14,17,15,-1,2,243000,105000,348000
15,6,14,-1,2,276000,30000,306000
11,18,19,-1,2,195000,45000,240000
18,10,19,-1,2,177000,30000,207000
14,20,17,12,2,228000,45000,273000
7,10,16,-1,2,225000,15000,240000
9,12,8,-1,2,252000,90000,342000
19,10,6,-1,2,198000,15000,213000
10,7,14,-1,2,276000,45000,321000
12,10,14,-1,2,222000,75000,297000
6,10,13,-1,2,255000,45000,300000
13,14,16,12,2,207000,105000,312000
20,14,8,-1,2,225000,15000,240000
13,5,19,-1,1,216000,0,216000
7,10,14,-1,2,294000,45000,339000
20,16,11,-1,2,189000,30000,219000
20,6,16,-1,2,225000,15000,240000
12,17,13,-1,2,261000,60000,321000
9,6,10,13,2,327000,300000,627000
8,11,6,-1,2,285000,45000,330000
5,17,11,-1,2,207000,15000,222000
9,15,10,-1,2,261000,60000,321000
5,14,11,-1,2,240000,30000,270000
7,10,9,-1,2,249000,90000,339000
15,14,19,-1,2,198000,60000,258000
18,13,11,13,2,261000,155000,416000
19,8,12,-1,2,216000,15000,231000
18,18,15,-1,2,174000,15000,189000
6,14,5,-1,2,285000,45000,330000
7,19,20,-1,2,165000,30000,195000
9,8,8,-1,2,162000,0,162000
15,16,19,-1,2,177000,90000,267000
13,10,9,12,2,282000,240000,522000
20,14,11,-1,2,237000,30000,267000
9,5,20,-1,2,234000,15000,249000
15,9,17,-1,2,231000,30000,261000
18,19,7,-1,2,222000,30000,252000
15,18,6,-1,2,255000,15000,270000
13,8,16,-1,2,264000,45000,309000
9,13,5,11,2,288000,345000,633000
9,5,15,-1,2,279000,30000,309000
10,17,7,-1,2,237000,30000,267000
12,17,14,-1,2,213000,45000,258000
17,11,5,-1,2,243000,15000,258000
6,5,10,-1,2,270000,60000,330000
5,20,18,-1,2,174000,15000,189000
5,17,19,11,2,315000,215000,530000
10,13,20,-1,1,153000,0,153000
16,13,19,-1,2,249000,45000,294000
6,17,15,-1,2,255000,15000,270000
19,16,17,-1,2,183000,105000,288000
17,15,18,-1,2,183000,90000,273000
18,10,8,-1,1,180000,0,180000
11,17,6,13,2,285000,315000,600000
15,13,16,-1,2,207000,45000,252000
20,15,11,-1,2,225000,30000,255000
6,15,13,-1,2,267000,30000,297000
20,17,14,-1,2,183000,45000,228000
9,15,5,-1,1,207000,0,207000
18,11,10,-1,2,231000,45000,276000
18,16,11,12,2,279000,220000,499000
6,14,11,-1,2,237000,15000,252000
11,8,13,-1,2,240000,75000,315000
18,11,16,-1,2,210000,45000,255000
20,19,18,-1,2,150000,60000,210000
18,5,16,-1,2,246000,15000,261000
19,14,18,-1,2,198000,75000,273000
19,5,17,11,2,285000,170000,455000
11,18,5,-1,2,243000,15000,258000
13,16,17,-1,2,213000,90000,303000
11,12,10,-1,2,288000,90000,378000
5,11,10,-1,2,255000,75000,330000
13,10,12,-1,2,222000,90000,312000
15,9,14,-1,2,237000,75000,312000
14,9,13,11,2,291000,225000,516000
9,14,13,-1,2,273000,75000,348000
14,17,18,-1,2,192000,90000,282000
14,19,5,-1,2,198000,15000,213000
18,7,16,-1,2,219000,15000,234000
19,6,8,-1,2,237000,15000,252000
10,17,12,-1,2,249000,45000,294000
10,15,8,11,2,300000,330000,630000
5,10,6,-1,2,309000,105000,414000
10,19,20,-1,2,165000,30000,195000
9,13,15,-1,2,219000,15000,234000
19,9,16,-1,2,204000,30000,234000
19,7,15,-1,2,234000,15000,249000
13,17,9,-1,2,255000,45000,300000
13,7,17,11,2,291000,250000,541000
10,8,17,-1,2,282000,30000,312000
13,5,15,-1,2,228000,15000,243000
11,13,12,-1,2,234000,90000,324000
11,5,6,-1,2,279000,60000,339000
17,20,14,-1,2,174000,45000,219000
6,8,13,-1,2,228000,30000,258000
19,18,13,11,2,171000,75000,246000
7,20,14,-1,1,153000,0,153000
7,5,10,-1,2,297000,90000,387000
15,13,18,-1,2,195000,45000,240000
20,11,18,-1,2,210000,30000,240000
20,14,15,-1,2,189000,15000,204000
13,12,20,-1,2,249000,45000,294000
8,13,18,12,2,297000,265000,562000
16,5,9,-1,1,207000,0,207000
16,20,12,-1,2,201000,45000,246000
20,8,14,-1,2,225000,15000,240000
10,14,5,-1,2,279000,30000,309000
19,9,14,-1,2,207000,30000,237000
5,9,18,-1,2,234000,15000,249000
17,12,16,11,2,210000,75000,285000
5,20,17,-1,2,228000,15000,243000
14,20,5,-1,1,216000,0,216000
9,18,15,-1,2,249000,30000,279000
12,14,16,-1,2,249000,75000,324000
13,11,12,-1,2,261000,90000,351000
19,6,13,-1,2,225000,15000,240000
10,16,18,11,2,300000,215000,515000
15,16,14,-1,2,252000,90000,342000
6,8,16,-1,2,264000,15000,279000
10,17,8,-1,2,246000,30000,276000
15,18,5,-1,2,210000,15000,225000
9,14,8,-1,2,288000,60000,348000
5,12,17,-1,2,207000,15000,222000
10,17,9,11,2,300000,315000,615000
11,18,16,-1,2,255000,45000,300000
16,17,11,-1,2,237000,75000,312000
15,7,16,-1,2,249000,30000,279000
17,6,11,-1,2,225000,15000,240000
19,12,7,-1,2,216000,15000,231000
9,14,11,-1,2,267000,45000,312000
5,14,16,11,2,282000,235000,517000
12,10,15,-1,2,276000,45000,321000
11,8,14,-1,2,258000,45000,303000
20,16,14,-1,2,195000,45000,240000
6,17,13,-1,2,264000,30000,294000
18,12,11,-1,2,243000,60000,303000
5,10,12,-1,2,264000,45000,309000
20,17,15,12,2,165000,45000,210000
20,7,8,-1,2,198000,0,198000
6,11,16,-1,2,270000,30000,300000
11,18,20,-1,2,165000,30000,195000
13,19,18,-1,2,177000,30000,207000
8,14,18,-1,2,246000,30000,276000
11,5,10,-1,2,273000,75000,348000
11,16,15,13,2,231000,225000,456000
5,8,7,-1,2,258000,90000,348000
19,7,14,-1,2,189000,15000,204000
6,7,13,-1,2,288000,60000,348000
18,7,11,-1,2,189000,15000,204000
19,20,7,-1,2,201000,30000,231000
18,20,14,-1,2,174000,15000,189000
16,10,9,13,2,312000,355000,667000
13,15,12,-1,2,228000,30000,258000
11,18,20,-1,2,183000,30000,213000
18,17,10,-1,2,186000,30000,216000
12,5,16,-1,2,264000,30000,294000
18,7,20,-1,2,183000,15000,198000
12,7,19,-1,2,243000,15000,258000
5,7,11,12,2,321000,285000,606000
10,20,9,-1,2,231000,30000,261000
13,17,16,-1,2,240000,90000,330000
18,19,14,-1,2,216000,75000,291000
18,5,14,-1,2,198000,15000,213000
20,19,16,-1,2,159000,75000,234000
7,19,11,-1,2,225000,15000,240000
19,10,8,11,2,318000,270000,588000
17,18,11,-1,2,243000,45000,288000
19,17,13,-1,2,237000,45000,282000
17,8,19,-1,2,237000,15000,252000
18,17,14,-1,2,219000,90000,309000
5,10,8,-1,2,231000,30000,261000
7,18,16,-1,2,192000,15000,207000
7,8,12,13,2,312000,285000,597000
19,13,8,-1,2,225000,15000,240000
11,19,14,-1,2,258000,45000,303000
17,18,17,-1,2,159000,30000,189000
17,9,7,-1,2,246000,15000,261000
11,5,7,-1,2,267000,45000,312000
13,8,11,-1,2,240000,75000,315000
18,10,12,11,2,282000,235000,517000
19,14,5,-1,2,252000,15000,267000
15,18,12,-1,2,231000,45000,276000
6,7,11,-1,2,297000,60000,357000
10,15,10,-1,2,153000,15000,168000
14,18,10,-1,2,210000,45000,255000
10,14,13,-1,2,249000,90000,339000
12,9,10,12,2,249000,240000,489000
7,11,6,-1,2,270000,60000,330000
12,8,11,-1,2,240000,90000,330000
5,6,6,-1,2,177000,30000,207000
6,9,16,-1,2,246000,30000,276000
13,16,12,-1,2,216000,90000,306000
10,20,5,-1,2,225000,15000,240000
17,19,14,11,2,210000,75000,285000
20,14,12,-1,2,180000,15000,195000
20,5,19,-1,2,210000,30000,240000
15,18,16,-1,2,201000,30000,231000
5,12,15,-1,2,276000,30000,306000
17,13,14,-1,2,216000,90000,306000
14,12,15,-1,2,249000,90000,339000
7,19,14,11,2,309000,175000,484000
16,18,17,-1,2,210000,90000,300000
14,18,16,-1,2,204000,75000,279000
16,18,19,-1,2,198000,90000,288000
5,19,17,-1,2,201000,15000,216000
12,19,5,-1,1,216000,0,216000
8,18,17,-1,2,240000,30000,270000
13,6,11,13,2,258000,240000,498000
12,10,6,-1,2,264000,45000,309000
18,7,20,-1,2,174000,15000,189000
12,6,20,-1,1,216000,0,216000
10,12,17,-1,2,276000,45000,321000
17,20,13,-1,2,201000,45000,246000
11,19,18,-1,2,231000,45000,276000
16,15,14,13,2,201000,45000,246000
9,7,8,-1,2,288000,90000,378000
15,11,17,-1,2,201000,45000,246000
7,15,18,-1,2,237000,15000,252000
19,9,18,-1,2,222000,30000,252000
11,15,10,-1,2,288000,60000,348000
19,18,5,-1,2,204000,30000,234000
18,9,19,12,2,294000,245000,539000
15,6,9,-1,2,255000,30000,285000
10,14,15,-1,2,210000,75000,285000
13,10,17,-1,2,249000,45000,294000
7,10,20,-1,2,228000,15000,243000
16,8,10,-1,2,264000,30000,294000
13,5,20,-1,1,180000,0,180000
13,6,12,11,2,318000,255000,573000
20,10,8,-1,2,246000,15000,261000
14,6,15,-1,2,258000,30000,288000
17,20,11,-1,2,183000,30000,213000
17,9,12,-1,2,207000,15000,222000
14,16,19,-1,2,204000,45000,249000
14,12,6,-1,2,276000,30000,306000
9,14,6,13,2,276000,280000,556000
16,17,8,-1,2,258000,30000,288000
19,16,8,-1,2,228000,15000,243000
6,5,7,-1,2,297000,90000,387000
20,8,18,-1,2,174000,15000,189000
20,10,8,-1,2,246000,15000,261000
20,9,19,-1,2,201000,30000,231000
13,6,8,13,2,231000,125000,356000
12,16,8,-1,2,228000,45000,273000
7,19,17,-1,2,192000,15000,207000
10,17,12,-1,2,267000,45000,312000
12,14,17,-1,2,222000,45000,267000
6,12,9,-1,2,285000,45000,330000
5,7,19,-1,2,201000,15000,216000
15,12,16,11,2,231000,90000,321000
16,18,15,-1,2,222000,105000,327000
11,9,16,-1,2,219000,30000,249000
14,20,19,-1,2,159000,75000,234000
15,5,10,-1,2,243000,30000,273000
19,11,14,-1,2,213000,45000,258000
9,10,16,-1,2,279000,60000,339000
9,13,20,13,2,204000,140000,344000
5,12,16,-1,2,264000,30000,294000
20,6,11,-1,2,198000,15000,213000
6,12,15,-1,2,258000,30000,288000
11,6,5,-1,2,270000,60000,330000
19,16,20,-1,2,132000,75000,207000
16,17,12,-1,2,228000,75000,303000
9,8,18,12,2,324000,310000,634000
14,9,5,-1,2,291000,45000,336000
16,19,5,-1,2,192000,15000,207000
5,8,9,-1,2,294000,90000,384000
11,10,18,-1,2,222000,45000,267000
5,12,14,-1,2,258000,30000,288000
5,8,11,-1,2,249000,45000,294000
17,14,8,12,2,252000,250000,502000
12,17,6,-1,2,216000,15000,231000
10,12,11,-1,2,243000,90000,333000
13,20,6,-1,1,180000,0,180000
6,5,20,-1,2,261000,45000,306000
18,16,19,-1,2,180000,90000,270000
13,18,15,-1,2,213000,45000,258000
13,14,12,11,2,261000,90000,351000
14,10,11,-1,2,270000,90000,360000
18,5,7,-1,2,228000,15000,243000
17,11,13,-1,2,231000,45000,276000
16,5,13,-1,2,246000,15000,261000
9,18,17,-1,2,213000,30000,243000
16,6,20,-1,2,225000,15000,240000
20,16,11,12,2,297000,160000,457000
12,19,5,-1,1,180000,0,180000
19,7,6,-1,2,249000,30000,279000
20,6,12,-1,1,189000,0,189000
8,13,16,-1,2,282000,45000,327000
17,9,6,-1,2,219000,15000,234000
14,5,8,-1,2,273000,30000,303000
12,6,10,13,2,270000,295000,565000
19,20,16,-1,2,186000,75000,261000
8,12,20,-1,2,216000,15000,231000
17,12,6,-1,2,255000,30000,285000
15,17,18,-1,2,183000,90000,273000
19,7,8,-1,2,207000,0,207000
13,18,15,-1,2,222000,45000,267000
9,12,6,11,2,324000,345000,669000
5,16,10,-1,2,252000,15000,267000
15,13,17,-1,2,213000,75000,288000
15,10,12,-1,2,267000,45000,312000
13,10,11,-1,2,252000,105000,357000
10,12,18,-1,2,228000,30000,258000
20,17,8,-1,2,210000,15000,225000
5,15,8,12,2,330000,225000,555000
12,20,10,-1,2,219000,15000,234000
12,8,9,-1,2,306000,90000,396000
8,12,7,-1,2,252000,60000,312000
19,10,14,-1,2,198000,30000,228000
16,7,12,-1,2,261000,30000,291000
14,19,13,-1,2,216000,60000,276000
17,6,5,12,2,327000,155000,482000
16,14,10,-1,2,246000,45000,291000
17,15,14,-1,2,225000,105000,330000
5,14,8,-1,2,303000,45000,348000
17,9,6,-1,2,210000,15000,225000
14,12,5,-1,2,258000,30000,288000
20,5,12,-1,1,171000,0,171000
18,7,14,12,2,297000,250000,547000
19,20,10,-1,2,165000,30000,195000
18,12,7,-1,1,180000,0,180000
13,5,9,-1,2,273000,45000,318000
10,15,8,-1,2,240000,45000,285000
16,13,15,-1,2,195000,90000,285000
18,11,13,-1,2,258000,45000,303000
17,11,6,12,2,288000,315000,603000
15,6,13,-1,2,219000,15000,234000
13,17,9,-1,2,228000,45000,273000
5,8,20,-1,2,219000,15000,234000
19,15,10,-1,2,234000,30000,264000
11,5,15,-1,2,255000,30000,285000
7,9,18,-1,2,210000,15000,225000
18,17,15,11,2,192000,90000,282000
14,11,6,-1,2,237000,15000,252000
7,18,16,-1,2,192000,15000,207000
7,14,5,-1,2,273000,30000,303000
6,17,20,-1,2,183000,15000,198000
20,12,18,-1,2,210000,30000,240000
16,12,18,-1,2,192000,15000,207000
19,7,6,11,2,321000,205000,526000
6,18,7,-1,2,258000,30000,288000
17,6,10,-1,2,216000,15000,231000
5,13,18,-1,2,234000,15000,249000
11,15,13,-1,2,231000,75000,306000
20,11,12,-1,2,240000,45000,285000
19,10,9,-1,2,231000,30000,261000
8,15,19,12,2,297000,205000,502000
6,5,10,-1,2,246000,30000,276000
11,7,19,-1,2,189000,15000,204000
13,9,20,-1,2,207000,15000,222000
12,17,14,-1,2,258000,45000,303000
10,6,17,-1,2,234000,15000,249000
15,10,9,-1,2,270000,60000,330000
16,14,17,11,2,195000,90000,285000
16,10,8,-1,2,282000,30000,312000
13,12,14,-1,2,225000,90000,315000
5,11,15,-1,2,255000,30000,285000
8,10,15,-1,2,249000,45000,294000
17,5,9,-1,2,207000,15000,222000
17,13,14,-1,2,225000,90000,315000
7,12,10,11,2,327000,360000,687000
8,16,9,-1,2,294000,45000,339000
5,16,14,-1,2,219000,15000,234000
7,18,11,-1,2,207000,15000,222000
7,12,11,-1,2,273000,75000,348000
10,15,5,-1,2,234000,30000,264000
6,19,7,-1,2,213000,30000,243000
11,15,7,13,2,276000,345000,621000
7,12,16,-1,2,216000,15000,231000
18,13,12,-1,2,225000,60000,285000
8,19,6,-1,2,237000,15000,252000
20,17,12,-1,2,219000,45000,264000
19,13,10,-1,2,255000,30000,285000
13,16,19,-1,2,231000,45000,276000
10,13,17,11,2,327000,250000,577000
8,20,14,-1,2,234000,15000,249000
12,13,15,-1,2,261000,105000,366000
14,8,10,-1,2,276000,45000,321000
17,7,18,-1,2,195000,30000,225000
18,6,20,-1,2,219000,15000,234000
19,8,9,-1,2,258000,30000,288000
18,11,8,11,2,249000,140000,389000
17,14,6,-1,2,237000,15000,252000
20,12,18,-1,2,183000,30000,213000
14,19,17,-1,2,186000,30000,216000
15,18,9,-1,2,240000,30000,270000
5,9,13,-1,2,282000,45000,327000
10,11,7,-1,2,249000,90000,339000
8,7,18,12,2,276000,180000,456000
15,10,17,-1,2,255000,45000,300000
8,19,20,-1,2,192000,30000,222000
7,8,17,-1,2,225000,0,225000
7,5,11,-1,2,249000,45000,294000
8,10,7,-1,2,252000,105000,357000
9,11,8,-1,2,252000,105000,357000
18,13,14,12,2,207000,60000,267000
18,19,7,-1,2,231000,30000,261000
11,14,13,-1,2,267000,90000,357000
17,18,15,-1,2,192000,90000,282000
12,16,18,-1,2,192000,15000,207000
15,11,6,-1,2,270000,30000,300000
10,11,5,-1,2,237000,75000,312000
10,18,16,12,2,252000,220000,472000
15,13,9,-1,2,219000,15000,234000
7,11,16,-1,2,234000,30000,264000
6,20,7,-1,2,213000,30000,243000
7,14,16,-1,2,249000,30000,279000
15,9,14,-1,2,237000,75000,312000
7,17,13,-1,2,219000,30000,249000
19,14,10,13,2,258000,265000,523000
20,14,7,-1,2,207000,15000,222000
6,16,11,-1,2,270000,30000,300000
19,12,6,-1,2,198000,15000,213000
6,16,15,-1,2,240000,30000,270000
17,15,9,-1,2,222000,30000,252000
8,18,9,-1,2,240000,30000,270000
5,6,9,11,2,342000,285000,627000
6,16,5,-1,2,258000,30000,288000
16,14,11,-1,2,222000,75000,297000
16,17,20,-1,2,192000,90000,282000
7,9,20,-1,2,210000,15000,225000
15,9,19,-1,2,219000,30000,249000
10,6,19,-1,2,243000,15000,258000
9,13,7,11,2,306000,345000,651000
9,16,17,-1,2,252000,45000,297000
8,12,20,-1,2,216000,15000,231000
5,7,17,-1,2,264000,15000,279000
17,5,12,-1,2,216000,15000,231000
6,20,12,-1,1,180000,0,180000
10,9,6,-1,2,303000,90000,393000
11,7,19,13,2,249000,300000,549000
9,20,10,-1,2,198000,0,198000
19,8,17,-1,2,219000,15000,234000
12,16,8,-1,2,273000,45000,318000
5,10,15,-1,2,243000,30000,273000
17,6,13,-1,2,210000,30000,240000
7,8,6,-1,2,270000,90000,360000
7,9,14,13,2,267000,280000,547000
7,14,9,-1,2,294000,45000,339000
10,9,11,-1,2,243000,90000,333000
15,11,5,-1,2,228000,30000,258000
12,8,13,-1,2,237000,75000,312000
20,8,14,-1,2,189000,15000,204000
17,16,8,-1,2,249000,30000,279000
12,15,17,13,2,267000,250000,517000
10,8,11,-1,2,258000,90000,348000
20,8,16,-1,2,180000,15000,195000
8,14,11,-1,2,285000,45000,330000
6,15,18,-1,2,210000,15000,225000
9,20,15,-1,2,219000,30000,249000
5,11,12,-1,2,288000,45000,333000
9,15,16,11,2,273000,220000,493000
6,11,9,-1,2,303000,75000,378000
13,7,10,-1,2,249000,45000,294000
10,12,16,-1,2,222000,45000,267000
11,19,20,-1,2,183000,30000,213000
20,14,5,-1,1,162000,0,162000
9,11,14,-1,2,285000,45000,330000
19,9,11,12,2,270000,300000,570000
5,17,11,-1,1,189000,0,189000
12,5,14,-1,2,258000,30000,288000
7,11,20,-1,2,189000,15000,204000
13,9,6,-1,2,285000,45000,330000
12,6,8,-1,2,240000,45000,285000
14,16,8,-1,2,204000,30000,234000
7,9,13,11,2,306000,345000,651000
17,15,13,-1,2,240000,75000,315000
16,6,20,-1,2,225000,15000,240000
5,20,6,-1,2,249000,30000,279000
8,17,9,-1,2,276000,45000,321000
15,10,20,-1,2,207000,30000,237000
19,5,17,-1,2,219000,15000,234000
14,6,10,12,2,315000,345000,660000
7,11,20,-1,2,243000,15000,258000
11,7,10,-1,2,285000,90000,375000
11,20,7,-1,2,189000,15000,204000
6,8,18,-1,2,246000,15000,261000
17,15,14,-1,2,216000,105000,321000
19,18,14,-1,2,216000,75000,291000
7,13,14,11,2,285000,180000,465000
11,9,20,-1,2,219000,15000,234000
7,9,18,-1,2,246000,15000,261000
12,15,16,-1,2,231000,90000,321000
7,17,18,-1,2,240000,30000,270000
12,5,19,-1,1,216000,0,216000
10,16,5,-1,2,252000,15000,267000
13,18,9,11,2,291000,220000,511000
20,12,14,-1,2,246000,30000,276000
20,8,9,-1,2,249000,30000,279000
15,8,11,-1,2,276000,45000,321000
8,18,14,-1,2,201000,30000,231000
16,6,15,-1,2,249000,30000,279000
19,11,7,-1,2,216000,15000,231000
18,14,7,11,2,309000,205000,514000
15,16,12,-1,2,258000,90000,348000
13,10,7,-1,2,294000,45000,339000
17,19,13,-1,2,183000,45000,228000
14,10,17,-1,2,264000,45000,309000
10,9,13,-1,2,270000,90000,360000
8,16,12,-1,2,237000,45000,282000
13,19,17,12,2,192000,45000,237000
5,9,16,-1,2,264000,30000,294000
19,16,8,-1,2,210000,15000,225000
17,5,13,-1,2,252000,15000,267000
8,19,5,-1,2,228000,15000,243000
11,12,13,-1,2,252000,90000,342000
17,5,19,-1,2,210000,15000,225000
8,19,16,12,2,297000,190000,487000
12,5,6,-1,2,243000,15000,258000
13,7,10,-1,2,249000,45000,294000
12,15,5,-1,2,231000,30000,261000
18,10,6,-1,2,207000,15000,222000
19,18,5,-1,2,213000,30000,243000
11,7,9,-1,2,294000,75000,369000
7,6,20,12,2,273000,190000,463000
9,11,5,-1,2,282000,45000,327000
5,20,17,-1,2,183000,15000,198000
17,8,15,-1,2,258000,30000,288000
12,5,6,-1,2,279000,60000,339000
13,17,9,-1,2,219000,45000,264000
15,6,8,-1,2,255000,30000,285000
16,13,18,12,2,195000,75000,270000
6,12,16,-1,2,264000,30000,294000
18,19,5,-1,2,204000,30000,234000
18,17,13,-1,2,237000,75000,312000
10,5,6,-1,2,309000,105000,414000
18,14,13,-1,2,207000,60000,267000
6,13,17,-1,2,255000,30000,285000
19,20,12,11,2,174000,45000,219000
6,20,18,-1,2,183000,15000,198000
19,7,5,-1,2,258000,30000,288000
13,10,9,-1,2,270000,90000,360000
5,11,17,-1,2,216000,15000,231000
7,5,18,-1,2,228000,15000,243000
7,20,8,-1,2,222000,30000,252000
10,19,16,12,2,288000,190000,478000
11,12,17,-1,2,225000,15000,240000
18,9,13,-1,2,225000,30000,255000
20,12,11,-1,2,240000,45000,285000
11,14,16,-1,2,249000,75000,324000
5,11,6,-1,2,288000,60000,348000
7,15,8,-1,2,249000,45000,294000
5,19,13,12,2,252000,235000,487000
18,17,5,-1,2,195000,30000,225000
8,5,10,-1,2,294000,75000,369000
13,17,9,-1,2,219000,45000,264000
7,11,5,-1,2,258000,45000,303000
6,13,17,-1,2,210000,30000,240000
6,5,12,-1,2,270000,60000,330000
16,15,5,11,2,273000,220000,493000
19,7,8,-1,2,267000,30000,297000
13,11,17,-1,2,240000,45000,285000
9,16,18,-1,2,222000,30000,252000
18,11,6,-1,2,234000,15000,249000
17,18,12,-1,2,219000,75000,294000
15,19,9,-1,2,228000,30000,258000
20,6,18,12,2,285000,215000,500000
20,11,12,-1,2,222000,45000,267000
12,11,10,-1,2,270000,90000,360000
8,7,12,-1,2,270000,60000,330000
17,6,20,-1,2,183000,15000,198000
18,6,8,-1,2,264000,15000,279000
14,16,6,-1,2,228000,15000,243000
18,17,20,12,2,153000,90000,243000
17,8,7,-1,2,249000,30000,279000
12,19,11,-1,2,240000,45000,285000
8,13,5,-1,2,285000,45000,330000
16,13,6,-1,2,222000,30000,252000
5,8,11,-1,2,267000,45000,312000
9,14,15,-1,2,219000,75000,294000
20,18,10,11,2,267000,170000,437000
18,5,19,-1,2,186000,30000,216000
17,5,6,-1,2,288000,45000,333000
20,11,6,-1,2,198000,15000,213000
16,6,13,-1,2,258000,30000,288000
13,16,9,-1,2,237000,45000,282000
13,20,7,-1,2,207000,15000,222000
10,5,18,11,2,318000,300000,618000
12,15,10,-1,2,276000,45000,321000
19,5,17,-1,2,201000,15000,216000
5,16,10,-1,2,252000,15000,267000
10,9,13,-1,2,261000,90000,351000
15,8,12,-1,2,237000,45000,282000
17,10,19,-1,2,195000,30000,225000
10,7,15,11,2,327000,330000,657000
8,16,19,-1,2,246000,15000,261000
8,5,10,-1,2,294000,75000,369000
13,10,19,-1,2,210000,30000,240000
18,7,8,-1,2,249000,30000,279000
13,9,11,-1,2,258000,75000,333000
18,16,12,-1,2,201000,45000,246000
15,18,15,12,2,174000,15000,189000
7,14,6,-1,2,285000,45000,330000
9,14,13,-1,2,219000,75000,294000
20,18,13,-1,2,189000,45000,234000
18,15,12,-1,2,195000,30000,225000
13,11,14,-1,2,249000,90000,339000
13,17,7,-1,2,228000,30000,258000
20,16,6,12,2,279000,160000,439000
12,19,13,-1,2,216000,15000,231000
7,16,10,-1,2,264000,30000,294000
9,19,16,-1,2,204000,30000,234000
15,13,19,-1,2,240000,45000,285000
14,15,18,-1,2,243000,90000,333000
6,11,17,-1,2,252000,15000,267000
18,7,8,12,2,303000,180000,483000
9,19,7,-1,2,246000,15000,261000
20,19,14,-1,2,177000,75000,252000
9,12,13,-1,2,240000,90000,330000
6,11,8,-1,2,258000,45000,303000
19,12,15,-1,2,204000,45000,249000
10,14,8,-1,2,285000,45000,330000
10,9,11,13,2,282000,310000,592000
16,19,20,-1,2,186000,75000,261000
16,9,14,-1,2,255000,45000,300000
11,8,12,-1,2,258000,90000,348000
5,8,18,-1,2,228000,15000,243000
18,17,10,-1,2,216000,45000,261000
8,6,17,-1,2,255000,15000,270000
15,14,18,11,2,216000,90000,306000
12,15,10,-1,2,276000,45000,321000
8,15,13,-1,2,246000,45000,291000
10,18,20,-1,2,183000,15000,198000
20,15,5,-1,2,243000,15000,258000
8,10,12,-1,2,276000,75000,351000
6,10,12,-1,2,237000,45000,282000
5,12,7,12,2,237000,175000,412000
5,15,12,-1,2,231000,30000,261000
18,5,20,-1,2,183000,15000,198000
11,8,17,-1,2,282000,30000,312000
17,15,16,-1,2,195000,90000,285000
5,17,20,-1,2,183000,15000,198000
17,10,9,-1,2,285000,45000,330000
8,11,19,13,2,267000,300000,567000
18,15,9,-1,2,201000,15000,216000
9,13,14,-1,2,255000,75000,330000
11,15,20,-1,2,207000,30000,237000
11,18,19,-1,2,222000,45000,267000
17,6,12,-1,2,207000,15000,222000
19,13,20,-1,2,156000,45000,201000
20,18,12,11,2,174000,30000,204000
16,12,7,-1,2,216000,15000,231000
14,5,6,-1,2,258000,45000,303000
20,11,12,-1,2,213000,45000,258000
11,15,12,-1,2,261000,90000,351000
17,18,16,-1,2,183000,90000,273000
6,8,15,-1,2,255000,30000,285000
7,6,13,12,2,285000,280000,565000
18,17,14,-1,2,210000,90000,300000
18,8,17,-1,2,195000,30000,225000
14,6,17,-1,2,255000,15000,270000
8,5,10,-1,2,276000,75000,351000
18,15,20,-1,2,153000,75000,228000
17,10,15,-1,2,228000,45000,273000
5,6,18,11,2,321000,205000,526000
7,19,8,-1,2,240000,30000,270000
17,11,5,-1,2,234000,15000,249000
9,10,13,-1,2,261000,90000,351000
17,5,10,-1,2,216000,15000,231000
9,11,13,-1,2,249000,75000,324000
19,5,9,-1,2,207000,15000,222000
15,12,20,13,2,258000,220000,478000
5,15,8,-1,2,264000,30000,294000
8,19,16,-1,2,192000,15000,207000
8,7,19,-1,2,258000,30000,288000
15,17,6,-1,2,228000,15000,243000
18,9,7,-1,2,228000,15000,243000
9,10,12,-1,2,270000,105000,375000
11,19,20,11,2,246000,200000,446000
18,17,12,-1,2,201000,75000,276000
5,6,11,-1,2,297000,60000,357000
11,18,9,-1,2,219000,30000,249000
19,10,6,-1,2,216000,15000,231000
14,20,12,-1,2,219000,30000,249000
8,19,16,-1,2,237000,15000,252000
11,6,9,13,2,324000,285000,609000
12,11,7,-1,2,282000,75000,357000
7,12,14,-1,2,237000,45000,282000
6,18,9,-1,2,210000,15000,225000
9,15,11,-1,2,258000,45000,303000
15,7,13,-1,2,222000,30000,252000
18,12,19,-1,2,186000,45000,231000
12,11,18,13,2,276000,270000,546000
9,10,14,-1,2,297000,60000,357000
8,13,12,-1,2,237000,75000,312000
20,7,16,-1,2,189000,15000,204000
17,19,12,-1,2,237000,45000,282000
16,10,5,-1,2,252000,15000,267000
5,13,20,-1,1,189000,0,189000
10,16,6,13,2,303000,355000,658000
17,10,11,-1,2,234000,15000,249000
11,12,18,-1,2,234000,60000,294000
5,9,20,-1,2,216000,15000,231000
18,12,9,-1,2,255000,30000,285000
13,9,11,-1,2,258000,75000,333000
8,10,19,-1,2,201000,15000,216000
13,14,15,12,2,243000,90000,333000
11,16,15,-1,2,246000,75000,321000
8,15,11,-1,2,276000,45000,321000
9,15,19,-1,2,192000,30000,222000
9,6,12,-1,2,294000,45000,339000
20,8,18,-1,2,174000,15000,189000
15,5,9,-1,2,291000,45000,336000
16,18,16,12,2,120000,15000,135000
6,5,10,-1,2,288000,60000,348000
7,15,11,-1,2,237000,45000,282000
11,20,15,-1,2,189000,30000,219000
12,8,15,-1,2,273000,45000,318000
8,13,20,-1,2,189000,15000,204000
13,11,16,-1,2,258000,45000,303000
14,8,7,12,2,303000,265000,568000
6,17,20,-1,2,228000,15000,243000
7,20,13,-1,2,243000,15000,258000
16,18,13,-1,2,231000,75000,306000
14,6,17,-1,2,264000,15000,279000
10,6,14,-1,2,264000,45000,309000
10,8,14,-1,2,240000,45000,285000
7,5,16,11,2,285000,195000,480000
18,11,20,-1,2,201000,30000,231000
11,14,20,-1,2,180000,15000,195000
11,18,15,-1,2,237000,45000,282000
11,19,6,-1,2,234000,15000,249000
20,18,7,-1,2,201000,15000,216000
8,18,10,-1,2,246000,15000,261000
14,11,16,13,2,267000,280000,547000
17,12,10,-1,2,240000,45000,285000
20,11,15,-1,2,207000,30000,237000
18,19,6,-1,2,231000,30000,261000
19,18,17,-1,2,189000,75000,264000
19,11,14,-1,2,249000,45000,294000
6,13,10,-1,2,273000,45000,318000
9,7,14,11,2,279000,330000,609000
16,11,10,-1,2,279000,60000,339000
6,11,10,-1,2,255000,75000,330000
16,10,9,-1,2,243000,60000,303000
10,17,14,-1,2,219000,45000,264000
8,12,5,-1,2,276000,45000,321000
6,18,20,-1,2,174000,15000,189000
12,19,9,11,2,327000,205000,532000
8,14,7,-1,2,306000,60000,366000
18,9,19,-1,2,186000,30000,216000
18,15,11,-1,2,255000,45000,300000
7,10,8,-1,2,288000,105000,393000
9,17,19,-1,2,183000,15000,198000
13,18,9,-1,2,252000,30000,282000
12,15,19,11,2,231000,45000,276000
13,9,10,-1,2,288000,90000,378000
14,17,19,-1,2,183000,75000,258000
6,14,8,-1,2,225000,15000,240000
10,8,9,-1,2,252000,90000,342000
9,12,20,-1,2,183000,15000,198000
17,10,18,-1,2,252000,45000,297000
18,19,15,13,2,198000,90000,288000
16,10,9,-1,2,261000,60000,321000
10,13,16,-1,2,231000,45000,276000
14,19,16,-1,2,213000,45000,258000
14,18,20,-1,2,216000,45000,261000
16,19,12,-1,2,192000,15000,207000
14,16,18,-1,2,231000,75000,306000
12,5,13,13,2,270000,240000,510000
19,7,20,-1,2,201000,30000,231000
8,13,6,-1,2,228000,30000,258000
15,8,9,-1,2,252000,60000,312000
5,15,16,-1,2,213000,30000,243000
13,14,5,-1,2,258000,30000,288000
5,13,18,-1,2,216000,15000,231000
15,7,18,11,2,291000,190000,481000
15,15,7,-1,1,198000,0,198000
7,8,16,-1,2,249000,45000,294000
14,12,13,-1,2,216000,90000,306000
6,9,10,-1,2,285000,90000,375000
8,20,9,-1,2,204000,30000,234000
8,9,16,-1,2,276000,45000,321000
20,17,11,12,2,261000,185000,446000
15,9,6,-1,2,225000,15000,240000
20,5,9,-1,2,189000,15000,204000
18,6,19,-1,2,222000,30000,252000
7,19,15,-1,2,243000,15000,258000
20,13,9,-1,2,207000,15000,222000
8,18,15,-1,2,258000,30000,288000
8,16,18,11,2,309000,215000,524000
12,18,19,-1,2,222000,45000,267000
18,6,14,-1,2,198000,15000,213000
14,17,19,-1,2,201000,75000,276000
6,10,18,-1,1,198000,0,198000
17,5,16,-1,2,222000,30000,252000
7,17,10,-1,2,273000,30000,303000
13,16,9,12,2,261000,265000,526000
13,8,5,-1,2,225000,15000,240000
5,15,13,-1,2,219000,15000,234000
12,16,11,-1,2,234000,60000,294000
7,19,14,-1,2,216000,15000,231000
9,18,8,-1,2,240000,30000,270000
18,8,5,-1,2,255000,15000,270000
15,14,11,13,2,249000,255000,504000
10,6,7,-1,2,270000,90000,360000
18,20,16,-1,2,144000,75000,219000
6,7,20,-1,2,222000,30000,252000
10,8,17,-1,2,264000,30000,294000
5,15,6,-1,2,240000,30000,270000
9,16,20,-1,2,192000,30000,222000
5,8,13,11,2,333000,370000,703000
13,7,11,-1,2,282000,45000,327000
12,10,18,-1,2,210000,30000,240000
9,17,19,-1,2,210000,15000,225000
9,20,6,-1,2,246000,15000,261000
15,9,18,-1,2,231000,30000,261000
14,5,20,-1,1,207000,0,207000
16,10,19,12,2,306000,190000,496000
7,16,15,-1,2,213000,30000,243000
18,16,5,-1,2,219000,15000,234000
12,10,7,-1,2,285000,75000,360000
17,14,15,-1,2,198000,105000,303000
15,14,5,-1,2,276000,30000,306000
20,13,12,-1,2,222000,45000,267000
20,16,12,12,2,297000,160000,457000
13,6,7,-1,2,243000,15000,258000
19,10,6,-1,2,198000,15000,213000
16,10,18,-1,2,213000,30000,243000
15,18,19,-1,2,198000,90000,288000
9,20,9,-1,1,126000,0,126000
18,12,15,-1,2,240000,45000,285000
17,16,12,13,2,276000,195000,471000
10,12,6,-1,2,255000,45000,300000
16,20,12,-1,2,192000,45000,237000
13,19,15,-1,2,240000,45000,285000
12,15,7,-1,2,282000,45000,327000
12,19,5,-1,1,171000,0,171000
16,18,8,-1,2,237000,15000,252000
18,6,12,11,2,309000,235000,544000
7,10,12,-1,2,303000,75000,378000
10,6,14,-1,2,237000,45000,282000
5,15,12,-1,2,231000,30000,261000
5,11,15,-1,2,228000,30000,258000
14,10,18,-1,2,219000,45000,264000
5,17,8,-1,2,246000,15000,261000
7,11,5,13,2,303000,295000,598000
18,19,10,-1,2,222000,30000,252000
5,15,9,-1,2,291000,45000,336000
8,5,20,-1,2,201000,15000,216000
15,9,18,-1,2,231000,30000,261000
7,10,17,-1,2,282000,30000,312000
12,15,8,-1,2,237000,45000,282000
20,19,7,13,2,228000,230000,458000
5,15,7,-1,2,246000,15000,261000
19,11,14,-1,2,222000,45000,267000
17,12,9,-1,2,267000,45000,312000
15,9,10,-1,2,261000,60000,321000
10,15,12,-1,2,231000,45000,276000
15,20,16,-1,2,195000,60000,255000
18,5,17,11,2,285000,185000,470000
18,10,17,-1,2,234000,45000,279000
14,14,18,-1,2,171000,15000,186000
5,6,11,-1,2,279000,60000,339000
18,11,12,-1,2,225000,60000,285000
9,11,5,-1,2,264000,45000,309000
6,14,11,-1,2,237000,45000,282000
13,5,10,12,2,270000,345000,615000
8,12,9,-1,2,306000,90000,396000
15,17,9,-1,2,195000,30000,225000
7,13,16,-1,2,249000,30000,279000
5,12,15,-1,2,258000,30000,288000
15,20,11,-1,2,198000,30000,228000
17,14,15,-1,2,243000,105000,348000
7,19,14,11,2,327000,175000,502000
7,10,8,-1,2,306000,105000,411000
18,20,10,-1,2,174000,15000,189000
11,18,19,-1,2,231000,45000,276000
20,7,6,-1,2,189000,0,189000
6,14,10,-1,2,273000,45000,318000
6,12,20,-1,1,162000,0,162000
20,5,6,11,2,336000,190000,526000
17,16,9,-1,2,243000,45000,288000
17,18,5,-1,2,231000,30000,261000
14,18,9,-1,2,252000,30000,282000
20,16,6,-1,2,207000,15000,222000
8,16,15,-1,2,261000,45000,306000
12,18,7,-1,2,216000,15000,231000
20,12,19,11,2,192000,45000,237000
5,14,20,-1,1,171000,0,171000
7,12,15,-1,2,291000,45000,336000
20,16,13,-1,2,195000,45000,240000
20,6,13,-1,1,216000,0,216000
12,15,20,-1,2,258000,45000,303000
14,15,7,-1,2,270000,45000,315000
19,9,17,13,2,249000,220000,469000
13,5,7,-1,2,255000,30000,285000
5,8,16,-1,2,219000,15000,234000
12,6,11,-1,2,255000,75000,330000
10,11,5,-1,2,237000,75000,312000
5,12,16,-1,2,219000,30000,249000
16,11,11,-1,2,162000,15000,177000
19,20,6,11,2,237000,200000,437000
6,12,19,-1,2,207000,15000,222000
16,15,6,-1,2,240000,30000,270000
18,10,17,-1,2,225000,45000,270000
15,15,9,-1,1,180000,0,180000
11,15,17,-1,2,210000,45000,255000
14,5,13,-1,2,267000,30000,297000
5,6,8,12,2,315000,215000,530000
11,16,20,-1,2,207000,30000,237000
14,12,5,-1,2,276000,30000,306000
6,13,14,-1,2,234000,45000,279000
18,7,12,-1,2,198000,15000,213000
20,18,13,-1,2,207000,45000,252000
12,6,19,-1,1,171000,0,171000
12,18,6,11,2,309000,235000,544000
14,20,13,-1,2,261000,60000,321000
7,19,18,-1,2,231000,30000,261000
9,15,18,-1,2,249000,30000,279000
20,6,17,-1,2,228000,15000,243000
19,12,10,-1,2,264000,30000,294000
18,10,13,-1,2,249000,45000,294000
14,7,18,11,2,300000,205000,505000
11,9,17,-1,2,273000,30000,303000
5,17,11,-1,2,225000,15000,240000
10,8,5,-1,2,267000,75000,342000
9,19,15,-1,2,183000,30000,213000
8,14,10,-1,2,285000,45000,330000
20,12,14,-1,2,192000,30000,222000
19,19,13,12,1,144000,0,144000
20,18,6,-1,2,219000,15000,234000
14,15,16,-1,2,252000,90000,342000
18,11,5,-1,2,252000,15000,267000
5,16,12,-1,2,246000,30000,276000
12,19,16,-1,2,201000,45000,246000
10,18,12,-1,2,255000,30000,285000
7,10,20,13,2,285000,295000,580000
11,8,15,-1,2,228000,30000,258000
8,11,20,-1,2,192000,15000,207000
12,8,16,-1,2,273000,45000,318000
6,17,10,-1,2,207000,15000,222000
5,11,16,-1,2,246000,30000,276000
17,5,13,-1,2,216000,15000,231000
7,10,9,12,2,309000,310000,619000
11,20,16,-1,2,234000,30000,264000
16,12,17,-1,2,237000,75000,312000
9,14,15,-1,2,264000,75000,339000
10,9,20,-1,2,213000,30000,243000
10,15,16,-1,2,255000,75000,330000
9,13,5,-1,2,264000,45000,309000
5,16,18,12,2,252000,220000,472000
18,6,20,-1,2,174000,15000,189000
11,16,17,-1,2,255000,75000,330000
18,13,5,-1,2,243000,15000,258000
16,13,18,-1,2,213000,75000,288000
11,6,8,-1,2,294000,45000,339000
9,14,18,-1,2,207000,30000,237000
14,5,17,11,2,300000,235000,535000
6,20,7,-1,2,258000,30000,288000
20,12,17,-1,2,228000,45000,273000
20,8,13,-1,2,225000,15000,240000
16,5,5,-1,1,189000,0,189000
12,13,8,-1,2,228000,75000,303000
11,15,20,-1,2,198000,30000,228000
13,11,18,12,2,297000,265000,562000
15,9,19,-1,2,189000,15000,204000
5,16,8,-1,2,255000,15000,270000
18,5,14,-1,2,216000,15000,231000
8,10,9,-1,2,279000,90000,369000
11,7,8,-1,2,252000,90000,342000
17,5,9,-1,2,207000,15000,222000
11,14,13,13,2,225000,175000,400000
5,17,8,-1,2,255000,15000,270000
5,11,15,-1,2,237000,30000,267000
20,7,5,-1,2,201000,15000,216000
8,9,18,-1,2,240000,30000,270000
7,13,5,-1,2,273000,30000,303000
6,14,8,-1,2,237000,30000,267000
8,14,17,13,2,231000,265000,496000
16,17,10,-1,2,216000,45000,261000
17,14,9,-1,2,264000,45000,309000
15,13,16,-1,2,213000,90000,303000
20,6,6,-1,1,153000,0,153000
16,6,19,-1,2,228000,15000,243000
12,8,13,-1,2,273000,75000,348000
17,18,16,12,2,165000,90000,255000
20,16,8,-1,2,198000,15000,213000
6,14,7,-1,2,294000,45000,339000
19,14,15,-1,2,198000,60000,258000
10,14,5,-1,2,291000,45000,336000
8,7,17,-1,2,213000,30000,243000
11,5,16,-1,2,246000,30000,276000
10,18,6,13,2,267000,325000,592000
16,10,14,-1,2,210000,15000,225000
7,13,17,-1,2,219000,30000,249000
13,12,13,-1,2,195000,30000,225000
11,18,12,-1,2,225000,60000,285000
5,18,12,-1,2,234000,15000,249000
7,15,12,-1,2,255000,45000,300000
5,16,12,11,2,273000,265000,538000
13,16,17,-1,2,249000,90000,339000
12,20,11,-1,2,267000,45000,312000
18,20,8,-1,2,210000,15000,225000
11,15,7,-1,2,291000,45000,336000
16,18,17,-1,2,156000,90000,246000
7,15,14,-1,2,243000,45000,288000
8,16,14,12,2,270000,250000,520000
5,8,17,-1,1,207000,0,207000
14,8,18,-1,2,201000,30000,231000
9,14,15,-1,2,255000,75000,330000
20,9,6,-1,2,219000,15000,234000
9,8,7,-1,2,288000,90000,378000
13,17,19,-1,2,183000,45000,228000
6,12,20,11,2,327000,205000,532000
20,16,19,-1,2,186000,75000,261000
7,9,14,-1,2,276000,45000,321000
17,8,18,-1,2,195000,30000,225000
17,5,7,-1,2,264000,15000,279000
6,12,15,-1,2,231000,30000,261000
15,12,6,-1,2,240000,30000,270000
19,17,5,11,2,279000,215000,494000
12,19,16,-1,2,183000,15000,198000
11,13,8,-1,2,285000,75000,360000
20,15,8,-1,2,189000,15000,204000
9,18,16,-1,2,240000,30000,270000
19,7,12,-1,2,225000,15000,240000
16,19,15,-1,2,213000,90000,303000
16,11,13,13,2,219000,130000,349000
20,6,9,-1,2,219000,15000,234000
18,7,11,-1,2,225000,15000,240000
15,17,5,-1,2,237000,15000,252000
20,15,14,-1,2,225000,60000,285000
18,10,16,-1,2,240000,30000,270000
7,14,10,-1,2,294000,45000,339000
11,8,7,13,2,288000,285000,573000
9,12,14,-1,2,276000,75000,351000
17,12,14,-1,2,222000,45000,267000
11,7,8,-1,2,288000,90000,378000
18,8,13,-1,2,216000,30000,246000
20,8,14,-1,2,198000,15000,213000
7,20,11,-1,2,234000,15000,249000
20,13,7,11,2,309000,190000,499000
18,15,12,-1,2,258000,45000,303000
18,7,19,-1,2,231000,30000,261000
6,15,19,-1,2,243000,15000,258000
5,8,16,-1,2,255000,15000,270000
15,14,11,-1,2,231000,90000,321000
13,16,17,-1,2,231000,90000,321000
8,13,15,12,2,306000,280000,586000
11,5,10,-1,2,240000,30000,270000
18,6,5,-1,2,222000,30000,252000
14,12,13,-1,2,234000,90000,324000
14,10,6,-1,2,273000,45000,318000
13,17,6,-1,2,210000,30000,240000
7,18,5,-1,2,228000,15000,243000
13,7,11,13,2,231000,240000,471000
15,5,17,-1,2,228000,15000,243000
15,19,17,-1,2,192000,75000,267000
15,14,8,-1,2,222000,30000,252000
15,13,19,-1,2,213000,45000,258000
13,19,9,-1,2,252000,30000,282000
19,13,18,-1,2,198000,75000,273000
13,18,16,11,2,186000,30000,216000
7,7,15,-1,1,180000,0,180000
17,18,20,-1,2,135000,90000,225000
8,20,18,-1,2,210000,15000,225000
8,9,11,-1,2,306000,105000,411000
10,7,13,-1,2,249000,45000,294000
9,8,15,-1,2,252000,60000,312000
11,18,9,12,2,261000,315000,576000
17,19,8,-1,2,183000,15000,198000
15,8,10,-1,2,285000,45000,330000
17,15,6,-1,2,201000,15000,216000
15,8,19,-1,2,219000,30000,249000
6,17,19,-1,2,219000,15000,234000
14,8,11,-1,2,285000,45000,330000
10,16,11,11,2,234000,155000,389000
17,13,14,-1,2,225000,90000,315000
12,18,5,-1,2,252000,15000,267000
11,5,6,-1,2,270000,60000,330000
17,7,14,-1,2,213000,30000,243000
10,6,8,-1,2,267000,75000,342000
15,14,5,-1,2,222000,30000,252000
17,5,10,13,2,276000,340000,616000
14,20,8,-1,1,162000,0,162000
11,14,15,-1,2,267000,90000,357000
5,19,8,-1,2,246000,15000,261000
10,15,20,-1,2,225000,30000,255000
18,11,6,-1,2,234000,15000,249000
9,18,11,-1,2,246000,30000,276000
8,16,20,12,2,270000,160000,430000
8,9,14,-1,2,243000,15000,258000
19,18,12,-1,2,168000,45000,213000
16,11,9,-1,2,219000,30000,249000
20,13,17,-1,2,192000,45000,237000
20,16,12,-1,2,246000,45000,291000
10,8,12,-1,2,285000,75000,360000
7,18,14,13,2,231000,265000,496000
10,18,14,-1,2,228000,45000,273000
6,19,20,-1,2,192000,30000,222000
16,7,5,-1,1,207000,0,207000
5,14,20,-1,1,171000,0,171000
13,9,6,-1,2,303000,45000,348000
17,8,19,-1,2,183000,15000,198000
6,9,15,12,2,324000,355000,679000
18,5,9,-1,2,264000,30000,294000
16,19,8,-1,2,210000,15000,225000
5,9,10,-1,2,282000,75000,357000
12,20,9,-1,2,183000,15000,198000
18,20,9,-1,2,228000,15000,243000
20,11,14,-1,2,255000,30000,285000
12,17,8,12,2,261000,155000,416000
16,14,5,-1,2,237000,15000,252000
19,16,15,-1,2,195000,90000,285000
17,5,10,-1,1,198000,0,198000
5,19,20,-1,2,183000,30000,213000
16,18,14,-1,2,186000,30000,216000
14,20,7,-1,2,234000,15000,249000
13,10,12,11,2,309000,255000,564000
5,9,18,-1,2,264000,30000,294000
6,19,18,-1,2,204000,30000,234000
9,6,8,-1,2,294000,90000,384000
5,10,20,-1,2,189000,15000,204000
14,7,16,-1,2,249000,30000,279000
13,11,14,-1,2,231000,90000,321000
7,17,15,12,2,279000,235000,514000
10,6,9,-1,2,243000,45000,288000
16,6,7,-1,2,222000,30000,252000
10,19,16,-1,2,204000,30000,234000
16,14,9,-1,2,273000,45000,318000
17,13,20,-1,2,201000,45000,246000
17,11,10,-1,2,288000,60000,348000
15,18,7,13,2,249000,250000,499000
6,7,12,-1,2,270000,60000,330000
17,19,20,-1,2,123000,75000,198000
11,20,10,-1,2,222000,30000,252000
15,13,9,-1,2,273000,45000,318000
18,20,19,-1,2,132000,60000,192000
11,16,13,-1,2,267000,45000,312000
11,10,17,13,2,276000,315000,591000
16,6,12,-1,2,216000,15000,231000
15,18,19,-1,2,162000,90000,252000
8,9,15,-1,2,270000,60000,330000
13,17,15,-1,2,195000,75000,270000
20,12,11,-1,2,258000,45000,303000
11,13,18,-1,2,249000,45000,294000
17,13,18,12,2,210000,75000,285000
7,5,12,-1,2,297000,60000,357000
7,13,12,-1,2,237000,75000,312000
17,8,20,-1,2,183000,15000,198000
6,10,12,-1,2,291000,45000,336000
6,17,7,-1,2,222000,30000,252000
16,17,13,-1,2,213000,90000,303000
9,14,7,13,2,321000,280000,601000
18,20,5,-1,2,228000,15000,243000
15,14,10,-1,2,264000,75000,339000
19,20,15,-1,2,168000,75000,243000
12,11,6,-1,2,255000,75000,330000
8,7,14,-1,2,252000,60000,312000
17,12,15,-1,2,204000,75000,279000
13,7,18,12,2,297000,265000,562000
7,12,5,-1,2,228000,30000,258000
11,7,12,-1,2,237000,75000,312000
14,20,5,-1,1,162000,0,162000
20,13,18,-1,2,225000,45000,270000
18,10,12,-1,2,189000,15000,204000
18,20,15,-1,2,180000,75000,255000
17,19,16,11,2,174000,105000,279000
10,11,5,-1,2,255000,75000,330000
6,18,15,-1,2,201000,15000,216000
14,20,11,-1,2,237000,30000,267000
20,15,19,-1,2,186000,75000,261000
19,12,6,-1,2,216000,15000,231000
9,18,10,-1,2,258000,45000,303000
16,12,6,12,2,234000,130000,364000
10,14,18,-1,2,237000,45000,282000
10,7,8,-1,2,279000,105000,384000
8,6,7,-1,2,252000,90000,342000
10,12,8,-1,2,240000,75000,315000
11,18,15,-1,2,201000,45000,246000
19,12,18,-1,2,204000,45000,249000
7,8,6,11,2,321000,200000,521000
9,20,15,-1,2,192000,30000,222000
6,8,17,-1,2,255000,15000,270000
8,6,9,-1,2,258000,90000,348000
16,6,8,-1,2,210000,15000,225000
7,12,15,-1,2,255000,45000,300000
11,12,15,-1,2,225000,90000,315000
6,16,17,11,2,300000,245000,545000
11,16,18,-1,2,255000,45000,300000
14,18,13,-1,2,243000,60000,303000
20,10,15,-1,2,243000,30000,273000
14,16,7,-1,2,249000,30000,279000
13,9,17,-1,2,237000,45000,282000
16,8,13,-1,2,246000,45000,291000
14,7,11,13,2,258000,345000,603000
11,13,11,-1,1,144000,0,144000
6,5,12,-1,2,252000,60000,312000
18,12,18,-1,1,108000,0,108000
15,8,9,-1,2,288000,60000,348000
16,14,5,-1,2,210000,15000,225000
12,18,19,-1,2,186000,45000,231000
18,19,5,11,2,273000,155000,428000
19,17,7,-1,2,237000,15000,252000
18,9,16,-1,2,240000,30000,270000
11,5,16,-1,2,255000,30000,285000
18,14,20,-1,2,171000,45000,216000
9,19,6,-1,1,189000,0,189000
15,8,16,-1,2,243000,45000,288000
13,5,12,12,2,243000,175000,418000
5,15,13,-1,2,246000,15000,261000
8,16,16,-1,1,153000,0,153000
13,20,12,-1,2,204000,45000,249000
12,11,14,-1,2,270000,105000,375000
8,12,7,-1,2,279000,60000,339000
5,6,18,-1,2,222000,30000,252000
17,16,8,11,2,291000,245000,536000
5,6,15,-1,2,288000,45000,333000
18,19,15,-1,2,162000,90000,252000
18,8,16,-1,2,210000,15000,225000
18,16,9,-1,2,231000,30000,261000
13,18,10,-1,2,258000,45000,303000
14,5,20,-1,1,189000,0,189000
12,17,13,11,2,270000,60000,330000
7,8,20,-1,2,240000,30000,270000
18,10,13,-1,2,258000,45000,303000
18,13,14,-1,2,234000,60000,294000
12,15,8,-1,2,273000,45000,318000
16,5,17,-1,2,213000,30000,243000
16,12,17,-1,2,228000,75000,303000
18,8,11,13,2,294000,300000,594000
18,11,15,-1,2,201000,15000,216000
13,6,11,-1,2,273000,45000,318000
14,16,9,-1,2,219000,45000,264000
7,11,5,-1,2,258000,45000,303000
8,17,17,-1,1,135000,0,135000
9,15,5,-1,2,243000,30000,273000
12,19,18,11,2,168000,45000,213000
20,12,10,-1,1,162000,0,162000
17,19,5,-1,2,237000,15000,252000
10,17,20,-1,2,219000,30000,249000
19,10,5,-1,1,180000,0,180000
9,17,5,-1,2,234000,15000,249000
15,7,11,-1,2,255000,45000,300000
19,6,13,12,2,252000,235000,487000
5,16,18,-1,2,192000,15000,207000
7,17,15,-1,2,237000,15000,252000
14,17,8,-1,2,231000,30000,261000
9,17,12,-1,2,267000,45000,312000
11,15,8,-1,2,258000,45000,303000
5,16,14,-1,2,219000,15000,234000
5,15,13,11,2,291000,250000,541000
8,5,20,-1,2,258000,30000,288000
10,5,8,-1,2,285000,75000,360000
9,18,20,-1,2,174000,15000,189000
11,7,15,-1,2,291000,45000,336000
13,9,10,-1,2,243000,90000,333000
5,14,8,-1,2,255000,30000,285000
18,6,8,12,2,276000,180000,456000
16,8,13,-1,2,273000,45000,318000
19,20,8,-1,2,174000,30000,204000
9,12,19,-1,1,171000,0,171000
15,8,10,-1,2,285000,45000,330000
19,20,15,-1,2,141000,75000,216000
15,15,8,-1,1,162000,0,162000
13,17,20,13,2,231000,190000,421000
5,20,16,-1,2,198000,15000,213000
13,15,6,-1,2,267000,30000,297000
6,5,12,-1,2,261000,60000,321000
17,10,14,-1,2,210000,45000,255000
11,10,12,-1,2,261000,90000,351000
18,15,8,-1,2,222000,30000,252000
15,11,17,13,2,267000,250000,517000
10,18,8,-1,2,210000,15000,225000
13,11,18,-1,2,249000,45000,294000
9,17,20,-1,2,210000,15000,225000
6,17,12,-1,2,264000,30000,294000
17,9,10,-1,2,249000,45000,294000
8,16,14,-1,2,222000,30000,252000
15,9,19,12,2,279000,205000,484000
11,8,7,-1,2,246000,30000,276000
8,9,12,-1,2,252000,90000,342000
11,19,6,-1,2,198000,15000,213000
19,14,9,-1,2,234000,30000,264000
19,10,17,-1,2,213000,30000,243000
14,20,7,-1,2,234000,15000,249000
5,18,12,13,2,276000,315000,591000
13,8,19,-1,2,198000,15000,213000
13,8,5,-1,2,294000,45000,339000
10,9,7,-1,2,240000,90000,330000
16,10,13,-1,2,222000,45000,267000
5,13,17,-1,2,234000,15000,249000
18,15,11,-1,2,219000,45000,264000
6,17,12,12,2,252000,155000,407000
10,16,8,-1,2,255000,30000,285000
12,10,18,-1,2,219000,30000,249000
9,6,12,-1,2,276000,45000,321000
20,7,6,-1,2,204000,30000,234000
9,12,17,-1,2,267000,45000,312000
7,19,15,-1,2,207000,15000,222000
18,9,8,13,2,303000,195000,498000
18,10,11,-1,2,276000,45000,321000
7,20,5,-1,2,219000,15000,234000
18,8,11,-1,2,264000,30000,294000
5,19,6,-1,2,231000,30000,261000
5,6,20,-1,2,231000,30000,261000
6,15,5,-1,2,267000,30000,297000
20,17,7,12,2,261000,185000,446000
20,8,16,-1,2,180000,15000,195000
10,8,18,-1,2,237000,15000,252000
20,18,11,-1,2,201000,30000,231000
10,6,12,-1,2,219000,15000,234000
14,20,9,-1,2,171000,15000,186000
16,20,7,-1,2,234000,15000,249000
18,13,9,12,2,297000,265000,562000
20,19,16,-1,2,156000,45000,201000
7,11,6,-1,2,261000,60000,321000
20,13,10,-1,2,210000,30000,240000
10,6,5,-1,2,288000,60000,348000
19,15,17,-1,2,165000,75000,240000
18,7,6,-1,2,216000,0,216000
5,14,19,13,2,249000,265000,514000
8,17,13,-1,2,234000,30000,264000
18,9,13,-1,2,225000,30000,255000
9,10,13,-1,2,270000,90000,360000
15,6,11,-1,2,243000,30000,273000
18,5,19,-1,2,186000,30000,216000
9,8,15,-1,2,306000,60000,366000
6,7,8,12,2,309000,310000,619000
16,17,12,-1,2,219000,75000,294000
13,18,10,-1,2,267000,45000,312000
11,5,16,-1,2,246000,30000,276000
6,20,11,-1,2,198000,15000,213000
8,15,20,-1,2,216000,15000,231000
13,18,5,-1,2,252000,15000,267000
10,6,18,11,2,300000,300000,600000
9,10,20,-1,2,249000,30000,279000
17,16,15,-1,2,222000,90000,312000
20,11,7,-1,1,180000,0,180000
16,17,10,-1,2,234000,45000,279000
9,18,7,-1,2,246000,15000,261000
8,11,15,-1,2,267000,45000,312000
5,15,11,13,2,258000,345000,603000
17,18,15,-1,2,189000,45000,234000
6,5,18,-1,2,279000,45000,324000
18,13,14,-1,2,225000,60000,285000
17,10,11,-1,2,279000,60000,339000
9,6,12,-1,2,267000,45000,312000
17,5,10,-1,2,207000,15000,222000
14,13,20,12,2,225000,60000,285000
6,17,14,-1,2,255000,15000,270000
6,14,9,-1,2,276000,45000,321000
12,17,11,-1,2,225000,60000,285000
14,6,13,-1,2,261000,45000,306000
13,15,8,-1,2,237000,45000,282000
9,6,14,-1,2,258000,45000,303000
11,7,19,12,2,261000,300000,561000
5,12,16,-1,2,216000,15000,231000
16,10,14,-1,2,219000,45000,264000
20,8,16,-1,2,207000,15000,222000
18,20,12,-1,2,201000,30000,231000
8,7,15,-1,2,225000,0,225000
14,15,19,-1,2,207000,60000,267000
6,12,18,11,2,327000,235000,562000
10,6,11,-1,2,291000,75000,366000
14,11,13,-1,2,213000,90000,303000
7,16,11,-1,2,252000,30000,282000
8,13,10,-1,2,249000,45000,294000
10,16,11,-1,2,234000,60000,294000
6,13,18,-1,2,216000,15000,231000
5,7,12,11,2,312000,280000,592000
15,17,10,-1,2,246000,45000,291000
17,8,11,-1,2,255000,30000,285000
8,17,5,-1,2,237000,15000,252000
20,5,11,-1,1,189000,0,189000
9,17,20,-1,2,228000,15000,243000
8,17,19,-1,2,237000,15000,252000
13,16,7,11,2,318000,250000,568000
18,8,12,-1,2,270000,30000,300000
15,17,9,-1,2,213000,30000,243000
12,8,6,-1,2,276000,45000,321000
13,14,20,-1,2,207000,60000,267000
8,10,17,-1,2,273000,30000,303000
17,16,19,-1,2,165000,105000,270000
15,5,11,13,2,267000,345000,612000
16,17,12,-1,2,204000,30000,234000
18,12,9,-1,2,255000,30000,285000
12,20,11,-1,2,240000,45000,285000
20,6,14,-1,1,198000,0,198000
8,19,5,-1,2,267000,30000,297000
12,10,15,-1,2,249000,45000,294000
8,10,6,12,2,306000,285000,591000
5,6,7,-1,2,288000,90000,378000
11,16,9,-1,2,231000,45000,276000
14,20,19,-1,2,159000,75000,234000
7,15,6,-1,2,258000,45000,303000
13,16,6,-1,2,222000,30000,252000
15,20,5,-1,2,207000,15000,222000
17,13,17,12,2,171000,15000,186000
16,19,13,-1,2,213000,45000,258000
18,10,7,-1,2,255000,15000,270000
14,10,14,-1,2,189000,15000,204000
15,14,10,-1,2,210000,75000,285000
18,10,5,-1,2,234000,15000,249000
16,7,6,-1,2,240000,30000,270000
18,16,8,12,2,270000,220000,490000
13,14,18,-1,2,219000,30000,249000
10,19,17,-1,2,213000,30000,243000
13,19,16,-1,2,240000,45000,285000
8,15,18,-1,2,258000,30000,288000
16,13,14,-1,2,243000,105000,348000
11,8,13,-1,2,285000,75000,360000
9,18,10,11,2,291000,300000,591000
20,11,16,-1,2,243000,30000,273000
13,5,10,-1,2,282000,45000,327000
16,5,12,-1,2,219000,30000,249000
19,7,16,-1,2,201000,15000,216000
18,12,20,-1,2,201000,30000,231000
19,15,5,-1,2,189000,15000,204000
19,18,9,11,2,285000,200000,485000
16,12,8,-1,2,216000,15000,231000
15,10,11,-1,2,243000,60000,303000
7,6,11,-1,2,270000,60000,330000
18,12,19,-1,2,168000,45000,213000
12,20,9,-1,1,171000,0,171000
10,15,7,-1,2,294000,45000,339000
11,14,12,13,2,240000,360000,600000
20,6,7,-1,2,222000,30000,252000
17,8,10,-1,2,264000,30000,294000
13,11,12,-1,2,234000,90000,324000
18,7,19,-1,2,213000,30000,243000
20,5,10,-1,2,243000,15000,258000
17,5,15,-1,2,237000,15000,252000
5,15,7,12,2,312000,225000,537000
7,11,12,-1,2,273000,75000,348000
10,12,19,-1,2,210000,30000,240000
6,11,14,-1,2,264000,45000,309000
18,20,11,-1,2,165000,30000,195000
9,17,11,-1,2,198000,15000,213000
12,15,20,-1,2,222000,45000,267000
9,14,11,11,2,270000,145000,415000
12,11,7,-1,2,255000,75000,330000
20,17,8,-1,2,183000,15000,198000
5,9,19,-1,2,255000,30000,285000
9,17,12,-1,2,258000,45000,303000
13,16,7,-1,2,231000,30000,261000
7,11,13,-1,2,264000,45000,309000
13,15,5,11,2,273000,250000,523000
8,10,18,-1,2,246000,15000,261000
11,17,8,-1,2,264000,30000,294000
16,19,18,-1,2,162000,90000,252000
9,12,6,-1,2,267000,45000,312000
13,18,8,-1,2,216000,30000,246000
10,8,9,-1,2,270000,90000,360000
17,11,13,11,2,273000,250000,523000
9,18,12,-1,2,273000,30000,303000
18,7,13,-1,2,228000,30000,258000
17,5,13,-1,2,234000,15000,249000
11,9,7,-1,2,258000,75000,333000
17,19,13,-1,2,183000,45000,228000
20,16,12,-1,2,246000,45000,291000
12,9,14,11,2,318000,280000,598000
14,15,9,-1,2,273000,75000,348000
12,18,8,-1,2,234000,30000,264000
11,13,8,-1,2,258000,75000,333000
5,18,19,-1,2,195000,30000,225000
13,20,12,-1,2,258000,45000,303000
17,7,5,-1,2,264000,15000,279000
20,8,15,12,2,261000,175000,436000
5,14,8,-1,2,225000,15000,240000
7,8,6,-1,2,252000,90000,342000
5,17,16,-1,2,204000,30000,234000
14,10,16,-1,2,246000,45000,291000
13,15,16,-1,2,222000,90000,312000
11,15,18,-1,2,246000,45000,291000
6,12,18,13,2,276000,315000,591000
8,7,17,-1,2,231000,30000,261000
18,7,16,-1,2,219000,15000,234000
5,12,7,-1,2,276000,45000,321000
5,6,13,-1,2,249000,45000,294000
18,11,13,-1,2,213000,45000,258000
17,18,15,-1,2,192000,90000,282000
9,17,18,11,2,285000,185000,470000
7,8,6,-1,2,288000,90000,378000
13,17,7,-1,2,201000,30000,231000
20,19,18,-1,2,141000,60000,201000
13,8,14,-1,2,282000,75000,357000
8,18,13,-1,2,225000,30000,255000
5,11,8,-1,2,267000,45000,312000
19,14,12,13,2,231000,265000,496000
6,5,13,-1,2,267000,45000,312000
6,19,15,-1,2,189000,15000,204000
8,19,18,-1,2,222000,30000,252000
5,7,12,-1,2,297000,60000,357000
19,8,9,-1,2,204000,30000,234000
5,8,6,-1,2,288000,105000,393000
11,7,12,11,2,225000,175000,400000
19,5,7,-1,2,219000,15000,234000
14,6,7,-1,2,276000,45000,321000
14,10,17,-1,2,210000,45000,255000
13,9,16,-1,2,246000,45000,291000
12,6,10,-1,2,255000,45000,300000
15,7,6,-1,2,249000,45000,294000
16,8,9,13,2,267000,225000,492000
5,10,17,-1,2,252000,15000,267000
14,18,13,-1,2,234000,60000,294000
7,6,19,-1,2,258000,30000,288000
16,20,11,-1,2,216000,30000,246000
12,17,8,-1,2,261000,30000,291000
6,18,8,-1,2,228000,15000,243000
16,11,14,13,2,249000,280000,529000
17,8,20,-1,2,201000,15000,216000
16,6,9,-1,2,300000,30000,330000
12,9,6,-1,2,249000,45000,294000
7,12,14,-1,2,237000,45000,282000
13,10,11,-1,2,234000,105000,339000
17,19,17,-1,2,129000,15000,144000
16,7,9,12,2,324000,340000,664000
8,18,12,-1,2,270000,30000,300000
9,10,8,-1,2,270000,90000,360000
8,16,6,-1,2,210000,15000,225000
20,16,6,-1,2,198000,15000,213000
7,17,12,-1,2,270000,30000,300000
11,14,9,-1,2,240000,45000,285000
14,12,5,11,2,282000,280000,562000
19,20,15,-1,2,195000,75000,270000
10,9,14,-1,2,261000,60000,321000
20,11,16,-1,2,198000,30000,228000
19,8,13,-1,2,225000,15000,240000
15,8,17,-1,2,249000,30000,279000
8,5,12,-1,2,276000,45000,321000
7,8,14,13,2,276000,280000,556000
6,12,8,-1,2,285000,45000,330000
9,15,14,-1,2,219000,75000,294000
17,10,8,-1,2,246000,30000,276000
17,15,6,-1,2,210000,15000,225000
5,20,5,-1,1,135000,0,135000
17,8,11,-1,2,264000,30000,294000
15,9,13,12,2,270000,280000,550000
19,13,17,-1,2,183000,15000,198000
16,7,20,-1,2,225000,15000,240000
13,10,9,-1,2,288000,90000,378000
16,13,8,-1,2,237000,45000,282000
11,9,7,-1,2,249000,75000,324000
10,8,14,-1,2,240000,45000,285000
6,10,15,11,2,282000,330000,612000
7,8,9,-1,2,306000,90000,396000
19,12,15,-1,2,204000,45000,249000
15,16,10,-1,2,255000,75000,330000
6,7,17,-1,2,249000,30000,279000
16,18,9,-1,2,213000,30000,243000
14,16,17,-1,2,222000,90000,312000
12,5,16,11,2,327000,265000,592000
6,18,17,-1,2,249000,30000,279000
13,7,12,-1,2,282000,75000,357000
14,6,5,-1,2,249000,45000,294000
17,19,18,-1,2,135000,75000,210000
19,13,9,-1,2,243000,30000,273000
8,10,11,-1,2,267000,90000,357000
8,15,16,13,2,231000,225000,456000
19,17,9,-1,2,201000,15000,216000
9,5,17,-1,2,252000,15000,267000
18,7,10,-1,2,219000,15000,234000
8,5,13,-1,2,285000,45000,330000
13,20,12,-1,2,204000,45000,249000
19,5,9,-1,2,243000,15000,258000
13,19,18,11,2,198000,75000,273000
7,6,6,-1,2,153000,0,153000
20,17,12,-1,2,192000,45000,237000
8,19,20,-1,2,210000,30000,240000
19,15,5,-1,2,189000,15000,204000
17,10,14,-1,2,246000,45000,291000
20,15,17,-1,2,192000,45000,237000
13,8,6,12,2,288000,175000,463000
17,19,10,-1,2,213000,30000,243000
16,19,10,-1,2,231000,30000,261000
11,5,14,-1,2,291000,45000,336000
10,12,20,-1,2,174000,15000,189000
6,18,16,-1,2,246000,15000,261000
17,10,12,-1,2,258000,45000,303000
15,14,19,12,2,216000,60000,276000
11,13,9,-1,2,285000,75000,360000
8,17,6,-1,2,219000,15000,234000
7,5,12,-1,2,258000,45000,303000
8,13,11,-1,2,240000,75000,315000
13,14,5,-1,2,240000,30000,270000
11,8,19,-1,2,201000,15000,216000
17,19,8,13,2,276000,220000,496000
14,11,19,-1,2,231000,45000,276000
6,5,10,-1,2,288000,60000,348000
5,11,20,-1,1,171000,0,171000
18,20,12,-1,2,201000,30000,231000
13,14,16,-1,2,219000,30000,249000
10,8,19,-1,2,219000,15000,234000
5,11,6,13,2,330000,295000,625000
12,20,15,-1,2,231000,45000,276000
18,5,7,-1,2,255000,15000,270000
9,6,17,-1,2,228000,15000,243000
17,12,14,-1,2,231000,45000,276000
17,18,5,-1,2,231000,30000,261000
7,8,14,-1,2,297000,60000,357000
20,6,17,13,2,231000,190000,421000
19,16,19,-1,2,138000,15000,153000
16,17,10,-1,2,243000,45000,288000
15,6,19,-1,2,234000,15000,249000
9,15,14,-1,2,255000,75000,330000
18,14,7,-1,2,219000,30000,249000
6,7,15,-1,2,276000,45000,321000
8,15,5,13,2,276000,265000,541000
5,8,17,-1,2,264000,15000,279000
14,17,12,-1,2,222000,45000,267000
12,13,19,-1,2,252000,60000,312000
9,20,10,-1,2,231000,30000,261000
20,16,5,-1,2,225000,15000,240000
18,8,9,-1,2,249000,30000,279000
6,14,8,12,2,312000,265000,577000
8,16,11,-1,2,285000,45000,330000
20,19,8,-1,2,174000,30000,204000
12,19,7,-1,1,180000,0,180000
18,7,19,-1,2,222000,30000,252000
16,17,11,-1,2,255000,75000,330000
5,8,10,-1,2,285000,75000,360000
13,9,14,12,2,252000,255000,507000
16,20,11,-1,2,180000,15000,195000
15,7,20,-1,2,234000,15000,249000
6,13,6,-1,1,180000,0,180000
7,19,8,-1,2,213000,30000,243000
14,15,6,-1,2,249000,30000,279000
13,8,11,-1,2,258000,75000,333000
10,17,18,12,2,261000,245000,506000
14,6,7,-1,2,234000,0,234000
10,12,10,-1,2,156000,15000,171000
18,7,13,-1,2,201000,30000,231000
9,11,6,-1,2,276000,75000,351000
20,15,12,-1,2,204000,45000,249000
13,11,10,-1,2,279000,105000,384000
7,14,10,13,2,276000,370000,646000
19,6,18,-1,2,186000,30000,216000
9,8,12,-1,2,306000,90000,396000
20,8,10,-1,2,192000,15000,207000
18,8,9,-1,2,240000,30000,270000
18,8,6,-1,2,246000,15000,261000
8,20,17,-1,2,201000,15000,216000
6,15,11,13,2,303000,345000,648000
13,5,17,-1,2,207000,15000,222000
20,16,15,-1,2,195000,60000,255000
6,5,16,-1,2,234000,0,234000
20,11,19,-1,2,165000,30000,195000
19,8,12,-1,1,180000,0,180000
8,11,14,-1,2,276000,45000,321000
14,9,11,13,2,258000,345000,603000
7,13,14,-1,2,231000,30000,261000
11,13,15,-1,2,222000,75000,297000
5,10,11,-1,2,264000,75000,339000
9,8,15,-1,2,252000,60000,312000
19,5,7,-1,2,201000,15000,216000
14,7,11,-1,2,264000,45000,309000
20,13,10,11,2,273000,190000,463000
6,7,20,-1,2,258000,30000,288000
5,7,16,-1,2,255000,15000,270000
19,14,10,-1,2,207000,30000,237000
11,6,19,-1,2,234000,15000,249000
10,8,18,-1,2,219000,15000,234000
19,16,19,-1,2,156000,15000,171000
20,16,7,13,2,276000,205000,481000
5,20,6,-1,2,222000,30000,252000
6,11,16,-1,2,270000,30000,300000
19,6,20,-1,2,165000,30000,195000
20,6,7,-1,2,198000,0,198000
14,20,12,-1,2,228000,30000,258000
10,19,17,-1,2,231000,30000,261000
7,13,19,11,2,318000,190000,508000
15,5,19,-1,2,243000,15000,258000
13,18,15,-1,2,231000,45000,276000
15,5,10,-1,2,279000,30000,309000
15,19,6,-1,2,189000,15000,204000
16,15,9,-1,2,243000,45000,288000
18,15,5,-1,2,237000,15000,252000
12,17,11,13,2,276000,330000,606000
7,11,17,-1,2,243000,30000,273000
8,19,11,-1,2,201000,15000,216000
17,9,12,-1,2,276000,45000,321000
6,17,14,-1,2,228000,15000,243000
15,10,19,-1,2,225000,30000,255000
5,16,12,-1,2,255000,30000,285000
7,16,10,12,2,279000,315000,594000
17,12,14,-1,2,258000,45000,303000
12,9,5,-1,2,273000,45000,318000
17,6,8,-1,2,210000,15000,225000
12,13,17,-1,2,234000,60000,294000
17,7,11,-1,2,261000,30000,291000
12,18,8,-1,2,225000,30000,255000
5,12,9,13,2,297000,295000,592000
5,18,14,-1,2,252000,15000,267000
14,20,6,-1,1,189000,0,189000
5,13,14,-1,2,288000,45000,333000
13,12,12,-1,2,177000,30000,207000
11,20,18,-1,2,165000,30000,195000
10,12,16,-1,2,201000,30000,231000
20,8,5,12,2,294000,205000,499000
19,17,16,-1,2,201000,105000,306000
13,17,10,-1,2,240000,45000,285000
5,11,8,-1,2,276000,45000,321000
19,16,14,-1,2,186000,45000,231000
19,18,15,-1,2,207000,90000,297000
7,14,5,-1,2,255000,30000,285000
5,15,18,11,2,273000,190000,463000
20,5,6,-1,2,261000,45000,306000
17,13,20,-1,2,219000,45000,264000
14,13,12,-1,2,270000,90000,360000
8,14,20,-1,2,216000,15000,231000
17,5,10,-1,2,252000,15000,267000
5,18,11,-1,2,225000,15000,240000
7,9,13,12,2,297000,370000,667000
16,12,9,-1,2,285000,45000,330000
6,9,20,-1,2,219000,15000,234000
18,7,17,-1,2,231000,30000,261000
13,20,14,-1,2,252000,60000,312000
14,9,18,-1,2,252000,30000,282000
13,17,7,-1,2,228000,30000,258000
14,19,11,13,2,258000,265000,523000
18,6,15,-1,2,219000,15000,234000
17,11,16,-1,2,237000,75000,312000
10,20,17,-1,2,210000,30000,240000
6,12,11,-1,2,231000,30000,261000
15,20,9,-1,2,183000,30000,213000
8,17,16,-1,2,249000,30000,279000
7,8,17,11,2,324000,310000,634000
8,19,12,-1,2,225000,15000,240000
12,13,7,-1,2,282000,75000,357000
8,11,15,-1,2,240000,45000,285000
14,10,19,-1,2,207000,30000,237000
15,17,18,-1,2,201000,90000,291000
16,19,7,-1,2,192000,15000,207000
8,12,11,12,2,270000,240000,510000
11,16,5,-1,2,246000,30000,276000
18,10,14,-1,2,219000,45000,264000
19,11,5,-1,1,198000,0,198000
18,20,11,-1,2,210000,30000,240000
5,10,20,-1,1,171000,0,171000
17,12,8,-1,2,252000,30000,282000
17,12,6,11,2,291000,265000,556000
7,19,6,-1,2,267000,30000,297000
17,19,10,-1,2,213000,30000,243000
14,13,9,-1,2,264000,75000,339000
6,18,20,-1,2,192000,15000,207000
19,20,9,-1,2,219000,30000,249000
18,7,12,-1,1,180000,0,180000
10,5,11,12,2,318000,400000,718000
20,18,19,-1,2,168000,60000,228000
6,5,15,-1,2,288000,45000,333000
8,17,9,-1,2,249000,45000,294000
16,11,9,-1,2,240000,45000,285000
19,20,13,-1,2,156000,45000,201000
16,6,14,-1,2,228000,15000,243000
9,6,10,12,2,309000,310000,619000
12,20,18,-1,2,201000,30000,231000
6,20,19,-1,2,165000,30000,195000
12,11,5,-1,2,240000,30000,270000
14,13,8,-1,2,228000,75000,303000
20,12,18,-1,2,165000,30000,195000
20,15,7,-1,2,189000,15000,204000
17,19,9,12,2,288000,215000,503000
20,16,18,-1,2,156000,30000,186000
11,14,9,-1,2,231000,30000,261000
11,19,16,-1,2,210000,45000,255000
18,12,8,-1,2,252000,30000,282000
14,15,18,-1,2,216000,90000,306000
5,5,13,-1,1,198000,0,198000
20,17,8,12,2,252000,185000,437000
16,18,17,-1,2,192000,45000,237000
19,14,5,-1,2,252000,15000,267000
5,6,13,-1,2,276000,45000,321000
15,8,6,-1,2,237000,30000,267000
15,8,20,-1,2,180000,15000,195000
16,8,7,-1,2,294000,45000,339000
15,12,20,11,2,204000,45000,249000
5,8,19,-1,2,255000,15000,270000
18,5,19,-1,2,213000,30000,243000
16,19,8,-1,2,246000,15000,261000
12,14,5,-1,2,276000,30000,306000
18,20,14,-1,2,162000,45000,207000
13,7,15,-1,2,219000,15000,234000
14,19,15,13,2,207000,60000,267000
16,15,17,-1,2,231000,90000,321000
12,10,14,-1,2,222000,30000,252000
16,5,10,-1,2,216000,15000,231000
13,7,9,-1,2,258000,45000,303000
17,15,18,-1,2,165000,90000,255000
15,13,9,-1,2,219000,15000,234000
11,20,6,13,2,258000,285000,543000
13,19,15,-1,2,183000,30000,213000
6,12,18,-1,2,243000,15000,258000
16,19,11,-1,2,228000,45000,273000
8,12,20,-1,2,216000,15000,231000
16,19,15,-1,2,222000,90000,312000
15,14,16,-1,2,210000,45000,255000
10,20,6,11,2,318000,270000,588000
6,14,18,-1,2,252000,15000,267000
13,17,19,-1,2,210000,45000,255000
17,12,10,-1,2,276000,45000,321000
20,11,5,-1,1,189000,0,189000
7,18,9,-1,2,246000,15000,261000
17,16,9,-1,2,234000,45000,279000
16,11,8,13,2,285000,330000,615000
5,10,8,-1,2,231000,30000,261000
5,17,9,-1,2,207000,15000,222000
12,20,18,-1,2,174000,30000,204000
7,11,14,-1,2,237000,15000,252000
7,15,19,-1,2,189000,15000,204000
15,9,17,-1,2,231000,30000,261000
18,6,16,13,2,267000,235000,502000
7,8,6,-1,2,270000,90000,360000
17,8,16,-1,2,204000,30000,234000
10,7,17,-1,2,273000,30000,303000
19,14,10,-1,2,207000,30000,237000
18,5,12,-1,2,243000,15000,258000
10,13,16,-1,2,240000,45000,285000
9,7,19,13,2,294000,180000,474000
10,20,15,-1,2,252000,30000,282000
20,8,14,-1,2,216000,15000,231000
11,8,14,-1,2,285000,45000,330000
12,8,9,-1,2,261000,90000,351000
6,7,9,-1,2,252000,105000,357000
18,12,17,-1,2,192000,75000,267000
20,12,9,11,2,318000,205000,523000
11,8,6,-1,2,294000,45000,339000
9,17,13,-1,2,219000,45000,264000
14,18,7,-1,2,219000,30000,249000
12,19,16,-1,2,219000,45000,264000
16,10,8,-1,2,273000,30000,303000
12,13,16,-1,2,225000,90000,315000
10,6,15,12,2,306000,330000,636000
8,11,19,-1,2,246000,15000,261000
13,14,15,-1,2,252000,90000,342000
18,19,14,-1,2,207000,75000,282000
16,9,7,-1,2,225000,15000,240000
13,12,20,-1,2,204000,45000,249000
5,8,7,-1,2,285000,90000,375000
13,10,16,12,2,252000,265000,517000
5,15,11,-1,2,225000,15000,240000
14,10,8,-1,2,240000,45000,285000
7,19,10,-1,2,201000,15000,216000
17,13,20,-1,2,219000,45000,264000
20,12,6,-1,1,216000,0,216000
16,8,20,-1,2,234000,15000,249000
14,15,6,12,2,297000,225000,522000
18,15,11,-1,2,201000,15000,216000
20,10,9,-1,2,231000,30000,261000
5,19,14,-1,2,243000,15000,258000
7,11,16,-1,2,252000,30000,282000
15,13,20,-1,2,204000,45000,249000
12,17,16,-1,2,237000,75000,312000
6,18,19,13,2,276000,245000,521000
11,9,15,-1,2,249000,45000,294000
17,13,10,-1,2,231000,45000,276000
6,13,10,-1,2,264000,45000,309000
12,8,18,-1,2,216000,30000,246000
10,8,19,-1,2,210000,15000,225000
16,9,19,-1,2,231000,30000,261000
10,19,8,13,2,303000,310000,613000
17,14,5,-1,2,210000,15000,225000
11,5,14,-1,2,258000,30000,288000
7,16,14,-1,2,222000,30000,252000
13,18,6,-1,2,216000,15000,231000
13,11,20,-1,2,228000,30000,258000
11,10,5,-1,2,273000,75000,348000
18,12,9,11,2,273000,235000,508000
17,13,11,-1,2,267000,45000,312000
13,10,17,-1,2,249000,45000,294000
15,18,8,-1,2,231000,30000,261000
20,11,18,-1,2,201000,30000,231000
9,18,8,-1,2,207000,0,207000
13,15,5,-1,2,237000,15000,252000
16,17,9,11,2,282000,245000,527000
7,6,9,-1,2,306000,105000,411000
14,7,6,-1,2,249000,45000,294000
9,7,16,-1,2,237000,30000,267000
8,15,11,-1,2,240000,45000,285000
14,17,11,-1,2,222000,45000,267000
14,11,5,-1,2,267000,30000,297000
14,20,6,12,2,261000,190000,451000
19,13,11,-1,2,189000,15000,204000
8,13,15,-1,2,264000,45000,309000
13,15,17,-1,2,204000,75000,279000
11,18,12,-1,2,270000,60000,330000
20,8,11,-1,2,219000,15000,234000
8,11,13,-1,2,285000,75000,360000
15,14,12,13,2,240000,255000,495000
12,16,14,-1,2,222000,75000,297000
7,13,16,-1,2,249000,30000,279000
17,10,6,-1,2,225000,15000,240000
13,17,7,-1,2,228000,30000,258000
8,12,15,-1,2,255000,45000,300000
13,14,18,-1,2,216000,60000,276000
12,19,7,11,2,318000,205000,523000
15,20,5,-1,2,243000,15000,258000
16,12,19,-1,2,228000,45000,273000
14,18,20,-1,2,207000,45000,252000
14,20,5,-1,1,162000,0,162000
7,18,5,-1,2,267000,30000,297000
11,10,20,-1,2,204000,30000,234000
16,17,6,11,2,327000,245000,572000
15,12,8,-1,2,282000,45000,327000
19,6,15,-1,2,198000,15000,213000
17,13,14,-1,2,243000,90000,333000
12,7,16,-1,2,270000,30000,300000
9,18,19,-1,2,195000,30000,225000
19,20,5,-1,2,219000,30000,249000
11,16,7,13,2,273000,185000,458000
17,15,8,-1,2,249000,30000,279000
6,8,5,-1,2,279000,105000,384000
16,12,10,-1,2,222000,45000,267000
14,16,11,-1,2,231000,75000,306000
10,17,9,-1,2,267000,45000,312000
12,9,15,-1,2,249000,45000,294000
13,19,13,12,1,117000,0,117000
15,8,18,-1,2,249000,30000,279000
18,9,6,-1,2,246000,15000,261000
9,14,8,-1,2,279000,60000,339000
17,18,20,-1,2,135000,90000,225000
12,16,6,-1,2,246000,30000,276000
9,19,5,-1,2,216000,15000,231000
12,6,5,11,2,321000,280000,601000
6,20,17,-1,2,210000,15000,225000
12,19,14,-1,2,258000,45000,303000
18,17,5,-1,2,231000,30000,261000
19,8,11,-1,2,237000,15000,252000
15,17,11,-1,2,246000,45000,291000
13,5,14,-1,2,267000,30000,297000
9,19,6,12,2,288000,295000,583000
6,18,11,-1,2,252000,15000,267000
17,7,20,-1,2,210000,15000,225000
20,18,9,-1,2,228000,15000,243000
5,19,15,-1,2,243000,15000,258000
18,13,19,-1,2,207000,75000,282000
8,18,20,-1,2,165000,15000,180000
12,9,12,11,2,279000,175000,454000
19,20,15,-1,2,159000,75000,234000
14,6,12,-1,2,240000,30000,270000
11,16,18,-1,2,210000,45000,255000
7,12,10,-1,2,285000,75000,360000
15,11,20,-1,2,189000,30000,219000
17,13,15,-1,2,240000,75000,315000
6,16,17,11,2,318000,245000,563000
20,14,7,-1,2,243000,15000,258000
19,5,15,-1,2,225000,15000,240000
9,12,6,-1,2,285000,45000,330000
16,7,18,-1,2,192000,15000,207000
15,20,14,-1,2,234000,60000,294000
15,17,6,-1,2,255000,15000,270000
9,20,5,11,2,306000,270000,576000
12,18,17,-1,2,237000,75000,312000
9,8,19,-1,2,249000,30000,279000
16,20,14,-1,2,222000,45000,267000
18,19,6,-1,2,240000,30000,270000
7,14,6,-1,2,303000,45000,348000
12,10,8,-1,2,240000,75000,315000
20,18,13,13,2,231000,215000,446000
13,7,14,-1,2,243000,45000,288000
18,15,19,-1,2,171000,90000,261000
11,13,14,-1,2,231000,90000,321000
18,8,11,-1,2,255000,30000,285000
8,13,17,-1,2,234000,30000,264000
10,17,6,-1,2,216000,15000,231000
15,17,9,13,2,258000,250000,508000
13,18,7,-1,2,219000,30000,249000
9,11,10,-1,2,270000,90000,360000
18,15,17,-1,2,174000,90000,264000
10,7,5,-1,2,240000,30000,270000
17,6,16,-1,2,204000,30000,234000
14,6,17,-1,2,246000,15000,261000
13,16,9,11,2,300000,250000,550000
10,19,12,-1,2,264000,30000,294000
14,20,13,-1,2,234000,60000,294000
12,10,5,-1,2,282000,45000,327000
16,13,10,-1,2,222000,45000,267000
14,19,5,-1,2,225000,15000,240000
12,5,11,-1,2,270000,45000,315000
8,14,16,12,2,252000,250000,502000
13,9,17,-1,2,207000,15000,222000
19,15,12,-1,2,222000,45000,267000
15,9,6,-1,2,291000,30000,321000
7,6,11,-1,2,252000,60000,312000
13,14,18,-1,2,207000,60000,267000
17,16,8,-1,2,249000,30000,279000
14,13,12,11,2,252000,90000,342000
9,13,20,-1,2,207000,15000,222000
7,14,9,-1,2,294000,45000,339000
19,16,10,-1,2,186000,30000,216000
10,13,14,-1,2,276000,90000,366000
10,15,9,-1,2,270000,60000,330000
17,20,8,-1,2,192000,15000,207000
18,9,8,13,2,321000,195000,516000
17,11,6,-1,2,252000,15000,267000
18,9,17,-1,2,222000,30000,252000
6,11,8,-1,2,285000,45000,330000
11,13,17,-1,2,213000,45000,258000
12,6,15,-1,2,249000,30000,279000
15,18,9,-1,2,213000,30000,243000
20,8,7,11,2,333000,295000,628000
8,6,20,-1,2,237000,15000,252000
19,8,9,-1,2,240000,30000,270000
7,18,12,-1,2,225000,15000,240000
16,11,12,-1,2,261000,60000,321000
20,7,12,-1,2,216000,15000,231000
6,17,19,-1,2,219000,15000,234000
17,11,13,12,2,297000,265000,562000
15,14,8,-1,2,222000,30000,252000
6,14,13,-1,2,252000,45000,297000
11,13,12,-1,2,234000,90000,324000
11,7,20,-1,2,216000,15000,231000
13,18,20,-1,2,207000,45000,252000
9,10,14,-1,2,237000,30000,267000
11,18,15,12,2,252000,235000,487000
19,14,11,-1,2,189000,15000,204000
13,19,5,-1,1,207000,0,207000
5,20,6,-1,2,249000,30000,279000
9,15,16,-1,2,243000,45000,288000
8,13,14,-1,2,264000,75000,339000
20,17,13,-1,2,192000,45000,237000
9,11,14,13,2,303000,345000,648000
19,12,5,-1,1,180000,0,180000
10,11,8,-1,2,276000,90000,366000
10,16,8,-1,2,228000,30000,258000
9,16,7,-1,2,246000,30000,276000
11,15,13,-1,2,213000,75000,288000
6,19,7,-1,2,240000,30000,270000
9,19,8,12,2,306000,295000,601000
6,19,7,-1,2,267000,30000,297000
16,15,18,-1,2,204000,105000,309000
18,7,8,-1,2,216000,0,216000
6,7,14,-1,2,267000,45000,312000
17,19,16,-1,2,156000,105000,261000
13,13,5,-1,1,162000,0,162000
18,9,12,13,2,240000,315000,555000
10,17,20,-1,2,192000,30000,222000
17,20,16,-1,2,183000,30000,213000
10,5,9,-1,2,294000,120000,414000
13,7,11,-1,2,237000,45000,282000
8,19,7,-1,2,213000,30000,243000
14,9,5,-1,2,261000,30000,291000
18,11,7,13,2,249000,300000,549000
8,14,5,-1,2,225000,15000,240000
5,8,17,-1,2,219000,15000,234000
20,17,5,-1,2,201000,15000,216000
7,16,10,-1,2,291000,30000,321000
6,19,11,-1,2,207000,15000,222000
12,17,18,-1,2,219000,75000,294000
16,20,8,11,2,318000,185000,503000
14,9,20,-1,2,225000,15000,240000
10,7,16,-1,2,291000,30000,321000
14,7,9,-1,2,249000,45000,294000
5,18,15,-1,2,201000,15000,216000
18,7,15,-1,2,237000,15000,252000
12,8,14,-1,2,264000,45000,309000
18,12,14,13,2,240000,265000,505000
11,12,13,-1,2,243000,90000,333000
8,13,7,-1,2,279000,60000,339000
5,16,8,-1,2,219000,15000,234000
9,16,5,-1,2,225000,15000,240000
18,13,17,-1,2,201000,75000,276000
5,6,17,-1,2,288000,45000,333000
16,9,19,11,2,282000,185000,467000
11,17,12,-1,2,279000,60000,339000
5,9,14,-1,2,261000,30000,291000
17,15,5,-1,2,201000,15000,216000
19,16,7,-1,2,219000,15000,234000
8,6,10,-1,2,285000,75000,360000
5,6,13,-1,2,249000,45000,294000
8,13,17,12,2,252000,265000,517000
20,16,19,-1,2,156000,45000,201000
17,12,10,-1,2,231000,45000,276000
5,20,8,-1,2,219000,15000,234000
20,18,5,-1,2,210000,15000,225000
11,14,13,-1,2,267000,90000,357000
19,8,5,-1,2,237000,15000,252000
17,13,5,12,2,279000,265000,544000
15,10,8,-1,2,228000,30000,258000
12,20,11,-1,2,213000,45000,258000
6,11,17,-1,2,234000,15000,249000
11,8,10,-1,2,267000,90000,357000
19,7,17,-1,2,183000,15000,198000
10,13,8,-1,2,285000,45000,330000
15,20,8,12,2,252000,175000,427000
13,7,18,-1,2,207000,15000,222000
15,8,13,-1,2,246000,45000,291000
10,12,11,-1,2,243000,90000,333000
12,20,15,-1,2,222000,45000,267000
5,7,18,-1,2,255000,15000,270000
13,10,17,-1,2,240000,45000,285000
20,12,5,11,2,300000,205000,505000
19,13,9,-1,2,261000,30000,291000
19,5,18,-1,2,213000,30000,243000
6,11,16,-1,2,288000,30000,318000
10,19,8,-1,2,192000,15000,207000
7,9,16,-1,2,273000,30000,303000
18,13,10,-1,2,222000,45000,267000
16,13,12,11,2,243000,90000,333000
5,10,8,-1,2,285000,75000,360000
8,12,10,-1,2,240000,75000,315000
9,17,7,-1,2,201000,15000,216000
9,10,8,-1,2,279000,90000,369000
5,9,8,-1,2,249000,90000,339000
15,20,7,-1,2,189000,15000,204000
15,16,19,11,2,213000,90000,303000
18,12,13,-1,2,216000,15000,231000
14,7,8,-1,2,279000,60000,339000
9,17,16,-1,2,207000,45000,252000
13,5,11,-1,2,267000,30000,297000
8,13,15,-1,2,228000,45000,273000
12,5,10,-1,2,246000,45000,291000
18,15,19,12,2,153000,90000,243000
11,7,20,-1,2,207000,15000,222000
9,20,14,-1,2,207000,15000,222000
7,14,13,-1,2,279000,45000,324000
16,20,15,-1,2,195000,60000,255000
10,16,13,-1,2,222000,30000,252000
9,18,17,-1,2,213000,30000,243000
13,7,20,11,2,318000,190000,508000
6,19,7,-1,2,267000,30000,297000
16,8,14,-1,2,231000,30000,261000
14,13,8,-1,2,255000,75000,330000
13,16,12,-1,2,225000,90000,315000
9,8,20,-1,2,240000,30000,270000
15,16,18,-1,2,213000,105000,318000
9,8,15,11,2,291000,170000,461000
15,12,10,-1,2,249000,45000,294000
10,8,19,-1,2,210000,15000,225000
6,13,20,-1,1,198000,0,198000
17,20,6,-1,2,237000,15000,252000
5,10,13,-1,2,291000,45000,336000
8,15,9,-1,2,252000,60000,312000
19,5,18,12,2,240000,245000,485000
8,15,12,-1,2,237000,45000,282000
14,9,8,-1,2,261000,60000,321000
9,10,19,-1,2,195000,30000,225000
17,20,16,-1,2,201000,90000,291000
15,12,5,-1,2,249000,30000,279000
19,13,17,-1,2,192000,45000,237000
14,20,7,12,2,306000,190000,496000
16,10,12,-1,2,210000,30000,240000
6,7,18,-1,2,240000,30000,270000
14,19,16,-1,2,204000,45000,249000
13,15,8,-1,2,282000,45000,327000
6,8,10,-1,2,249000,75000,324000
12,16,8,-1,2,228000,45000,273000
19,7,16,11,2,282000,185000,467000
9,5,17,-1,2,264000,30000,294000
15,14,6,-1,2,240000,30000,270000
12,16,18,-1,2,210000,45000,255000
16,20,16,-1,2,153000,15000,168000
14,15,6,-1,2,267000,30000,297000
18,16,8,-1,2,210000,15000,225000
18,14,20,12,2,198000,45000,243000
19,11,5,-1,1,189000,0,189000
17,11,19,-1,2,204000,30000,234000
10,5,15,-1,2,288000,30000,318000
9,13,18,-1,2,207000,30000,237000
13,7,6,-1,2,279000,60000,339000
17,9,18,-1,2,195000,30000,225000
19,9,12,11,2,318000,205000,523000
11,9,18,-1,2,273000,30000,303000
7,8,9,-1,2,270000,90000,360000
20,19,13,-1,2,147000,45000,192000
9,13,10,-1,2,261000,90000,351000
16,8,18,-1,2,201000,15000,216000
15,16,12,-1,2,240000,90000,330000
10,19,17,12,2,297000,215000,512000
18,20,17,-1,2,171000,30000,201000
12,8,18,-1,1,180000,0,180000
10,15,11,-1,2,270000,60000,330000
10,17,13,-1,2,240000,45000,285000
6,18,10,-1,2,225000,15000,240000
10,7,12,-1,2,276000,75000,351000
16,6,8,12,2,276000,210000,486000
7,18,20,-1,2,219000,15000,234000
20,5,6,-1,2,261000,45000,306000
7,10,12,-1,2,285000,75000,360000
5,18,16,-1,2,192000,15000,207000
14,8,12,-1,2,264000,45000,309000
12,15,10,-1,2,231000,45000,276000
9,17,10,11,2,300000,315000,615000
10,9,11,-1,2,297000,90000,387000
17,16,14,-1,2,195000,90000,285000
12,17,10,-1,2,276000,45000,321000
19,15,7,-1,2,207000,15000,222000
19,19,9,-1,1,153000,0,153000
5,10,13,-1,2,264000,45000,309000
17,8,14,12,2,252000,250000,502000
20,17,10,-1,2,183000,15000,198000
16,13,14,-1,2,261000,105000,366000
14,10,5,-1,2,279000,30000,309000
13,5,9,-1,2,237000,45000,282000
11,9,20,-1,2,183000,15000,198000
15,5,13,-1,2,264000,15000,279000
7,19,18,12,2,249000,245000,494000
9,16,13,-1,2,228000,45000,273000
5,19,11,-1,1,189000,0,189000
8,17,5,-1,2,264000,15000,279000
9,17,14,-1,2,237000,45000,282000
9,5,7,-1,2,258000,75000,333000
9,14,15,-1,2,219000,75000,294000
8,19,12,13,2,258000,315000,573000
18,13,19,-1,2,189000,75000,264000
5,10,8,-1,2,222000,30000,252000
5,14,10,-1,2,234000,30000,264000
7,17,19,-1,2,183000,15000,198000
11,20,5,-1,1,216000,0,216000
14,8,11,-1,2,285000,45000,330000
8,11,16,12,2,270000,330000,600000
16,20,7,-1,2,180000,15000,195000
5,13,18,-1,2,252000,15000,267000
8,12,18,-1,2,234000,30000,264000
12,9,20,-1,2,201000,15000,216000
17,20,10,-1,2,228000,30000,258000
17,10,11,-1,2,225000,15000,240000
14,8,12,11,2,282000,280000,562000
9,13,6,-1,2,303000,45000,348000
5,16,19,-1,2,192000,15000,207000
7,6,9,-1,2,297000,105000,402000
15,19,11,-1,2,201000,45000,246000
12,5,13,-1,2,279000,45000,324000
8,15,17,-1,2,204000,30000,234000
17,20,5,12,2,279000,185000,464000
19,13,20,-1,2,165000,30000,195000
9,15,20,-1,2,189000,15000,204000
16,15,14,-1,2,234000,90000,324000
10,13,20,-1,2,264000,30000,294000
19,17,8,-1,2,219000,15000,234000
13,12,14,-1,2,261000,90000,351000
13,11,12,11,2,309000,255000,564000
10,17,18,-1,2,252000,45000,297000
19,17,8,-1,2,228000,15000,243000
8,7,17,-1,2,258000,30000,288000
20,5,7,-1,2,219000,15000,234000
14,13,16,-1,2,243000,105000,348000
16,17,5,-1,2,249000,30000,279000
19,12,6,13,2,276000,315000,591000
10,8,13,-1,2,258000,45000,303000
20,10,10,-1,1,108000,0,108000
7,13,16,-1,2,249000,30000,279000
13,15,5,-1,2,246000,15000,261000
16,19,7,-1,2,201000,15000,216000
13,19,10,-1,2,255000,30000,285000
17,7,9,11,2,315000,300000,615000
18,17,7,-1,2,240000,30000,270000
15,9,6,-1,2,291000,30000,321000
11,20,19,-1,2,165000,30000,195000
17,20,5,-1,2,183000,15000,198000
10,13,5,-1,2,291000,45000,336000
9,11,16,-1,2,231000,45000,276000
8,15,18,12,2,261000,235000,496000
10,7,6,-1,2,246000,30000,276000
11,17,18,-1,2,189000,45000,234000
8,17,5,-1,2,276000,30000,306000
5,12,12,-1,1,162000,0,162000
6,16,7,-1,2,222000,30000,252000
17,13,9,-1,2,237000,45000,282000
20,6,12,11,2,291000,205000,496000
10,8,15,-1,2,294000,45000,339000
17,19,5,-1,2,183000,15000,198000
6,11,19,-1,2,243000,15000,258000
7,9,15,-1,2,264000,30000,294000
19,12,13,-1,2,216000,60000,276000
12,17,5,-1,2,243000,15000,258000
11,12,16,13,2,258000,345000,603000
10,16,5,-1,2,225000,15000,240000
18,11,19,-1,2,195000,45000,240000
12,15,20,-1,2,171000,15000,186000
9,5,17,-1,2,252000,15000,267000
19,15,18,-1,2,171000,90000,261000
16,17,19,-1,2,174000,105000,279000
18,13,9,12,2,270000,265000,535000
6,20,18,-1,2,174000,15000,189000
7,13,19,-1,2,243000,15000,258000
5,18,10,-1,2,243000,15000,258000
20,13,17,-1,2,201000,45000,246000
6,10,15,-1,2,288000,30000,318000
18,5,13,-1,2,207000,15000,222000
17,8,10,11,2,300000,315000,615000
14,13,7,-1,2,279000,45000,324000
10,17,9,-1,2,249000,45000,294000
19,9,16,-1,2,213000,30000,243000
19,7,20,-1,2,210000,30000,240000
19,14,20,-1,2,165000,30000,195000
5,14,19,-1,2,198000,15000,213000
20,18,8,12,2,267000,215000,482000
6,17,18,-1,2,204000,30000,234000
10,7,19,-1,2,246000,15000,261000
14,10,19,-1,2,234000,30000,264000
14,13,12,-1,2,252000,90000,342000
13,13,19,-1,1,135000,0,135000
13,11,16,-1,2,258000,45000,303000
10,5,6,12,2,321000,295000,616000
13,6,20,-1,1,189000,0,189000
5,10,13,-1,2,291000,45000,336000
8,16,11,-1,2,240000,45000,285000
19,14,15,-1,2,207000,60000,267000
19,10,16,-1,2,240000,30000,270000
7,16,17,-1,2,258000,30000,288000
19,12,7,11,2,309000,205000,514000
14,10,9,-1,2,297000,60000,357000
15,20,10,-1,2,207000,30000,237000
17,10,18,-1,2,234000,45000,279000
5,20,19,-1,2,210000,30000,240000
6,13,16,-1,2,219000,15000,234000
12,10,9,-1,2,261000,105000,366000
13,19,15,12,2,204000,45000,249000
16,19,11,-1,2,246000,45000,291000
9,10,19,-1,2,231000,30000,261000
8,12,14,-1,2,273000,45000,318000
9,7,5,-1,2,249000,75000,324000
20,7,16,-1,2,180000,15000,195000
13,20,8,-1,2,225000,15000,240000
5,18,8,13,2,321000,195000,516000
18,5,16,-1,2,237000,15000,252000
14,16,19,-1,2,222000,45000,267000
11,7,12,-1,2,291000,75000,366000
8,14,13,-1,2,228000,75000,303000
14,10,6,-1,2,246000,45000,291000
12,20,10,-1,2,174000,15000,189000
9,14,18,11,2,327000,205000,532000
18,20,7,-1,2,228000,15000,243000
7,16,6,-1,2,276000,30000,306000
8,17,5,-1,2,237000,15000,252000
19,11,13,-1,2,219000,30000,249000
19,14,17,-1,2,210000,75000,285000
13,14,15,-1,2,219000,45000,264000
7,17,6,12,2,312000,195000,507000
14,11,17,-1,2,249000,45000,294000
20,16,10,-1,2,210000,30000,240000
18,12,17,-1,2,246000,75000,321000
6,14,13,-1,2,279000,45000,324000
8,15,10,-1,2,249000,45000,294000
14,17,20,-1,2,174000,45000,219000
6,7,16,13,2,279000,145000,424000
14,20,15,-1,2,234000,60000,294000
10,14,18,-1,2,264000,45000,309000
11,16,17,-1,2,228000,75000,303000
5,14,8,-1,2,282000,30000,312000
20,14,16,-1,2,186000,45000,231000
7,11,14,-1,2,291000,45000,336000
18,11,17,12,2,252000,245000,497000
9,17,19,-1,2,183000,15000,198000
16,20,18,-1,2,189000,75000,264000
18,11,10,-1,2,240000,45000,285000
14,19,5,-1,2,225000,15000,240000
10,17,12,-1,2,249000,45000,294000
5,8,19,-1,2,228000,15000,243000
11,14,18,12,2,279000,250000,529000
20,5,12,-1,1,180000,0,180000
15,5,19,-1,2,225000,15000,240000
16,14,10,-1,2,246000,45000,291000
7,8,17,-1,2,240000,30000,270000
17,18,12,-1,2,219000,75000,294000
15,16,11,-1,2,246000,75000,321000
19,5,15,12,2,288000,205000,493000
11,10,13,-1,2,246000,30000,276000
8,15,9,-1,2,252000,60000,312000
7,10,13,-1,2,249000,45000,294000
9,13,14,-1,2,219000,75000,294000
10,20,13,-1,2,228000,30000,258000
19,5,11,-1,1,207000,0,207000
16,8,6,11,2,333000,325000,658000
11,14,6,-1,2,282000,45000,327000
12,20,17,-1,2,192000,45000,237000
19,18,11,-1,2,222000,45000,267000
10,8,17,-1,2,207000,15000,222000
16,6,14,-1,2,219000,15000,234000
8,12,19,-1,2,198000,15000,213000
5,6,19,12,2,327000,180000,507000
7,8,15,-1,2,285000,45000,330000
13,6,8,-1,2,240000,45000,285000
7,16,15,-1,2,213000,30000,243000
14,19,10,-1,2,225000,30000,255000
12,17,5,-1,2,243000,15000,258000
10,11,20,-1,2,204000,30000,234000
19,12,10,13,2,294000,315000,609000
19,8,15,-1,2,210000,30000,240000
11,10,19,-1,2,258000,45000,303000
11,14,6,-1,2,264000,45000,309000
10,8,7,-1,2,252000,105000,357000
20,5,16,-1,2,180000,15000,195000
14,10,16,-1,2,255000,45000,300000
14,17,6,11,2,300000,235000,535000
15,16,18,-1,2,231000,105000,336000
18,12,19,-1,2,186000,30000,216000
20,17,11,-1,2,219000,30000,249000
20,5,12,-1,1,180000,0,180000
19,10,12,-1,2,246000,30000,276000
11,15,7,-1,2,264000,45000,309000
8,17,12,11,2,273000,265000,538000
13,19,20,-1,2,201000,45000,246000
14,12,16,-1,2,222000,75000,297000
7,13,11,-1,2,273000,45000,318000
18,19,19,-1,2,114000,30000,144000
8,10,16,-1,2,282000,30000,312000
10,19,15,-1,2,207000,30000,237000
10,5,15,11,2,318000,330000,648000
10,7,15,-1,2,303000,45000,348000
16,15,7,-1,2,213000,30000,243000
13,5,11,-1,2,258000,30000,288000
9,6,7,-1,2,252000,105000,357000
17,14,12,-1,2,204000,45000,249000
19,13,18,-1,2,207000,75000,282000
16,9,13,12,2,267000,220000,487000
17,6,9,-1,2,255000,15000,270000
6,13,18,-1,2,225000,15000,240000
8,17,12,-1,2,243000,30000,273000
20,17,13,-1,2,201000,45000,246000
9,18,12,-1,2,273000,30000,303000
13,15,16,-1,2,222000,90000,312000
7,5,13,11,2,330000,265000,595000
9,16,8,-1,2,276000,45000,321000
15,17,12,-1,2,213000,75000,288000
19,10,16,-1,2,231000,30000,261000
8,9,6,-1,2,294000,90000,384000
8,7,15,-1,2,249000,45000,294000
15,14,18,-1,2,198000,90000,288000
16,5,17,13,2,285000,195000,480000
15,17,10,-1,2,228000,45000,273000
10,5,8,-1,2,276000,75000,351000
6,10,7,-1,2,252000,90000,342000
9,10,12,-1,2,243000,105000,348000
6,13,7,-1,2,261000,60000,321000
7,20,6,-1,2,204000,30000,234000
8,14,20,13,2,267000,235000,502000
8,13,16,-1,2,246000,45000,291000
14,5,9,-1,2,243000,30000,273000
5,11,17,-1,2,207000,15000,222000
18,10,9,-1,2,249000,45000,294000
11,7,17,-1,2,243000,30000,273000
7,8,11,-1,2,261000,90000,351000
14,15,7,13,2,231000,255000,486000
17,11,5,-1,2,225000,15000,240000
6,16,18,-1,2,210000,15000,225000
14,13,9,-1,2,255000,75000,330000
8,14,17,-1,2,222000,30000,252000
18,8,15,-1,2,240000,30000,270000
16,8,11,-1,2,276000,45000,321000
9,12,17,11,2,282000,265000,547000
14,16,18,-1,2,240000,75000,315000
12,7,13,-1,2,291000,75000,366000
12,20,8,-1,2,180000,15000,195000
19,10,20,-1,2,210000,30000,240000
15,8,5,-1,1,207000,0,207000
9,5,14,-1,2,243000,30000,273000
10,19,18,12,2,240000,245000,485000
11,16,18,-1,2,210000,45000,255000
18,16,7,-1,2,228000,15000,243000
14,18,6,-1,2,234000,15000,249000
12,6,16,-1,2,237000,30000,267000
9,15,20,-1,2,201000,30000,231000
10,17,14,-1,2,255000,45000,300000
20,13,10,12,2,279000,205000,484000
5,19,16,-1,2,192000,15000,207000
19,9,14,-1,2,252000,30000,282000
11,6,18,-1,2,225000,15000,240000
8,10,12,-1,2,267000,75000,342000
16,10,14,-1,2,210000,45000,255000
5,20,19,-1,2,192000,30000,222000
13,19,11,12,2,276000,190000,466000
9,13,18,-1,2,252000,30000,282000
11,10,7,-1,2,276000,90000,366000
5,19,7,-1,2,201000,15000,216000
11,17,16,-1,2,228000,75000,303000
19,9,10,-1,2,231000,30000,261000
20,11,13,-1,2,246000,30000,276000
15,7,19,13,2,267000,250000,517000
16,6,9,-1,2,264000,30000,294000
14,12,5,-1,2,231000,30000,261000
20,16,7,-1,2,180000,15000,195000
20,15,14,-1,2,243000,60000,303000
13,14,9,-1,2,273000,75000,348000
14,8,19,-1,2,210000,30000,240000
12,14,10,11,2,309000,280000,589000
7,14,20,-1,2,243000,15000,258000
16,19,5,-1,2,228000,15000,243000
15,19,7,-1,2,234000,15000,249000
18,8,6,-1,2,246000,15000,261000
5,19,11,-1,1,189000,0,189000
7,19,10,-1,2,246000,15000,261000
15,13,8,11,2,309000,250000,559000
19,6,17,-1,2,237000,15000,252000
8,11,10,-1,2,285000,90000,375000
8,16,6,-1,2,210000,15000,225000
5,13,12,-1,2,261000,45000,306000
6,15,11,-1,2,234000,30000,264000
14,12,7,-1,2,237000,45000,282000
18,6,10,13,2,258000,325000,583000
15,10,14,-1,2,222000,30000,252000
12,20,9,-1,2,201000,15000,216000
16,7,11,-1,2,279000,30000,309000
12,18,9,-1,2,228000,30000,258000
13,17,14,-1,2,234000,90000,324000
18,10,17,-1,2,243000,45000,288000
11,18,5,12,2,306000,315000,621000
12,10,7,-1,2,231000,30000,261000
13,6,14,-1,2,234000,45000,279000
10,13,20,-1,2,219000,30000,249000
11,14,15,-1,2,249000,90000,339000
18,16,7,-1,2,228000,15000,243000
13,8,5,-1,2,285000,45000,330000
12,16,13,11,2,216000,90000,306000
13,5,7,-1,2,273000,30000,303000
17,14,11,-1,2,213000,45000,258000
5,9,6,-1,2,288000,90000,378000
11,10,5,-1,2,237000,75000,312000
14,18,14,-1,2,126000,15000,141000
17,20,11,-1,2,192000,30000,222000
20,17,6,13,2,267000,145000,412000
13,18,5,-1,2,252000,15000,267000
14,7,20,-1,2,216000,15000,231000
8,7,17,-1,2,249000,30000,279000
11,19,16,-1,2,228000,45000,273000
7,19,10,-1,2,237000,15000,252000
16,13,15,-1,2,231000,90000,321000
15,8,10,11,2,327000,330000,657000
6,8,14,-1,2,291000,30000,321000
9,10,17,-1,2,231000,45000,276000
11,16,6,-1,2,252000,30000,282000
8,12,19,-1,2,180000,15000,195000
15,17,14,-1,2,243000,105000,348000
13,15,12,-1,2,270000,105000,375000
9,17,14,13,2,267000,265000,532000
13,9,7,-1,2,258000,45000,303000
11,15,7,-1,2,237000,45000,282000
14,10,13,-1,2,222000,90000,312000
11,19,19,-1,1,144000,0,144000
20,11,8,-1,2,219000,15000,234000
10,14,18,-1,2,255000,45000,300000
13,5,16,11,2,300000,250000,550000
13,5,6,-1,2,306000,60000,366000
11,7,17,-1,2,225000,30000,255000
17,7,11,-1,2,234000,30000,264000
12,5,7,-1,2,249000,45000,294000
20,15,14,-1,2,198000,60000,258000
8,19,20,-1,2,219000,30000,249000
19,14,7,13,2,267000,205000,472000
10,15,9,-1,2,297000,60000,357000
11,14,10,-1,2,243000,90000,333000
19,14,11,-1,2,231000,45000,276000
18,16,13,-1,2,231000,75000,306000
17,6,7,-1,2,276000,30000,306000
6,13,11,-1,2,255000,45000,300000
14,13,7,12,2,252000,255000,507000
5,8,6,-1,2,246000,30000,276000
10,17,6,-1,2,198000,15000,213000
8,16,12,-1,2,255000,45000,300000
18,7,12,-1,2,198000,15000,213000
17,8,5,-1,2,255000,15000,270000
12,17,7,-1,2,243000,30000,273000
20,14,6,12,2,261000,190000,451000
8,20,14,-1,1,162000,0,162000
20,15,8,-1,2,234000,15000,249000
14,20,18,-1,2,207000,45000,252000
6,17,16,-1,2,204000,30000,234000
16,14,12,-1,2,240000,75000,315000
8,14,11,-1,2,276000,45000,321000
16,11,8,12,2,270000,330000,600000
10,14,18,-1,2,198000,15000,213000
14,6,7,-1,2,276000,45000,321000
10,14,17,-1,2,210000,45000,255000
9,14,7,-1,2,267000,45000,312000
19,12,11,-1,2,213000,45000,258000
19,15,5,-1,2,225000,15000,240000
14,8,6,12,2,312000,265000,577000
8,12,7,-1,2,297000,60000,357000
18,17,7,-1,2,195000,30000,225000
6,7,10,-1,2,297000,90000,387000
19,15,13,-1,2,195000,45000,240000
16,20,6,-1,2,225000,15000,240000
12,16,10,-1,2,267000,45000,312000
10,17,16,12,2,270000,220000,490000
12,9,20,-1,1,171000,0,171000
10,18,14,-1,2,255000,45000,300000
18,9,17,-1,2,222000,30000,252000
18,10,7,-1,2,246000,15000,261000
18,11,7,-1,2,225000,15000,240000
6,7,19,-1,2,249000,30000,279000
12,11,9,12,2,252000,240000,492000
19,10,18,-1,2,213000,30000,243000
20,17,14,-1,2,228000,45000,273000
18,11,7,-1,1,189000,0,189000
15,20,9,-1,2,210000,30000,240000
6,8,16,-1,2,255000,15000,270000
10,8,17,-1,2,246000,30000,276000
12,13,17,11,2,225000,60000,285000
14,15,20,-1,2,234000,60000,294000
7,5,20,-1,2,249000,30000,279000
9,5,8,-1,2,285000,90000,375000
6,12,17,-1,2,210000,30000,240000
15,12,18,-1,2,222000,45000,267000
12,6,5,-1,2,297000,60000,357000
6,16,17,13,2,231000,195000,426000
14,17,19,-1,2,192000,75000,267000
20,17,7,-1,2,183000,15000,198000
16,12,14,-1,2,258000,75000,333000
17,13,11,-1,2,249000,45000,294000
18,8,12,-1,2,243000,30000,273000
16,11,20,-1,2,207000,30000,237000
14,5,7,12,2,330000,265000,595000
20,13,10,-1,2,246000,30000,276000
14,6,15,-1,2,258000,30000,288000
20,16,18,-1,2,162000,75000,237000
17,10,14,-1,2,228000,45000,273000
11,15,12,-1,2,252000,90000,342000
19,16,6,-1,2,219000,15000,234000
9,19,20,12,2,273000,200000,473000
15,11,10,-1,2,252000,60000,312000
5,9,18,-1,2,225000,15000,240000
15,18,11,-1,2,219000,45000,264000
12,19,5,-1,1,207000,0,207000
7,15,13,-1,2,258000,30000,288000
8,6,9,-1,2,258000,90000,348000
15,9,6,12,2,279000,355000,634000
10,5,13,-1,2,291000,45000,336000
16,9,14,-1,2,219000,45000,264000
19,10,15,-1,2,216000,30000,246000
5,15,16,-1,2,249000,30000,279000
7,16,12,-1,2,252000,30000,282000
9,10,15,-1,2,252000,60000,312000
12,10,15,11,2,282000,265000,547000
18,19,15,-1,2,207000,90000,297000
19,7,18,-1,2,204000,30000,234000
12,10,16,-1,2,276000,45000,321000
13,5,6,-1,2,267000,45000,312000
18,19,7,-1,2,186000,30000,216000
13,15,9,-1,2,273000,45000,318000
20,16,14,13,2,204000,45000,249000
18,5,19,-1,2,240000,30000,270000
16,11,14,-1,2,267000,75000,342000
10,6,12,-1,2,273000,45000,318000
5,10,8,-1,2,249000,75000,324000
17,8,7,-1,2,213000,30000,243000
10,14,6,-1,2,264000,45000,309000
5,18,16,11,2,273000,215000,488000
19,13,16,-1,2,249000,45000,294000
7,20,11,-1,2,243000,15000,258000
13,9,6,-1,2,285000,45000,330000
9,18,13,-1,2,207000,30000,237000
18,11,16,-1,2,228000,45000,273000
17,13,17,-1,2,171000,15000,186000
10,20,18,11,2,267000,170000,437000
11,16,14,-1,2,213000,30000,243000
19,11,5,-1,1,189000,0,189000
12,10,7,-1,2,294000,75000,369000
7,6,9,-1,2,252000,105000,357000
19,20,5,-1,2,165000,30000,195000
5,19,20,-1,2,165000,30000,195000
16,9,20,12,2,276000,145000,421000
17,12,9,-1,2,276000,45000,321000
20,11,9,-1,2,201000,15000,216000
16,12,9,-1,2,276000,45000,321000
5,7,17,-1,2,237000,15000,252000
6,20,8,-1,2,201000,15000,216000
11,5,9,-1,2,273000,45000,318000
16,13,6,12,2,252000,265000,517000
18,17,15,-1,2,189000,45000,234000
11,6,13,-1,2,291000,45000,336000
12,14,6,-1,2,222000,30000,252000
9,14,10,-1,2,252000,60000,312000
6,14,10,-1,2,246000,45000,291000
15,13,18,-1,2,195000,45000,240000
6,5,16,13,2,327000,185000,512000
13,18,10,-1,2,258000,45000,303000
9,8,6,-1,2,267000,90000,357000
15,12,8,-1,2,228000,45000,273000
9,12,18,-1,2,228000,30000,258000
20,7,9,-1,2,219000,15000,234000
15,16,5,-1,2,249000,30000,279000
7,19,5,11,2,312000,205000,517000
7,20,17,-1,2,219000,15000,234000
8,16,13,-1,2,282000,45000,327000
14,20,7,-1,2,198000,15000,213000
6,20,15,-1,2,225000,15000,240000
12,9,13,-1,2,267000,90000,357000
19,13,12,-1,2,234000,60000,294000
6,8,5,13,2,342000,215000,557000
20,17,16,-1,2,174000,90000,264000
19,15,17,-1,2,183000,75000,258000
7,10,17,-1,1,189000,0,189000
11,8,16,-1,2,267000,45000,312000
10,15,19,-1,2,207000,30000,237000
20,17,11,-1,2,201000,30000,231000
18,7,11,13,2,273000,155000,428000
7,12,5,-1,2,285000,45000,330000
14,6,5,-1,2,249000,45000,294000
7,18,20,-1,2,174000,15000,189000
8,14,13,-1,2,282000,75000,357000
13,7,12,-1,2,246000,75000,321000
8,19,5,-1,2,210000,15000,225000
20,11,17,12,2,279000,185000,464000
7,12,5,-1,2,228000,30000,258000
7,5,10,-1,2,240000,45000,285000
12,9,7,-1,2,240000,45000,285000
14,13,20,-1,2,207000,60000,267000
14,7,13,-1,2,270000,45000,315000
9,20,12,-1,2,201000,15000,216000
14,8,10,12,2,324000,345000,669000
12,13,15,-1,2,270000,105000,375000
13,6,16,-1,2,258000,30000,288000
18,10,5,-1,2,225000,15000,240000
19,15,13,-1,2,213000,45000,258000
17,12,16,-1,2,237000,75000,312000
12,7,10,-1,2,294000,75000,369000
11,12,18,11,2,273000,235000,508000
9,18,13,-1,2,261000,30000,291000
19,9,11,-1,2,210000,15000,225000
13,7,6,-1,2,297000,60000,357000
13,20,14,-1,2,207000,60000,267000
12,6,15,-1,2,267000,30000,297000
5,7,15,-1,2,237000,15000,252000
7,6,10,11,2,306000,295000,601000
9,8,7,-1,2,288000,90000,378000
9,14,10,-1,2,243000,60000,303000
5,11,14,-1,2,240000,30000,270000
8,8,12,-1,2,162000,15000,177000
6,20,7,-1,2,204000,30000,234000
10,20,9,-1,2,231000,30000,261000
6,15,5,12,2,327000,185000,512000
13,10,14,-1,2,258000,90000,348000
13,8,19,-1,2,207000,15000,222000
10,13,8,-1,2,285000,45000,330000
12,8,17,-1,2,216000,30000,246000
10,20,13,-1,2,228000,30000,258000
18,6,7,-1,2,258000,30000,288000
6,16,10,11,2,300000,315000,615000
17,10,14,-1,2,264000,45000,309000
20,7,19,-1,2,192000,30000,222000
8,19,13,-1,1,171000,0,171000
20,18,8,-1,2,219000,15000,234000
15,19,7,-1,2,243000,15000,258000
15,5,18,-1,2,237000,15000,252000
18,9,13,11,2,309000,220000,529000
15,8,5,-1,2,303000,45000,348000
11,16,20,-1,2,189000,30000,219000
15,13,5,-1,2,264000,15000,279000
5,18,10,-1,2,216000,15000,231000
15,20,14,-1,2,216000,60000,276000
6,20,10,-1,2,243000,15000,258000
14,6,8,12,2,312000,265000,577000
19,14,20,-1,2,195000,75000,270000
12,7,11,-1,2,246000,75000,321000
9,11,10,-1,2,243000,90000,333000
12,7,5,-1,2,249000,45000,294000
19,20,6,-1,2,165000,30000,195000
9,19,13,-1,1,171000,0,171000
9,13,18,11,2,318000,220000,538000
19,5,20,-1,2,219000,30000,249000
18,9,5,-1,1,198000,0,198000
20,8,16,-1,2,198000,15000,213000
8,12,10,-1,2,285000,75000,360000
12,13,8,-1,2,228000,75000,303000
7,8,16,-1,2,258000,45000,303000
11,14,12,11,2,273000,280000,553000
5,9,11,-1,2,294000,90000,384000
19,6,16,-1,2,192000,15000,207000
17,14,5,-1,2,255000,15000,270000
8,16,15,-1,2,243000,45000,288000
10,20,5,-1,2,216000,15000,231000
5,6,19,-1,2,249000,30000,279000
13,5,15,11,2,300000,250000,550000
13,6,10,-1,2,291000,45000,336000
10,6,17,-1,2,198000,15000,213000
6,17,8,-1,2,237000,15000,252000
9,13,12,-1,2,249000,90000,339000
16,6,14,-1,2,228000,15000,243000
7,12,15,-1,2,255000,45000,300000
10,17,9,11,2,282000,315000,597000
12,10,20,-1,2,228000,15000,243000
17,7,5,-1,2,276000,30000,306000
13,11,8,-1,2,249000,75000,324000
13,15,20,-1,2,204000,45000,249000
20,10,7,-1,2,246000,15000,261000
16,9,6,-1,2,282000,30000,312000
7,10,17,11,2,282000,315000,597000
7,8,10,-1,2,306000,105000,411000
11,7,8,-1,2,252000,90000,342000
5,6,17,-1,2,231000,30000,261000
6,20,12,-1,1,171000,0,171000
15,10,16,-1,2,264000,75000,339000
18,10,19,-1,2,213000,30000,243000
11,10,16,12,2,315000,330000,645000
20,12,7,-1,1,180000,0,180000
16,15,17,-1,2,213000,90000,303000
8,6,18,-1,1,198000,0,198000
5,14,15,-1,2,240000,30000,270000
16,12,13,-1,2,234000,90000,324000
11,8,19,-1,2,228000,15000,243000
19,9,11,13,2,294000,300000,594000
15,10,14,-1,2,222000,30000,252000
17,15,20,-1,2,183000,45000,228000
15,11,19,-1,2,189000,15000,204000
7,10,9,-1,2,276000,90000,366000
10,14,9,-1,2,243000,60000,303000
19,9,20,-1,2,174000,30000,204000
18,19,13,13,2,267000,185000,452000
8,11,13,-1,2,294000,75000,369000
20,18,16,-1,2,153000,75000,228000
10,18,6,-1,2,216000,15000,231000
9,5,6,-1,2,279000,90000,369000
9,11,18,-1,2,219000,30000,249000
14,13,17,-1,2,225000,90000,315000
16,12,15,13,2,276000,225000,501000
13,20,19,-1,2,165000,45000,210000
9,14,12,-1,2,249000,75000,324000
16,17,6,-1,2,222000,30000,252000
6,15,17,-1,2,237000,15000,252000
16,8,20,-1,2,207000,15000,222000
20,6,16,-1,2,225000,15000,240000
16,8,19,11,2,318000,185000,503000
11,9,13,-1,2,285000,75000,360000
9,20,11,-1,2,192000,15000,207000
13,9,15,-1,2,264000,45000,309000
6,14,9,-1,2,267000,45000,312000
17,6,11,-1,2,198000,15000,213000
11,9,10,-1,2,270000,90000,360000
11,5,15,13,2,258000,345000,603000
19,9,11,-1,1,171000,0,171000
15,18,13,-1,2,240000,45000,285000
9,8,12,-1,2,297000,90000,387000
20,8,11,-1,2,192000,15000,207000
14,5,10,-1,2,279000,30000,309000
18,11,9,-1,2,219000,30000,249000
11,20,6,13,2,267000,285000,552000
20,18,6,-1,2,174000,15000,189000
10,7,5,-1,2,297000,90000,387000
19,12,20,-1,2,156000,45000,201000
11,10,7,-1,2,258000,90000,348000
16,9,14,-1,2,219000,45000,264000
12,15,13,-1,2,234000,105000,339000
6,5,8,13,2,342000,215000,557000
18,7,20,-1,2,192000,15000,207000
11,17,15,-1,2,255000,45000,300000
20,10,8,-1,2,228000,15000,243000
6,20,14,-1,1,198000,0,198000
8,16,18,-1,2,246000,15000,261000
17,6,18,-1,2,231000,30000,261000
16,10,8,11,2,327000,315000,642000
12,6,20,-1,1,216000,0,216000
15,13,11,-1,2,267000,75000,342000
6,13,17,-1,2,237000,30000,267000
10,9,14,-1,2,261000,60000,321000
11,9,10,-1,2,252000,90000,342000
18,19,12,-1,2,177000,45000,222000
20,17,11,13,2,267000,145000,412000
10,17,11,-1,2,288000,60000,348000
8,20,9,-1,2,222000,30000,252000
18,5,8,-1,2,255000,15000,270000
10,15,7,-1,2,267000,45000,312000
19,7,9,-1,2,201000,15000,216000
10,9,19,-1,2,222000,30000,252000
11,5,17,12,2,306000,315000,621000
13,17,9,-1,2,207000,15000,222000
6,14,5,-1,2,267000,45000,312000
11,8,18,-1,2,228000,30000,258000
13,10,18,-1,2,240000,45000,285000
19,14,13,-1,2,234000,60000,294000
5,11,12,-1,2,288000,45000,333000
12,17,19,11,2,192000,45000,237000
18,7,20,-1,2,219000,15000,234000
20,11,17,-1,2,219000,30000,249000
6,9,19,-1,1,189000,0,189000
20,7,19,-1,2,192000,30000,222000
10,18,12,-1,2,198000,15000,213000
9,6,16,-1,2,273000,30000,303000
12,6,17,11,2,273000,265000,538000
20,11,10,-1,2,240000,30000,270000
14,18,5,-1,2,252000,15000,267000
11,12,18,-1,2,252000,60000,312000
11,19,14,-1,2,240000,45000,285000
15,18,7,-1,2,237000,15000,252000
14,17,15,-1,2,234000,105000,339000
17,6,14,12,2,306000,250000,556000
12,8,5,-1,2,228000,30000,258000
19,15,6,-1,2,189000,15000,204000
11,13,19,-1,2,237000,30000,267000
16,14,19,-1,2,222000,45000,267000
10,8,16,-1,2,282000,30000,312000
5,9,13,-1,2,246000,45000,291000
8,12,17,13,2,240000,330000,570000
16,14,7,-1,2,231000,30000,261000
11,8,19,-1,2,210000,15000,225000
10,12,13,-1,2,267000,90000,357000
5,7,13,-1,2,255000,30000,285000
10,7,18,-1,2,201000,15000,216000
20,7,20,-1,1,144000,0,144000
18,13,9,11,2,309000,220000,529000
5,7,18,-1,2,267000,30000,297000
13,17,9,-1,2,237000,45000,282000
15,10,11,-1,2,252000,60000,312000
13,8,6,-1,2,258000,45000,303000
8,15,14,-1,2,216000,45000,261000
13,6,17,-1,2,237000,30000,267000
8,19,6,13,2,294000,180000,474000
19,8,6,-1,2,246000,15000,261000
17,16,7,-1,2,231000,30000,261000
9,15,20,-1,2,219000,30000,249000
15,14,18,-1,2,243000,90000,333000
12,6,20,-1,1,216000,0,216000
14,6,19,-1,2,252000,15000,267000
9,11,17,13,2,276000,315000,591000
14,13,18,-1,2,219000,30000,249000
9,15,13,-1,2,246000,45000,291000
11,8,15,-1,2,258000,45000,303000
12,5,19,-1,1,180000,0,180000
13,14,7,-1,2,270000,45000,315000
17,12,8,-1,2,234000,30000,264000
16,13,9,11,2,291000,250000,541000
19,15,13,-1,2,249000,45000,294000
7,18,15,-1,2,246000,15000,261000
14,5,18,-1,2,234000,15000,249000
6,12,20,-1,1,189000,0,189000
20,9,18,-1,2,228000,15000,243000
19,7,16,-1,2,246000,15000,261000
19,16,12,12,2,297000,190000,487000
13,6,14,-1,2,231000,30000,261000
19,20,7,-1,2,174000,30000,204000
11,5,8,-1,2,240000,30000,270000
13,16,19,-1,2,195000,45000,240000
8,16,11,-1,2,294000,45000,339000
7,13,10,-1,2,258000,45000,303000
11,14,6,12,2,261000,360000,621000
14,20,10,-1,1,162000,0,162000
10,18,16,-1,2,240000,30000,270000
12,13,14,-1,2,261000,90000,351000
12,11,16,-1,2,261000,60000,321000
19,20,6,-1,2,192000,30000,222000
18,8,5,-1,1,198000,0,198000
20,6,16,11,2,291000,185000,476000
7,12,10,-1,2,303000,75000,378000
15,20,11,-1,2,189000,30000,219000
19,14,16,-1,2,231000,45000,276000
20,17,18,-1,2,189000,90000,279000
11,9,10,-1,2,279000,90000,369000
20,12,7,-1,2,198000,15000,213000
10,18,15,12,2,288000,235000,523000
19,9,10,-1,2,207000,0,207000
5,12,17,-1,2,234000,15000,249000
17,20,10,-1,2,192000,30000,222000
17,19,8,-1,2,174000,15000,189000
14,20,8,-1,2,225000,15000,240000
19,8,14,-1,2,237000,30000,267000
16,12,9,11,2,309000,265000,574000
15,17,7,-1,2,255000,15000,270000
15,7,8,-1,2,276000,45000,321000
9,18,14,-1,2,207000,30000,237000
20,5,20,-1,1,135000,0,135000
16,8,14,-1,2,240000,30000,270000
16,14,6,-1,2,237000,15000,252000
19,11,14,12,2,270000,220000,490000
5,17,6,-1,2,225000,0,225000
18,12,10,-1,2,219000,30000,249000
20,9,5,-1,2,216000,15000,231000
8,12,7,-1,2,288000,60000,348000
12,16,19,-1,2,192000,45000,237000
12,18,13,-1,2,261000,60000,321000
14,20,8,13,2,267000,235000,502000
20,10,13,-1,2,228000,30000,258000
12,16,9,-1,2,267000,45000,312000
17,5,18,-1,2,213000,30000,243000
15,6,7,-1,2,294000,45000,339000
15,10,11,-1,2,234000,60000,294000
10,15,5,-1,2,252000,30000,282000
19,11,15,11,2,273000,160000,433000
5,19,7,-1,2,258000,30000,288000
13,9,14,-1,2,246000,75000,321000
15,16,20,-1,2,195000,60000,255000
18,7,6,-1,2,216000,0,216000
16,18,5,-1,2,210000,15000,225000
15,6,14,-1,2,258000,30000,288000
11,9,12,12,2,243000,240000,483000
11,16,8,-1,2,267000,45000,312000
17,6,8,-1,2,219000,15000,234000
15,14,6,-1,2,240000,30000,270000
20,9,6,-1,2,219000,15000,234000
7,19,18,-1,2,222000,30000,252000
5,14,19,-1,2,252000,15000,267000
7,14,15,13,2,258000,255000,513000
6,12,5,-1,2,270000,60000,330000
6,7,12,-1,2,252000,60000,312000
14,17,7,-1,2,213000,30000,243000
15,18,11,-1,2,228000,45000,273000
18,9,8,-1,2,240000,30000,270000
10,13,17,-1,2,258000,45000,303000
7,6,20,11,2,300000,190000,490000
8,17,20,-1,2,228000,15000,243000
17,5,7,-1,2,276000,30000,306000
11,19,10,-1,2,231000,45000,276000
11,14,12,-1,2,252000,105000,357000
9,7,6,-1,2,279000,105000,384000
8,16,17,-1,2,204000,30000,234000
7,17,10,11,2,318000,315000,633000
10,12,20,-1,2,228000,15000,243000
17,6,5,-1,2,288000,45000,333000
17,8,6,-1,2,219000,15000,234000
20,16,12,-1,2,210000,45000,255000
11,15,5,-1,2,264000,30000,294000
13,14,8,-1,2,237000,75000,312000
10,15,12,12,2,225000,145000,370000
12,17,5,-1,2,234000,15000,249000
13,9,12,-1,2,249000,90000,339000
5,10,6,-1,2,270000,60000,330000
5,8,15,-1,2,246000,30000,276000
16,7,13,-1,2,213000,30000,243000
6,18,7,-1,2,249000,30000,279000
9,16,14,11,2,291000,235000,526000
19,17,20,-1,2,177000,75000,252000
9,14,17,-1,2,255000,45000,300000
11,17,12,-1,2,243000,60000,303000
8,16,5,-1,2,246000,15000,261000
5,18,16,-1,2,210000,15000,225000
14,11,10,-1,2,270000,90000,360000
7,5,17,13,2,291000,170000,461000
6,19,15,-1,2,234000,15000,249000
18,19,5,-1,2,222000,30000,252000
19,17,8,-1,2,237000,15000,252000
15,12,11,-1,2,270000,90000,360000
18,20,9,-1,2,201000,15000,216000
8,5,6,-1,2,309000,135000,444000
16,7,9,13,2,267000,225000,492000
18,5,20,-1,2,228000,15000,243000
18,5,16,-1,2,246000,15000,261000
9,15,8,-1,2,288000,60000,348000
11,10,16,-1,2,234000,60000,294000
9,14,7,-1,2,258000,45000,303000
17,13,15,-1,2,195000,75000,270000
5,20,9,11,2,324000,270000,594000
7,17,19,-1,2,228000,15000,243000
6,7,10,-1,2,297000,90000,387000
9,20,15,-1,2,183000,30000,213000
11,5,13,-1,2,276000,30000,306000
10,20,15,-1,2,198000,30000,228000
20,14,17,-1,2,210000,45000,255000
14,12,13,11,2,228000,45000,273000
7,11,16,-1,2,243000,30000,273000
8,6,16,-1,2,219000,15000,234000
9,15,13,-1,2,237000,45000,282000
20,15,16,-1,2,195000,60000,255000
11,10,18,-1,2,198000,0,198000
10,18,8,-1,2,228000,15000,243000
14,13,7,11,2,309000,225000,534000
8,10,15,-1,2,294000,45000,339000
6,10,15,-1,2,234000,30000,264000
10,6,7,-1,2,252000,90000,342000
7,20,17,-1,2,183000,15000,198000
17,19,6,-1,2,237000,15000,252000
10,9,20,-1,2,240000,30000,270000
9,5,16,13,2,312000,225000,537000
15,10,14,-1,2,264000,75000,339000
6,8,15,-1,2,264000,30000,294000
12,20,6,-1,1,162000,0,162000
15,9,8,-1,2,306000,60000,366000
14,11,12,-1,2,225000,105000,330000
19,8,7,-1,2,240000,30000,270000
19,7,11,12,2,288000,300000,588000
9,18,11,-1,2,207000,15000,222000
20,10,15,-1,2,216000,30000,246000
16,8,17,-1,2,240000,30000,270000
7,15,12,-1,2,273000,45000,318000
6,7,16,-1,2,222000,30000,252000
13,11,5,-1,2,249000,30000,279000
9,8,15,12,2,279000,355000,634000
17,11,19,-1,2,231000,30000,261000
5,13,19,-1,2,252000,15000,267000
5,18,9,-1,2,234000,15000,249000
16,12,14,-1,2,222000,75000,297000
15,9,19,-1,2,219000,30000,249000
19,9,13,-1,2,252000,30000,282000
16,8,20,12,2,279000,160000,439000
18,5,6,-1,2,216000,0,216000
5,9,19,-1,2,216000,15000,231000
11,12,9,-1,2,258000,90000,348000
19,18,15,-1,2,162000,90000,252000
13,6,14,-1,2,252000,45000,297000
12,13,6,-1,2,243000,45000,288000
10,14,7,11,2,291000,345000,636000
10,19,6,-1,2,252000,15000,267000
8,5,9,-1,2,276000,90000,366000
18,16,7,-1,2,192000,15000,207000
6,9,5,-1,2,288000,90000,378000
9,17,6,-1,2,210000,15000,225000
16,19,20,-1,2,159000,75000,234000
20,11,8,13,2,285000,285000,570000
6,14,20,-1,1,162000,0,162000
8,19,15,-1,2,246000,30000,276000
20,16,6,-1,2,216000,15000,231000
9,8,5,-1,2,294000,90000,384000
8,14,9,-1,2,252000,60000,312000
10,20,7,-1,2,201000,15000,216000
17,18,14,13,2,210000,90000,300000
5,14,15,-1,2,222000,30000,252000
9,16,12,-1,2,249000,45000,294000
19,13,17,-1,2,201000,45000,246000
20,14,18,-1,2,216000,45000,261000
20,9,11,-1,1,171000,0,171000
13,10,20,-1,2,255000,30000,285000
18,12,5,11,2,309000,235000,544000
13,7,15,-1,2,267000,30000,297000
15,11,13,-1,2,231000,75000,306000
12,5,16,-1,2,246000,30000,276000
16,13,9,-1,2,228000,45000,273000
7,19,10,-1,2,219000,15000,234000
18,14,6,-1,2,234000,15000,249000
17,16,11,12,2,279000,220000,499000
15,13,18,-1,2,195000,30000,225000
6,17,10,-1,2,243000,15000,258000
12,17,13,-1,2,243000,60000,303000
9,11,16,-1,2,267000,45000,312000
5,10,13,-1,2,246000,45000,291000
11,6,16,-1,2,234000,30000,264000
16,5,14,12,2,252000,250000,502000
11,14,16,-1,2,213000,30000,243000
5,12,13,-1,2,261000,45000,306000
10,9,16,-1,2,243000,60000,303000
13,11,14,-1,2,222000,90000,312000
6,19,11,-1,2,225000,15000,240000
10,7,12,-1,2,276000,75000,351000
20,10,19,11,2,237000,200000,437000
15,12,20,-1,2,213000,45000,258000
13,20,12,-1,2,249000,45000,294000
15,20,13,-1,2,240000,45000,285000
9,12,18,-1,2,264000,30000,294000
7,14,12,-1,2,264000,45000,309000
19,11,13,-1,2,201000,30000,231000
19,12,7,13,2,276000,315000,591000
15,14,19,-1,2,216000,60000,276000
10,12,7,-1,2,303000,75000,378000
7,16,17,-1,2,204000,30000,234000
6,8,12,-1,2,276000,45000,321000
9,16,14,-1,2,219000,45000,264000
7,5,12,-1,2,258000,45000,303000
9,12,8,11,2,279000,345000,624000
14,6,15,-1,2,267000,30000,297000
10,11,8,-1,2,258000,90000,348000
7,11,6,-1,2,252000,60000,312000
14,17,10,-1,2,210000,45000,255000
13,20,5,-1,1,198000,0,198000
6,15,20,-1,2,234000,15000,249000
20,9,15,11,2,309000,160000,469000
20,9,7,-1,2,246000,15000,261000
17,18,13,-1,2,219000,75000,294000
5,8,9,-1,2,306000,120000,426000
5,14,11,-1,2,231000,30000,261000
11,17,20,-1,2,174000,30000,204000
7,17,13,-1,2,207000,15000,222000
15,11,17,12,2,270000,235000,505000
7,11,16,-1,2,225000,15000,240000
12,17,5,-1,2,207000,15000,222000
9,13,16,-1,2,237000,45000,282000
15,20,11,-1,2,207000,30000,237000
16,11,18,-1,2,246000,45000,291000
8,17,11,-1,2,264000,30000,294000
14,5,18,12,2,270000,250000,520000
18,9,12,-1,2,207000,15000,222000
14,11,16,-1,2,231000,75000,306000
5,6,8,-1,2,288000,105000,393000
6,5,13,-1,2,249000,45000,294000
10,9,12,-1,2,243000,105000,348000
6,14,10,-1,2,246000,45000,291000
15,10,11,13,2,249000,345000,594000
7,14,11,-1,2,237000,15000,252000
11,12,20,-1,2,213000,45000,258000
12,6,9,-1,2,285000,45000,330000
20,13,7,-1,2,189000,15000,204000
16,17,5,-1,2,240000,30000,270000
17,18,13,-1,2,219000,75000,294000
10,7,19,11,2,336000,270000,606000
7,20,14,-1,2,243000,15000,258000
18,6,13,-1,2,234000,15000,249000
10,6,13,-1,2,264000,45000,309000
18,10,13,-1,2,222000,45000,267000
19,12,8,-1,2,207000,15000,222000
18,17,13,-1,2,228000,75000,303000
12,17,8,11,2,327000,265000,592000
10,7,20,-1,2,255000,15000,270000
17,20,13,-1,2,219000,45000,264000
7,16,18,-1,2,246000,15000,261000
13,15,20,-1,2,231000,45000,276000
10,7,12,-1,2,294000,75000,369000
14,11,13,-1,2,213000,90000,303000
7,19,6,11,2,312000,205000,517000
12,18,6,-1,2,234000,15000,249000
10,13,18,-1,2,249000,45000,294000
16,17,13,-1,2,222000,90000,312000
5,16,5,-1,1,198000,0,198000
17,13,12,-1,2,216000,60000,276000
20,16,7,-1,2,216000,15000,231000
10,6,11,11,2,279000,240000,519000
18,13,9,-1,2,225000,30000,255000
9,11,15,-1,2,258000,45000,303000
18,7,17,-1,2,204000,30000,234000
18,11,20,-1,2,210000,30000,240000
6,17,13,-1,2,198000,15000,213000
15,14,7,-1,2,243000,45000,288000
18,19,16,12,2,162000,90000,252000
20,7,18,-1,2,192000,15000,207000
11,13,15,-1,2,267000,75000,342000
6,17,10,-1,2,225000,15000,240000
18,18,5,-1,1,153000,0,153000
11,12,20,-1,2,231000,45000,276000
8,11,19,-1,2,228000,15000,243000
8,20,14,12,2,297000,190000,487000
8,15,5,-1,1,207000,0,207000
17,18,16,-1,2,165000,90000,255000
13,20,12,-1,2,222000,45000,267000
14,5,16,-1,2,255000,15000,270000
15,13,8,-1,2,246000,45000,291000
13,5,16,-1,2,228000,15000,243000
6,5,9,12,2,324000,295000,619000
8,15,6,-1,2,264000,30000,294000
14,11,7,-1,2,237000,45000,282000
14,10,11,-1,2,234000,90000,324000
5,13,16,-1,2,237000,15000,252000
10,11,9,-1,2,261000,90000,351000
16,7,17,-1,2,213000,30000,243000
6,8,17,12,2,312000,195000,507000
9,14,17,-1,2,264000,45000,309000
16,11,8,-1,2,258000,45000,303000
5,17,6,-1,2,240000,30000,270000
7,13,9,-1,2,249000,45000,294000
20,14,10,-1,2,198000,30000,228000
20,18,17,-1,2,171000,90000,261000
15,5,14,11,2,309000,195000,504000
16,9,20,-1,2,237000,30000,267000
7,18,5,-1,2,255000,15000,270000
12,16,18,-1,2,210000,45000,255000
18,8,14,-1,2,237000,30000,267000
16,17,8,-1,2,240000,30000,270000
12,18,10,-1,2,246000,30000,276000
8,15,12,13,2,267000,360000,627000
15,12,15,-1,2,174000,15000,189000
16,15,20,-1,2,186000,60000,246000
16,18,9,-1,2,192000,15000,207000
16,14,18,-1,2,222000,75000,297000
19,7,9,-1,2,255000,15000,270000
16,8,15,-1,2,243000,45000,288000
18,14,19,13,2,189000,75000,264000
20,12,14,-1,2,180000,15000,195000
13,15,17,-1,2,240000,75000,315000
5,16,13,-1,2,264000,15000,279000
11,13,5,-1,2,249000,30000,279000
10,5,20,-1,2,189000,15000,204000
19,6,5,-1,2,249000,30000,279000
9,12,14,13,2,267000,360000,627000
11,15,12,-1,2,243000,90000,333000
16,14,13,-1,2,234000,105000,339000
19,16,17,-1,2,201000,105000,306000
20,11,18,-1,2,183000,30000,213000
15,17,17,-1,1,108000,0,108000
17,10,13,-1,2,249000,45000,294000
8,6,20,11,2,315000,295000,610000
18,12,13,-1,2,261000,60000,321000
7,14,20,-1,2,225000,15000,240000
19,17,9,-1,2,219000,15000,234000
6,20,17,-1,2,228000,15000,243000
14,18,11,-1,2,267000,45000,312000
6,10,12,-1,2,273000,45000,318000
17,6,14,13,2,231000,265000,496000
10,17,13,-1,2,240000,45000,285000
19,9,14,-1,2,234000,30000,264000
12,7,6,-1,2,279000,60000,339000
10,19,5,-1,2,198000,15000,213000
16,10,7,-1,2,264000,30000,294000
13,14,9,-1,2,228000,75000,303000
17,9,15,12,2,270000,235000,505000
7,16,16,-1,1,144000,0,144000
9,6,20,-1,2,201000,15000,216000
11,10,19,-1,2,258000,45000,303000
10,7,13,-1,2,276000,45000,321000
5,13,11,-1,2,231000,30000,261000
18,10,6,-1,2,198000,15000,213000
6,19,19,13,2,234000,155000,389000
13,16,19,-1,2,231000,45000,276000
17,10,5,-1,2,252000,15000,267000
7,9,12,-1,2,267000,45000,312000
18,20,12,-1,2,156000,30000,186000
16,13,11,-1,2,213000,30000,243000
12,15,10,-1,2,249000,45000,294000
18,16,13,12,2,213000,75000,288000
19,17,18,-1,2,189000,75000,264000
9,5,17,-1,2,243000,15000,258000
13,9,19,-1,2,225000,30000,255000
19,16,11,-1,2,228000,45000,273000
8,18,16,-1,2,228000,15000,243000
14,17,7,-1,2,249000,30000,279000
9,17,16,13,2,258000,195000,453000
11,14,19,-1,2,231000,45000,276000
7,14,10,-1,2,285000,45000,330000
9,17,15,-1,2,195000,30000,225000
6,12,7,-1,2,288000,60000,348000
20,18,9,-1,2,174000,15000,189000
7,12,18,-1,2,243000,15000,258000
7,12,17,13,2,276000,330000,606000
9,17,11,-1,2,237000,30000,267000
16,20,19,-1,2,150000,75000,225000
19,13,12,-1,2,252000,60000,312000
17,18,15,-1,2,201000,90000,291000
8,9,6,-1,2,243000,45000,288000
13,9,17,-1,2,219000,45000,264000
19,8,15,11,2,291000,160000,451000
18,16,17,-1,2,210000,90000,300000
18,6,8,-1,2,228000,15000,243000
6,5,9,-1,2,270000,90000,360000
16,11,18,-1,2,201000,45000,246000
16,7,5,-1,2,255000,15000,270000
5,9,8,-1,2,258000,90000,348000
19,9,12,11,2,273000,205000,478000
15,17,5,-1,2,255000,15000,270000
7,13,9,-1,2,267000,45000,312000
18,5,10,-1,2,207000,15000,222000
11,20,9,-1,2,201000,15000,216000
6,11,15,-1,2,279000,30000,309000
12,13,8,-1,2,228000,75000,303000
17,10,15,11,2,282000,220000,502000
17,13,6,-1,2,264000,30000,294000
18,17,10,-1,2,216000,45000,261000
11,14,12,-1,2,270000,105000,375000
18,10,16,-1,2,213000,30000,243000
19,9,19,-1,1,162000,0,162000
15,13,5,-1,2,246000,15000,261000
7,13,9,12,2,288000,370000,658000
20,13,14,-1,2,261000,60000,321000
20,5,17,-1,2,228000,15000,243000
7,15,16,-1,2,267000,30000,297000
16,20,13,-1,2,222000,45000,267000
19,15,16,-1,2,231000,90000,321000
8,11,19,-1,1,180000,0,180000
20,10,15,11,2,309000,160000,469000
9,17,11,-1,2,273000,30000,303000
12,13,8,-1,2,246000,75000,321000
6,12,13,-1,2,243000,45000,288000
6,15,11,-1,2,243000,30000,273000
10,13,8,-1,2,240000,45000,285000
13,15,18,-1,2,195000,45000,240000
13,17,9,13,2,252000,130000,382000
11,7,20,-1,2,225000,15000,240000
15,5,13,-1,2,255000,15000,270000
19,14,10,-1,2,207000,30000,237000
17,13,7,-1,2,237000,30000,267000
10,6,12,-1,2,264000,45000,309000
15,11,14,-1,2,213000,90000,303000
5,13,9,12,2,315000,370000,685000
20,13,12,-1,2,258000,45000,303000
14,18,6,-1,2,243000,15000,258000
11,14,10,-1,2,261000,90000,351000
16,13,7,-1,2,231000,30000,261000
17,18,16,-1,2,183000,90000,273000
7,19,13,-1,2,207000,15000,222000
14,15,7,13,2,267000,255000,522000
11,17,12,-1,2,243000,60000,303000
10,12,14,-1,2,249000,75000,324000
13,18,15,-1,2,213000,45000,258000
19,16,9,-1,2,240000,30000,270000
20,6,17,-1,2,228000,15000,243000
5,15,18,-1,2,255000,15000,270000
5,16,11,13,2,285000,330000,615000
18,10,6,-1,1,198000,0,198000
10,18,8,-1,2,210000,15000,225000
14,12,9,-1,2,267000,75000,342000
18,8,17,-1,2,213000,30000,243000
16,14,19,-1,2,231000,45000,276000
5,20,6,-1,2,261000,45000,306000
7,5,14,13,2,309000,240000,549000
12,6,20,-1,1,207000,0,207000
10,20,17,-1,2,228000,30000,258000
11,19,20,-1,2,156000,30000,186000
13,7,9,-1,2,228000,30000,258000
10,15,5,-1,2,234000,30000,264000
9,17,18,-1,2,195000,30000,225000
8,16,13,13,2,252000,145000,397000
16,5,8,-1,2,255000,15000,270000
14,8,6,-1,2,255000,30000,285000
17,8,20,-1,2,183000,15000,198000
7,10,11,-1,2,303000,90000,393000
16,9,10,-1,2,243000,60000,303000
18,14,13,-1,2,216000,60000,276000
6,15,9,11,2,324000,315000,639000
6,12,5,-1,2,297000,60000,357000
18,16,20,-1,2,144000,75000,219000
10,16,17,-1,2,216000,45000,261000
18,5,6,-1,2,267000,30000,297000
11,12,20,-1,2,231000,45000,276000
8,19,14,-1,2,228000,30000,258000
18,17,10,12,2,288000,245000,533000
8,11,5,-1,2,240000,30000,270000
9,19,14,-1,2,207000,30000,237000
10,19,7,-1,2,228000,15000,243000
16,5,7,-1,2,255000,15000,270000
17,11,9,-1,2,228000,30000,258000
15,12,7,-1,2,255000,45000,300000
6,17,19,12,2,252000,215000,467000
19,11,15,-1,2,189000,15000,204000
18,10,8,-1,2,228000,15000,243000
7,20,19,-1,2,201000,30000,231000
8,14,9,-1,2,243000,15000,258000
16,7,10,-1,2,237000,30000,267000
19,12,16,-1,2,201000,45000,246000
9,19,6,11,2,324000,270000,594000
19,11,20,-1,2,210000,30000,240000
9,16,18,-1,2,192000,15000,207000
16,8,16,-1,1,180000,0,180000
19,6,17,-1,2,183000,15000,198000
14,11,9,-1,2,276000,45000,321000
13,7,18,-1,2,210000,30000,240000
10,9,14,13,2,285000,370000,655000
14,8,11,-1,2,240000,30000,270000
16,15,6,-1,2,213000,30000,243000
20,16,10,-1,2,201000,30000,231000
9,20,10,-1,2,249000,30000,279000
16,18,7,-1,2,237000,15000,252000
13,8,10,-1,2,276000,45000,321000
17,8,15,13,2,231000,250000,481000
11,7,16,-1,2,243000,30000,273000
14,16,20,-1,2,195000,45000,240000
16,10,9,-1,2,297000,60000,357000
18,16,19,-1,2,153000,90000,243000
13,20,18,-1,2,189000,45000,234000
16,14,13,-1,2,210000,30000,240000
5,9,15,12,2,306000,355000,661000
19,8,15,-1,2,246000,30000,276000
5,17,14,-1,2,246000,15000,261000
18,7,5,-1,2,237000,15000,252000
11,15,7,-1,2,255000,45000,300000
17,7,16,-1,2,204000,30000,234000
9,12,14,-1,2,267000,75000,342000
18,15,10,13,2,249000,250000,499000
20,14,17,-1,2,192000,45000,237000
9,17,13,-1,2,207000,15000,222000
9,7,10,-1,2,258000,90000,348000
19,11,9,-1,2,183000,15000,198000
19,16,12,-1,2,237000,45000,282000
16,12,10,-1,2,267000,45000,312000
19,9,11,13,2,267000,300000,567000
10,7,12,-1,2,231000,30000,261000
20,6,16,-1,2,180000,15000,195000
6,18,14,-1,2,243000,15000,258000
19,18,14,-1,2,189000,75000,264000
5,18,20,-1,2,174000,15000,189000
8,7,9,-1,2,306000,90000,396000
8,18,11,12,2,261000,315000,576000
8,12,16,-1,2,216000,15000,231000
5,18,13,-1,2,216000,15000,231000
14,7,5,-1,2,255000,30000,285000
10,5,16,-1,2,207000,15000,222000
16,5,18,-1,2,210000,15000,225000
6,20,9,-1,2,237000,15000,252000
5,7,9,11,2,333000,285000,618000
8,6,17,-1,2,237000,15000,252000
10,6,18,-1,2,216000,15000,231000
10,16,8,-1,2,255000,30000,285000
17,12,18,-1,2,201000,75000,276000
5,10,8,-1,2,294000,75000,369000
11,10,20,-1,2,186000,30000,216000
14,20,5,13,2,285000,235000,520000
12,11,13,-1,2,243000,90000,333000
17,14,11,-1,2,240000,45000,285000
7,19,17,-1,2,219000,15000,234000
7,18,12,-1,2,234000,15000,249000
16,11,8,-1,2,276000,45000,321000
9,15,12,-1,2,240000,45000,285000
11,19,13,13,2,225000,155000,380000
8,13,16,-1,2,264000,45000,309000
17,19,6,-1,2,192000,15000,207000
12,18,14,-1,2,249000,45000,294000
19,8,19,-1,1,153000,0,153000
14,18,7,-1,2,228000,30000,258000
11,16,8,-1,2,267000,45000,312000
5,16,15,12,2,261000,195000,456000
6,12,15,-1,2,228000,15000,243000
13,14,6,-1,2,243000,45000,288000
15,17,7,-1,2,210000,15000,225000
10,13,15,-1,2,249000,75000,324000
13,9,17,-1,2,246000,45000,291000
12,8,15,-1,2,246000,45000,291000
20,8,14,13,2,240000,235000,475000
15,6,14,-1,2,240000,30000,270000
10,11,14,-1,2,252000,90000,342000
13,19,19,-1,1,117000,0,117000
12,13,11,-1,2,270000,90000,360000
5,15,9,-1,2,261000,30000,291000
11,8,16,-1,2,240000,45000,285000
12,20,8,13,2,249000,300000,549000
18,12,13,-1,2,234000,60000,294000
19,17,10,-1,2,222000,30000,252000
5,17,13,-1,2,252000,15000,267000
16,19,6,-1,2,210000,15000,225000
10,16,13,-1,2,267000,45000,312000
11,12,13,-1,2,252000,90000,342000
15,12,13,11,2,243000,105000,348000
10,5,13,-1,2,273000,45000,318000
12,10,20,-1,2,174000,15000,189000
19,18,20,-1,2,168000,60000,228000
19,10,16,-1,2,240000,30000,270000
8,5,18,-1,2,276000,30000,306000
7,11,19,-1,2,207000,15000,222000
6,7,18,11,2,321000,205000,526000
18,10,8,-1,2,228000,15000,243000
20,13,17,-1,2,219000,45000,264000
15,18,14,-1,2,252000,90000,342000
19,10,8,-1,2,246000,15000,261000
8,6,12,-1,2,276000,45000,321000
15,20,17,-1,2,165000,45000,210000
6,12,17,11,2,285000,205000,490000
9,13,14,-1,2,255000,75000,330000
9,12,20,-1,2,201000,15000,216000
20,6,13,-1,1,216000,0,216000
13,7,10,-1,2,303000,45000,348000
20,9,13,-1,2,171000,15000,186000
13,5,20,-1,1,216000,0,216000
20,6,11,11,2,231000,125000,356000
9,7,19,-1,2,255000,15000,270000
10,20,19,-1,2,192000,30000,222000
6,14,7,-1,2,234000,0,234000
16,14,12,-1,2,204000,75000,279000
7,11,19,-1,2,225000,15000,240000
13,7,6,-1,2,288000,60000,348000
14,20,16,11,2,186000,45000,231000
17,8,12,-1,2,270000,30000,300000
15,13,5,-1,2,237000,15000,252000
6,16,11,-1,2,243000,30000,273000
14,16,20,-1,2,186000,45000,231000
18,14,15,-1,2,252000,90000,342000
7,20,8,-1,2,258000,30000,288000
11,8,6,13,2,324000,285000,609000
9,18,13,-1,2,252000,30000,282000
6,15,16,-1,2,240000,30000,270000
11,8,9,-1,2,279000,105000,384000
11,6,19,-1,2,198000,15000,213000
20,16,12,-1,2,219000,45000,264000
10,19,16,-1,2,231000,30000,261000
11,18,15,13,2,285000,250000,535000
12,13,17,-1,2,234000,60000,294000
9,6,15,-1,2,282000,30000,312000
5,8,6,-1,2,252000,105000,357000
12,13,17,-1,2,216000,60000,276000
6,20,9,-1,2,237000,15000,252000
9,6,8,-1,2,276000,90000,366000
18,15,13,12,2,195000,45000,240000
15,16,8,-1,2,261000,45000,306000
14,12,17,-1,2,231000,45000,276000
18,16,13,-1,2,231000,75000,306000
6,12,14,-1,2,276000,30000,306000
12,18,9,-1,2,228000,30000,258000
9,11,6,-1,2,276000,75000,351000
10,13,5,12,2,270000,345000,615000
14,8,12,-1,2,282000,45000,327000
19,5,16,-1,2,201000,15000,216000
16,5,14,-1,2,255000,15000,270000
8,13,9,-1,2,270000,60000,330000
15,12,17,-1,2,204000,75000,279000
16,10,6,-1,2,279000,30000,309000
11,14,5,13,2,249000,345000,594000
15,17,9,-1,2,201000,15000,216000
17,12,14,-1,2,231000,45000,276000
19,17,13,-1,2,219000,45000,264000
8,9,6,-1,2,294000,90000,384000
18,6,8,-1,2,210000,15000,225000
19,18,6,-1,2,204000,30000,234000
6,14,7,11,2,339000,225000,564000
10,7,9,-1,2,276000,90000,366000
18,15,10,-1,2,210000,45000,255000
6,17,11,-1,2,225000,15000,240000
20,15,8,-1,2,207000,15000,222000
15,10,17,-1,2,255000,45000,300000
16,13,7,-1,2,240000,30000,270000
9,11,20,11,2,204000,125000,329000
6,13,15,-1,2,276000,30000,306000
9,13,15,-1,2,228000,45000,273000
19,5,7,-1,2,219000,15000,234000
15,11,13,-1,2,240000,75000,315000
6,20,5,-1,2,231000,30000,261000
13,20,5,-1,1,207000,0,207000
8,6,17,12,2,321000,195000,516000
6,14,7,-1,2,294000,45000,339000
7,16,5,-1,2,219000,15000,234000
16,9,6,-1,2,255000,30000,285000
9,11,10,-1,2,243000,90000,333000
18,14,8,-1,2,201000,30000,231000
5,20,15,-1,2,225000,15000,240000
19,7,20,11,2,273000,200000,473000
9,6,5,-1,2,261000,90000,351000
18,11,12,-1,2,225000,60000,285000
6,14,17,-1,2,237000,15000,252000
12,15,8,-1,2,255000,45000,300000
14,15,17,-1,2,207000,105000,312000
11,13,16,-1,2,267000,45000,312000
14,7,11,13,2,276000,345000,621000
6,12,13,-1,2,240000,30000,270000
13,17,5,-1,2,207000,15000,222000
7,10,17,-1,2,255000,30000,285000
19,16,10,-1,2,195000,30000,225000
13,16,12,-1,2,270000,90000,360000
9,5,8,-1,2,285000,90000,375000
12,16,14,13,2,231000,280000,511000
8,11,19,-1,2,210000,15000,225000
18,13,16,-1,2,240000,75000,315000
13,9,18,-1,2,261000,30000,291000
11,10,16,-1,2,261000,60000,321000
20,15,6,-1,2,207000,15000,222000
16,17,7,-1,2,240000,30000,270000
7,17,12,11,2,309000,265000,574000
16,7,9,-1,2,291000,30000,321000
12,16,5,-1,2,219000,30000,249000
19,18,16,-1,2,153000,90000,243000
17,13,19,-1,2,201000,45000,246000
20,15,11,-1,2,243000,30000,273000
19,14,13,-1,2,252000,60000,312000
17,13,6,12,2,297000,265000,562000
19,7,13,-1,1,171000,0,171000
10,9,15,-1,2,288000,60000,348000
19,20,5,-1,2,174000,30000,204000
20,13,15,-1,2,183000,30000,213000
8,7,13,-1,2,297000,60000,357000
5,20,17,-1,2,183000,15000,198000
7,14,15,11,2,327000,195000,522000
15,16,7,-1,2,267000,30000,297000
12,15,8,-1,2,255000,45000,300000
20,16,14,-1,2,195000,45000,240000
9,18,19,-1,2,240000,30000,270000
7,9,5,-1,2,297000,120000,417000
10,14,6,-1,2,237000,45000,282000
17,11,14,11,2,273000,235000,508000
8,13,16,-1,2,282000,45000,327000
16,9,17,-1,2,216000,45000,261000
12,13,11,-1,2,261000,90000,351000
19,16,5,-1,2,219000,15000,234000
12,10,14,-1,2,267000,75000,342000
14,16,9,-1,2,237000,45000,282000
15,9,16,11,2,291000,220000,511000
17,9,13,-1,2,273000,45000,318000
5,8,19,-1,2,228000,15000,243000
7,14,16,-1,2,240000,30000,270000
19,9,14,-1,2,225000,30000,255000
20,5,10,-1,2,216000,15000,231000
14,6,15,-1,2,258000,30000,288000
9,19,18,11,2,267000,200000,467000
6,14,20,-1,1,162000,0,162000
18,7,11,-1,2,243000,15000,258000
11,19,6,-1,2,234000,15000,249000
11,19,18,-1,2,204000,45000,249000
5,6,7,-1,2,237000,45000,282000
12,16,15,-1,2,204000,90000,294000
5,15,17,12,2,297000,235000,532000
14,12,20,-1,2,180000,15000,195000
17,13,16,-1,2,240000,90000,330000
18,15,5,-1,2,255000,15000,270000
20,12,6,-1,1,198000,0,198000
16,13,14,-1,2,261000,105000,366000
15,16,17,-1,2,222000,90000,312000
13,15,6,12,2,276000,235000,511000
18,11,20,-1,2,210000,30000,240000
16,7,17,-1,2,195000,30000,225000
10,19,5,-1,2,234000,15000,249000
9,12,16,-1,2,258000,45000,303000
18,19,5,-1,2,204000,30000,234000
5,17,12,-1,2,264000,30000,294000
13,15,11,12,2,270000,280000,550000
6,16,18,-1,2,192000,15000,207000
19,16,18,-1,2,180000,90000,270000
16,20,19,-1,2,150000,75000,225000
12,14,8,-1,2,264000,45000,309000
13,10,17,-1,2,231000,45000,276000
18,7,13,-1,2,228000,30000,258000
12,16,7,11,2,300000,265000,565000
15,8,11,-1,2,294000,45000,339000
17,19,18,-1,2,144000,75000,219000
16,18,11,-1,2,237000,45000,282000
11,10,7,-1,2,285000,90000,375000
10,8,18,-1,2,192000,15000,207000
10,15,19,-1,2,234000,30000,264000
9,6,13,11,2,315000,345000,660000
12,5,17,-1,2,252000,15000,267000
13,20,14,-1,2,225000,60000,285000
12,16,19,-1,2,237000,45000,282000
10,14,18,-1,2,255000,45000,300000
6,17,19,-1,2,210000,15000,225000
8,17,14,-1,2,249000,30000,279000
9,15,12,13,2,276000,360000,636000
5,18,16,-1,2,210000,15000,225000
19,7,20,-1,2,201000,30000,231000
13,15,8,-1,2,219000,15000,234000
19,18,16,-1,2,153000,90000,243000
19,15,9,-1,2,201000,30000,231000
14,16,18,-1,2,231000,75000,306000
14,18,7,13,2,285000,265000,550000
19,14,16,-1,2,204000,45000,249000
18,5,6,-1,2,279000,45000,324000
11,15,8,-1,2,258000,45000,303000
18,5,20,-1,2,183000,15000,198000
9,18,6,-1,2,264000,15000,279000
9,17,6,-1,2,237000,15000,252000
14,19,16,13,2,213000,45000,258000
6,10,7,-1,2,306000,90000,396000
17,20,12,-1,2,192000,45000,237000
13,11,18,-1,2,258000,45000,303000
13,7,6,-1,2,279000,60000,339000
6,10,6,-1,2,153000,15000,168000
14,15,8,-1,2,216000,45000,261000
12,6,9,13,2,306000,295000,601000
5,20,16,-1,2,234000,15000,249000
8,19,7,-1,2,258000,30000,288000
6,19,11,-1,2,225000,15000,240000
12,5,10,-1,2,264000,45000,309000
20,12,6,-1,1,162000,0,162000
8,7,11,-1,2,306000,90000,396000
9,15,12,13,2,240000,360000,600000
20,7,19,-1,2,183000,30000,213000
20,7,12,-1,1,180000,0,180000
12,5,19,-1,1,207000,0,207000
14,18,12,-1,2,249000,45000,294000
7,6,19,-1,2,249000,30000,279000
7,12,9,-1,2,267000,45000,312000
13,12,6,12,2,216000,175000,391000
18,12,19,-1,2,195000,45000,240000
10,13,15,-1,2,222000,30000,252000
12,15,6,-1,2,231000,30000,261000
13,5,9,-1,2,255000,45000,300000
10,15,11,-1,2,234000,60000,294000
16,10,20,-1,2,192000,30000,222000
5,20,12,11,2,327000,205000,532000
9,16,7,-1,2,291000,30000,321000
10,14,17,-1,2,210000,45000,255000
6,16,17,-1,2,231000,30000,261000
9,18,15,-1,2,231000,30000,261000
14,13,8,-1,2,273000,75000,348000
14,18,20,-1,2,171000,45000,216000
19,6,13,11,2,285000,175000,460000
8,16,6,-1,2,246000,15000,261000
20,19,17,-1,2,141000,75000,216000
13,14,12,-1,2,252000,90000,342000
17,14,13,-1,2,243000,90000,333000
11,6,8,-1,2,285000,45000,330000
18,7,16,-1,2,192000,15000,207000
14,20,17,12,2,210000,45000,255000
7,11,17,-1,1,189000,0,189000
8,14,6,-1,2,264000,30000,294000
9,13,12,-1,2,231000,90000,321000
8,6,9,-1,2,258000,90000,348000
7,15,10,-1,2,249000,45000,294000
9,15,19,-1,2,183000,30000,213000
19,15,6,12,2,297000,205000,502000
12,20,17,-1,2,183000,15000,198000
19,11,14,-1,2,267000,45000,312000
12,10,9,-1,2,279000,105000,384000
19,8,10,-1,2,201000,15000,216000
12,19,7,-1,2,225000,15000,240000
15,20,18,-1,2,189000,75000,264000
17,19,13,11,2,201000,45000,246000
8,6,16,-1,2,264000,15000,279000
16,10,5,-1,2,225000,15000,240000
16,5,18,-1,2,210000,15000,225000
17,9,5,-1,2,243000,15000,258000
13,7,14,-1,2,243000,45000,288000
17,10,9,-1,2,249000,45000,294000
9,14,15,11,2,291000,195000,486000
18,7,14,-1,2,255000,30000,285000
5,15,10,-1,2,261000,30000,291000
13,6,20,-1,1,162000,0,162000
17,11,7,-1,2,279000,30000,309000
18,12,16,-1,2,201000,45000,246000
13,16,11,-1,2,258000,45000,303000
18,12,17,13,2,258000,220000,478000
18,16,13,-1,2,213000,75000,288000
13,11,9,-1,2,285000,75000,360000
20,6,17,-1,2,192000,15000,207000
7,18,12,-1,2,243000,15000,258000
16,8,5,-1,2,255000,15000,270000
18,12,14,-1,2,222000,45000,267000
7,20,11,12,2,297000,270000,567000
20,14,19,-1,2,165000,30000,195000
12,11,7,-1,2,240000,30000,270000
18,17,14,-1,2,174000,90000,264000
10,13,12,-1,2,234000,45000,279000
17,16,14,-1,2,195000,90000,285000
7,5,18,-1,2,267000,30000,297000
10,7,11,13,2,300000,310000,610000
14,16,12,-1,2,258000,75000,333000
9,15,10,-1,2,279000,60000,339000
15,7,17,-1,2,210000,15000,225000
7,14,13,-1,2,252000,45000,297000
8,10,6,-1,2,258000,75000,333000
6,8,7,-1,2,252000,90000,342000
7,9,18,11,2,279000,285000,564000
17,8,18,-1,2,240000,30000,270000
20,12,13,-1,2,249000,45000,294000
14,15,13,-1,2,252000,90000,342000
5,8,18,-1,2,264000,15000,279000
5,13,12,-1,2,261000,45000,306000
9,11,17,-1,2,219000,30000,249000
14,13,18,12,2,225000,60000,285000
7,11,15,-1,2,282000,45000,327000
10,18,11,-1,2,222000,45000,267000
15,13,17,-1,2,222000,75000,297000
16,20,17,-1,2,201000,90000,291000
10,15,11,-1,2,252000,60000,312000
18,17,13,-1,2,201000,75000,276000
14,15,8,12,2,306000,225000,531000
19,6,7,-1,2,207000,0,207000
18,6,17,-1,2,222000,30000,252000
17,19,7,-1,2,228000,15000,243000
11,15,16,-1,2,246000,75000,321000
12,13,18,-1,2,252000,60000,312000
15,9,7,-1,2,273000,30000,303000
13,17,16,11,2,195000,90000,285000
8,7,14,-1,2,306000,60000,366000
8,18,11,-1,2,228000,30000,258000
10,12,7,-1,2,267000,75000,342000
15,19,15,-1,2,117000,15000,132000
7,15,14,-1,2,261000,45000,306000
18,6,13,-1,2,216000,15000,231000
19,8,20,12,2,255000,200000,455000
6,15,12,-1,2,240000,30000,270000
10,14,8,-1,2,258000,45000,303000
15,20,13,-1,2,195000,45000,240000
19,15,7,-1,2,234000,15000,249000
13,9,18,-1,2,243000,30000,273000
9,17,19,-1,2,210000,15000,225000
13,15,7,13,2,252000,160000,412000
5,12,14,-1,2,267000,30000,297000
16,7,17,-1,2,204000,30000,234000
16,7,20,-1,2,216000,15000,231000
9,12,18,-1,2,264000,30000,294000
15,13,17,-1,2,222000,75000,297000
16,9,6,-1,2,291000,30000,321000
18,20,9,11,2,249000,170000,419000
17,9,19,-1,2,183000,15000,198000
20,10,14,-1,2,243000,30000,273000
11,6,13,-1,2,273000,45000,318000
13,15,18,-1,2,195000,45000,240000
11,15,16,-1,2,246000,75000,321000
18,8,8,-1,1,162000,0,162000
8,16,5,12,2,294000,210000,504000
14,20,9,-1,2,216000,15000,231000
14,12,20,-1,2,246000,30000,276000
6,15,8,-1,2,282000,30000,312000
5,7,12,-1,2,240000,45000,285000
18,13,14,-1,2,207000,60000,267000
12,15,19,-1,2,249000,45000,294000
16,18,5,12,2,297000,220000,517000
9,17,6,-1,1,198000,0,198000
14,5,15,-1,2,240000,30000,270000
15,10,11,-1,2,252000,60000,312000
12,18,20,-1,2,174000,30000,204000
19,11,8,-1,1,180000,0,180000
13,15,20,-1,2,231000,45000,276000
19,5,9,12,2,324000,295000,619000
20,12,16,-1,2,246000,45000,291000
14,11,14,-1,2,210000,15000,225000
19,10,7,-1,2,201000,15000,216000
12,11,12,-1,2,204000,30000,234000
11,16,10,-1,2,234000,60000,294000
5,12,8,-1,2,267000,45000,312000
17,20,13,12,2,183000,45000,228000
7,18,12,-1,2,243000,15000,258000
16,7,13,-1,2,249000,30000,279000
17,14,12,-1,2,231000,45000,276000
17,16,8,-1,2,240000,30000,270000
7,16,8,-1,2,285000,45000,330000
17,14,20,-1,2,174000,45000,219000
16,12,9,13,2,276000,300000,576000
14,6,8,-1,2,291000,30000,321000
11,5,16,-1,2,219000,30000,249000
14,16,13,-1,2,216000,105000,321000
18,11,10,-1,2,267000,45000,312000
15,12,17,-1,2,231000,75000,306000
11,15,12,-1,2,270000,90000,360000
14,5,20,12,2,279000,190000,469000
17,16,6,-1,2,204000,30000,234000
5,13,11,-1,2,267000,30000,297000
18,14,6,-1,2,198000,15000,213000
13,9,20,-1,2,198000,15000,213000
8,13,5,-1,2,306000,60000,366000
20,5,19,-1,2,165000,30000,195000
8,6,16,11,2,300000,155000,455000
5,6,9,-1,2,270000,90000,360000
17,15,13,-1,2,195000,75000,270000
8,10,12,-1,2,285000,75000,360000
15,16,11,-1,2,201000,75000,276000
17,20,7,-1,2,219000,15000,234000
8,17,19,-1,2,237000,15000,252000
13,19,18,12,2,216000,75000,291000
17,16,13,-1,2,198000,45000,243000
10,12,16,-1,2,258000,45000,303000
17,8,19,-1,2,201000,15000,216000
19,5,15,-1,2,234000,15000,249000
5,17,10,-1,2,243000,15000,258000
18,13,20,-1,2,189000,45000,234000
17,8,14,13,2,258000,220000,478000
13,7,6,-1,2,306000,60000,366000
19,18,14,-1,2,162000,75000,237000
18,15,14,-1,2,210000,30000,240000
9,20,14,-1,2,207000,15000,222000
17,11,6,-1,2,252000,15000,267000
12,15,19,-1,2,231000,45000,276000
5,13,11,12,2,306000,360000,666000
12,11,9,-1,2,243000,45000,288000
5,12,6,-1,2,252000,60000,312000
17,15,11,-1,2,201000,45000,246000
6,7,12,-1,2,288000,60000,348000
18,20,8,-1,2,174000,15000,189000
17,14,5,-1,2,264000,15000,279000
14,5,8,11,2,315000,355000,670000
18,10,11,-1,2,267000,45000,312000
18,17,20,-1,2,162000,90000,252000
13,17,7,-1,2,237000,30000,267000
15,6,8,-1,2,264000,30000,294000
9,18,6,-1,2,210000,15000,225000
17,19,7,-1,2,210000,15000,225000
6,5,15,11,2,339000,210000,549000
16,11,12,-1,2,252000,60000,312000
5,10,7,-1,2,267000,45000,312000
6,17,10,-1,2,198000,15000,213000
12,17,7,-1,2,252000,30000,282000
12,11,13,-1,2,234000,90000,324000
16,20,12,-1,2,219000,45000,264000
18,17,14,13,2,219000,90000,309000
16,18,7,-1,2,192000,15000,207000
12,17,6,-1,2,246000,30000,276000
13,8,7,-1,2,270000,60000,330000
10,18,16,-1,2,186000,30000,216000
11,16,9,-1,2,276000,45000,321000
11,16,18,-1,2,210000,45000,255000
9,16,13,12,2,288000,265000,553000
14,20,11,-1,2,189000,15000,204000
5,19,15,-1,2,225000,15000,240000
14,13,9,-1,2,255000,75000,330000
5,15,9,-1,2,252000,30000,282000
7,17,10,-1,2,237000,30000,267000
7,11,12,-1,2,246000,75000,321000
6,9,15,11,2,279000,315000,594000
8,16,9,-1,2,285000,45000,330000
20,12,16,-1,2,201000,45000,246000
14,15,17,-1,2,243000,105000,348000
19,13,18,-1,2,225000,75000,300000
7,16,12,-1,2,207000,15000,222000
7,14,11,-1,2,246000,45000,291000
8,17,18,13,2,231000,220000,451000
8,20,19,-1,2,183000,30000,213000
19,16,5,-1,2,192000,15000,207000
7,20,19,-1,2,210000,30000,240000
6,16,12,-1,2,216000,15000,231000
17,9,18,-1,2,204000,30000,234000
16,18,10,-1,2,231000,30000,261000
10,5,17,13,2,303000,340000,643000
20,13,14,-1,2,207000,15000,222000
19,8,10,-1,2,228000,15000,243000
15,8,12,-1,2,264000,45000,309000
13,6,5,-1,2,258000,45000,303000
17,7,14,-1,2,213000,30000,243000
13,19,7,-1,2,216000,15000,231000
16,12,10,11,2,309000,265000,574000
15,6,13,-1,2,276000,30000,306000
6,13,20,-1,1,171000,0,171000
16,18,17,-1,2,210000,90000,300000
13,8,20,-1,2,198000,15000,213000
17,16,11,-1,2,246000,75000,321000
12,10,19,-1,2,246000,30000,276000
6,14,13,12,2,279000,255000,534000
9,16,7,-1,2,225000,15000,240000
13,5,17,-1,2,207000,15000,222000
7,17,6,-1,2,240000,30000,270000
13,19,6,-1,2,216000,15000,231000
6,19,13,-1,2,225000,15000,240000
13,9,12,-1,2,258000,90000,348000
5,14,12,13,2,258000,360000,618000
15,14,16,-1,2,216000,90000,306000
11,5,18,-1,2,252000,15000,267000
16,8,15,-1,2,243000,45000,288000
17,5,15,-1,2,228000,15000,243000
10,19,11,-1,2,249000,45000,294000
16,13,7,-1,2,240000,30000,270000
10,13,16,13,2,234000,145000,379000
18,7,15,-1,2,237000,15000,252000
20,5,12,-1,1,207000,0,207000
9,13,11,-1,2,276000,75000,351000
8,10,11,-1,2,249000,90000,339000
19,5,6,-1,2,213000,30000,243000
13,20,5,-1,1,198000,0,198000
17,5,9,12,2,324000,325000,649000
5,6,18,-1,2,279000,45000,324000
12,8,10,-1,2,258000,75000,333000
5,20,9,-1,2,189000,15000,204000
13,5,14,-1,2,267000,30000,297000
9,20,12,-1,2,192000,15000,207000
12,18,5,-1,2,252000,15000,267000
17,20,12,11,2,219000,45000,264000
10,6,13,-1,2,282000,45000,327000
8,11,14,-1,2,240000,45000,285000
6,13,20,-1,1,171000,0,171000
9,14,20,-1,2,225000,15000,240000
15,16,7,-1,2,267000,30000,297000
20,12,17,-1,2,219000,45000,264000
12,16,13,11,2,261000,90000,351000
19,18,12,-1,2,204000,45000,249000
8,15,17,-1,2,201000,15000,216000
17,16,18,-1,2,183000,90000,273000
18,7,11,-1,2,207000,15000,222000
16,5,9,-1,2,243000,15000,258000
17,6,13,-1,2,228000,30000,258000
6,19,15,12,2,270000,205000,475000
13,8,19,-1,1,171000,0,171000
11,5,13,-1,2,276000,30000,306000
17,11,5,-1,2,207000,15000,222000
10,8,17,-1,2,246000,30000,276000
5,10,12,-1,2,246000,45000,291000
18,6,10,-1,2,198000,15000,213000
20,12,19,13,2,246000,230000,476000
10,6,16,-1,2,261000,30000,291000
13,18,11,-1,2,213000,45000,258000
9,12,18,-1,2,246000,30000,276000
6,11,9,-1,2,276000,75000,351000
15,19,12,-1,2,204000,45000,249000
9,6,7,-1,2,297000,105000,402000
8,15,17,12,2,252000,235000,487000
14,10,15,-1,2,222000,30000,252000
13,16,5,-1,2,237000,15000,252000
13,15,10,-1,2,240000,75000,315000
18,20,17,-1,2,162000,90000,252000
16,5,12,-1,2,255000,30000,285000
6,14,20,-1,1,171000,0,171000
10,15,14,13,2,285000,255000,540000
16,17,10,-1,2,216000,45000,261000
13,14,16,-1,2,252000,105000,357000
16,11,6,-1,2,279000,30000,309000
6,7,9,-1,2,252000,105000,357000
8,16,11,-1,2,240000,45000,285000
11,18,9,-1,2,228000,30000,258000
7,9,17,12,2,297000,325000,622000
14,11,7,-1,2,291000,45000,336000
18,13,20,-1,2,171000,45000,216000
9,6,11,-1,2,222000,30000,252000
9,12,15,-1,2,231000,45000,276000
13,8,14,-1,2,246000,75000,321000
20,18,8,-1,2,183000,15000,198000
20,10,5,13,2,312000,295000,607000
20,8,7,-1,2,198000,0,198000
11,6,13,-1,2,273000,45000,318000
14,7,9,-1,2,240000,45000,285000
18,5,14,-1,2,198000,15000,213000
19,7,18,-1,2,213000,30000,243000
10,5,8,-1,2,306000,120000,426000
6,15,19,11,2,273000,160000,433000
12,16,19,-1,2,246000,45000,291000
20,5,16,-1,2,225000,15000,240000
20,15,5,-1,2,234000,15000,249000
8,17,11,-1,2,264000,30000,294000
18,16,12,-1,2,210000,45000,255000
7,14,5,-1,2,282000,30000,312000
14,19,7,12,2,252000,220000,472000
15,19,17,-1,2,177000,30000,207000
18,6,17,-1,2,249000,30000,279000
5,8,12,-1,2,294000,45000,339000
5,15,10,-1,2,234000,30000,264000
18,11,13,-1,2,213000,45000,258000
13,7,19,-1,2,216000,15000,231000
15,7,6,12,2,321000,225000,546000
11,15,13,-1,2,249000,75000,324000
17,19,6,-1,2,210000,15000,225000
5,5,14,-1,1,189000,0,189000
13,19,20,-1,2,147000,45000,192000
16,15,11,-1,2,219000,75000,294000
7,17,12,-1,2,261000,30000,291000
16,7,6,11,2,294000,195000,489000
11,7,12,-1,2,273000,75000,348000
7,15,20,-1,2,189000,15000,204000
13,6,9,-1,2,285000,45000,330000
11,5,7,-1,2,240000,45000,285000
8,11,12,-1,2,240000,90000,330000
9,8,20,-1,2,213000,30000,243000
19,6,15,13,2,267000,250000,517000
11,20,17,-1,2,183000,30000,213000
9,10,12,-1,2,246000,30000,276000
6,9,19,-1,2,210000,15000,225000
20,11,15,-1,2,216000,30000,246000
16,7,14,-1,2,258000,30000,288000
8,9,16,-1,2,258000,45000,303000
5,11,13,13,2,222000,240000,462000
9,16,14,-1,2,246000,45000,291000
18,7,6,-1,2,240000,30000,270000
20,16,7,-1,2,198000,15000,213000
17,11,15,-1,2,246000,45000,291000
20,6,5,-1,2,240000,30000,270000
9,11,20,-1,2,219000,15000,234000
15,19,20,13,2,186000,75000,261000
10,11,17,-1,2,252000,60000,312000
13,16,20,-1,2,213000,45000,258000
10,15,7,-1,2,303000,45000,348000
13,8,7,-1,2,252000,60000,312000
13,16,19,-1,2,195000,45000,240000
12,18,13,-1,2,270000,60000,330000
13,6,9,11,2,315000,345000,660000
6,16,9,-1,2,291000,30000,321000
14,7,12,-1,2,237000,45000,282000
9,11,18,-1,2,219000,30000,249000
8,18,20,-1,2,192000,15000,207000
9,17,19,-1,2,237000,15000,252000
16,12,7,-1,2,270000,30000,300000
14,8,10,11,2,291000,345000,636000
20,10,9,-1,2,249000,30000,279000
7,5,8,-1,2,285000,90000,375000
6,20,13,-1,1,162000,0,162000
10,8,5,-1,2,306000,120000,426000
9,17,11,-1,2,219000,30000,249000
18,7,11,-1,2,207000,15000,222000
10,17,13,12,2,288000,265000,553000
16,18,9,-1,2,192000,15000,207000
7,6,8,-1,2,288000,90000,378000
11,13,20,-1,2,201000,30000,231000
11,14,12,-1,2,261000,105000,366000
18,20,8,-1,2,201000,15000,216000
8,20,16,-1,2,234000,15000,249000
20,13,5,12,2,297000,205000,502000
17,6,7,-1,2,225000,0,225000
12,9,18,-1,2,228000,30000,258000
18,8,10,-1,2,219000,15000,234000
12,11,19,-1,2,249000,45000,294000
13,7,13,-1,1,180000,0,180000
11,7,17,-1,2,225000,30000,255000
8,19,7,13,2,285000,180000,465000
8,17,10,-1,2,273000,30000,303000
18,17,20,-1,2,144000,90000,234000
11,15,7,-1,2,273000,45000,318000
8,20,10,-1,2,192000,15000,207000
8,10,7,-1,2,288000,105000,393000
14,17,7,-1,2,213000,30000,243000
5,18,13,13,2,234000,155000,389000
6,9,11,-1,2,285000,75000,360000
17,12,13,-1,2,216000,60000,276000
18,7,17,-1,2,231000,30000,261000
20,10,7,-1,2,246000,15000,261000
17,6,5,-1,2,267000,30000,297000
6,7,14,-1,2,258000,45000,303000
9,17,16,13,2,231000,195000,426000
16,19,6,-1,2,210000,15000,225000
15,6,7,-1,2,294000,45000,339000
6,15,5,-1,2,231000,30000,261000
17,12,8,-1,2,225000,30000,255000
11,16,5,-1,2,237000,30000,267000
17,18,13,-1,2,192000,75000,267000
10,18,10,13,2,312000,325000,637000
13,10,12,-1,2,234000,45000,279000
17,7,5,-1,2,228000,15000,243000
17,14,9,-1,2,228000,45000,273000
10,12,15,-1,2,240000,45000,285000
6,7,5,-1,2,270000,90000,360000
15,13,19,-1,2,195000,45000,240000
16,15,17,11,2,222000,90000,312000
13,8,15,-1,2,219000,15000,234000
18,19,16,-1,2,153000,90000,243000
12,7,11,-1,2,255000,75000,330000
6,5,14,-1,2,249000,45000,294000
8,6,9,-1,2,240000,90000,330000
13,15,19,-1,2,195000,45000,240000
13,11,12,13,2,261000,240000,501000
6,9,8,-1,2,276000,90000,366000
16,5,17,-1,2,204000,30000,234000
6,13,18,-1,2,234000,15000,249000
20,13,18,-1,2,198000,45000,243000
20,15,14,-1,2,189000,15000,204000
18,6,5,-1,2,267000,30000,297000
15,11,12,12,2,234000,145000,379000
12,8,9,-1,2,279000,90000,369000
7,8,14,-1,2,252000,60000,312000
9,18,19,-1,2,186000,30000,216000
16,8,14,-1,2,258000,30000,288000
20,16,13,-1,2,222000,45000,267000
6,18,8,-1,2,264000,15000,279000
14,10,13,12,2,270000,255000,525000
19,7,13,-1,1,171000,0,171000
14,9,20,-1,2,216000,15000,231000
13,6,17,-1,2,264000,30000,294000
20,18,13,-1,2,189000,45000,234000
19,16,14,-1,2,177000,30000,207000
6,7,5,-1,2,309000,120000,429000
13,15,20,11,2,195000,45000,240000
11,20,18,-1,2,210000,30000,240000
6,18,7,-1,2,207000,0,207000
14,15,7,-1,2,243000,45000,288000
13,9,15,-1,2,237000,45000,282000
9,18,12,-1,2,237000,30000,267000
11,6,16,-1,2,261000,30000,291000
12,18,9,13,2,240000,315000,555000
7,16,11,-1,2,243000,30000,273000
15,5,14,-1,2,231000,30000,261000
11,5,20,-1,1,189000,0,189000
20,11,15,-1,2,234000,30000,264000
16,17,19,-1,2,201000,105000,306000
6,8,19,-1,2,219000,15000,234000
11,17,6,13,2,276000,315000,591000
9,6,19,-1,1,189000,0,189000
15,6,18,-1,2,228000,15000,243000
15,14,17,-1,2,234000,105000,339000
14,12,15,-1,2,258000,90000,348000
12,19,6,-1,2,234000,15000,249000
9,19,16,-1,2,222000,30000,252000
16,15,16,11,2,186000,30000,216000
12,14,19,-1,2,231000,45000,276000
16,11,18,-1,2,237000,45000,282000
5,7,11,-1,2,276000,45000,321000
18,16,8,-1,2,192000,15000,207000
15,16,6,-1,2,249000,30000,279000
20,5,17,-1,2,210000,15000,225000
12,9,14,11,2,327000,280000,607000
13,7,8,-1,2,306000,60000,366000
6,8,17,-1,2,210000,15000,225000
6,12,11,-1,2,255000,75000,330000
14,6,16,-1,2,210000,15000,225000
5,7,10,-1,2,258000,45000,303000
8,9,5,-1,2,249000,90000,339000
20,16,19,11,2,132000,75000,207000
19,20,6,-1,2,201000,30000,231000
5,14,11,-1,2,237000,15000,252000
19,16,7,-1,2,192000,15000,207000
14,12,10,-1,2,267000,75000,342000
18,8,9,-1,2,222000,30000,252000
10,9,13,-1,2,279000,90000,369000
20,9,5,11,2,288000,270000,558000
12,10,20,-1,2,219000,15000,234000
6,11,6,-1,2,207000,15000,222000
19,16,13,-1,2,195000,45000,240000
19,8,13,-1,2,234000,15000,249000
18,19,5,-1,2,231000,30000,261000
12,16,5,-1,2,264000,30000,294000
10,15,7,12,2,288000,330000,618000
6,20,10,-1,2,243000,15000,258000
5,10,13,-1,2,273000,45000,318000
20,6,10,-1,2,189000,15000,204000
12,7,14,-1,2,273000,45000,318000
5,12,15,-1,2,231000,30000,261000
7,6,14,-1,2,258000,45000,303000
16,5,10,13,2,258000,355000,613000
7,15,5,-1,1,207000,0,207000
8,20,7,-1,2,213000,30000,243000
8,5,15,-1,2,282000,30000,312000
14,15,6,-1,2,222000,30000,252000
12,5,18,-1,2,225000,15000,240000
15,14,10,-1,2,228000,75000,303000
7,15,9,12,2,306000,355000,661000
9,12,8,-1,2,306000,90000,396000
16,7,12,-1,2,225000,30000,255000
20,18,10,-1,2,183000,15000,198000
10,11,15,-1,2,288000,60000,348000
18,7,10,-1,2,219000,15000,234000
9,17,6,-1,2,246000,15000,261000
14,5,6,12,2,309000,200000,509000
7,5,14,-1,2,273000,30000,303000
11,16,10,-1,2,234000,60000,294000
19,6,14,-1,2,216000,15000,231000
19,20,11,-1,2,192000,30000,222000
12,17,6,-1,2,216000,15000,231000
19,17,10,-1,2,195000,30000,225000
8,12,11,13,2,306000,400000,706000
9,5,8,-1,2,243000,45000,288000
18,15,7,-1,2,201000,15000,216000
5,17,20,-1,2,219000,15000,234000
16,7,15,-1,2,267000,30000,297000
5,16,5,-1,1,171000,0,171000
9,10,13,-1,2,243000,90000,333000
15,6,17,13,2,240000,250000,490000
13,15,9,-1,2,237000,45000,282000
12,14,20,-1,2,210000,30000,240000
11,9,13,-1,2,276000,75000,351000
6,16,15,-1,2,222000,30000,252000
18,17,10,-1,2,225000,45000,270000
10,17,14,-1,2,255000,45000,300000
7,17,9,13,2,294000,210000,504000
16,12,18,-1,2,246000,45000,291000
20,18,9,-1,2,219000,15000,234000
17,11,20,-1,2,219000,30000,249000
10,7,11,-1,2,243000,45000,288000
19,6,18,-1,2,186000,30000,216000
19,17,7,-1,2,237000,15000,252000
5,6,8,12,2,351000,215000,566000
8,16,7,-1,2,267000,45000,312000
17,13,9,-1,2,219000,45000,264000
20,5,12,-1,1,189000,0,189000
20,7,5,-1,2,237000,15000,252000
13,17,9,-1,2,255000,45000,300000
17,14,8,-1,2,222000,30000,252000
20,6,10,12,2,306000,270000,576000
10,17,9,-1,2,285000,45000,330000
8,14,15,-1,2,234000,45000,279000
13,11,16,-1,2,240000,45000,285000
7,14,16,-1,2,240000,30000,270000
8,10,20,-1,2,210000,15000,225000
15,19,13,-1,2,231000,45000,276000
11,5,7,12,2,330000,285000,615000
14,6,12,-1,2,258000,30000,288000
14,6,10,-1,2,246000,45000,291000
12,7,16,-1,2,225000,30000,255000
11,18,6,-1,2,207000,15000,222000
17,11,19,-1,2,204000,30000,234000
20,17,5,-1,2,237000,15000,252000
5,15,10,12,2,324000,330000,654000
12,11,18,-1,2,279000,60000,339000
5,20,6,-1,2,231000,30000,261000
10,18,7,-1,2,237000,15000,252000
5,6,14,-1,2,285000,45000,330000
8,18,19,-1,2,186000,30000,216000
11,14,16,-1,2,267000,75000,342000
11,9,6,13,2,315000,285000,600000
9,15,10,-1,2,288000,60000,348000
13,19,7,-1,2,198000,15000,213000
14,20,17,-1,2,210000,45000,255000
17,6,8,-1,1,198000,0,198000
16,5,20,-1,2,198000,15000,213000
16,15,5,-1,2,258000,30000,288000
11,6,5,12,2,321000,285000,606000
13,8,9,-1,2,279000,60000,339000
6,12,11,-1,2,237000,75000,312000
5,19,6,-1,2,213000,30000,243000
19,15,17,-1,2,192000,75000,267000
14,20,7,-1,1,162000,0,162000
18,17,20,-1,2,189000,90000,279000
11,9,16,12,2,297000,330000,627000
16,19,18,-1,2,168000,45000,213000
17,11,13,-1,2,201000,30000,231000
11,14,13,-1,2,240000,90000,330000
18,20,12,-1,2,183000,30000,213000
8,20,14,-1,1,162000,0,162000
12,7,11,-1,2,291000,75000,366000
20,5,12,11,2,273000,205000,478000
20,16,19,-1,2,186000,75000,261000
11,9,20,-1,2,219000,15000,234000
8,6,16,-1,2,255000,15000,270000
19,16,15,-1,2,195000,90000,285000
19,20,10,-1,2,165000,30000,195000
5,9,20,-1,1,180000,0,180000
13,15,7,13,2,243000,160000,403000
8,11,12,-1,2,276000,90000,366000
19,17,15,-1,2,174000,75000,249000
11,16,15,-1,2,213000,30000,243000
15,18,5,-1,2,228000,15000,243000
7,6,13,-1,2,288000,60000,348000
18,12,16,-1,2,192000,45000,237000
18,17,11,13,2,276000,220000,496000
10,9,15,-1,2,261000,60000,321000
9,16,12,-1,2,240000,45000,285000
11,9,16,-1,2,249000,45000,294000
10,20,17,-1,2,183000,30000,213000
17,9,16,-1,2,195000,30000,225000
10,19,5,-1,2,234000,15000,249000
10,13,5,13,2,249000,265000,514000
8,11,18,-1,2,255000,30000,285000
9,8,18,-1,2,222000,30000,252000
9,19,12,-1,2,255000,30000,285000
12,17,20,-1,2,219000,45000,264000
5,14,18,-1,2,243000,15000,258000
12,6,5,-1,2,279000,60000,339000
19,13,20,12,2,147000,45000,192000
16,8,19,-1,2,210000,15000,225000
14,11,17,-1,2,258000,45000,303000
14,9,5,-1,2,270000,30000,300000
13,10,8,-1,2,240000,45000,285000
7,16,12,-1,2,225000,30000,255000
5,10,6,-1,2,261000,60000,321000
6,7,9,11,2,297000,285000,582000
5,15,17,-1,2,228000,15000,243000
20,18,15,-1,2,180000,75000,255000
19,7,18,-1,2,204000,30000,234000
7,7,15,-1,1,198000,0,198000
5,19,6,-1,2,213000,30000,243000
6,11,12,-1,2,264000,75000,339000
16,8,11,13,2,249000,330000,579000
9,19,14,-1,2,198000,15000,213000
17,7,11,-1,2,252000,30000,282000
20,10,17,-1,2,183000,30000,213000
8,10,9,-1,2,237000,45000,282000
8,16,12,-1,2,228000,45000,273000
8,15,20,-1,2,189000,15000,204000
8,10,16,13,2,303000,355000,658000
13,5,11,-1,2,228000,15000,243000
19,13,9,-1,2,207000,30000,237000
18,8,12,-1,2,243000,30000,273000
11,14,17,-1,2,231000,45000,276000
15,17,9,-1,2,231000,30000,261000
19,10,6,-1,2,234000,15000,249000
8,9,10,11,2,318000,400000,718000
7,17,5,-1,2,264000,15000,279000
5,7,5,-1,2,165000,15000,180000
17,15,14,-1,2,198000,105000,303000
19,17,6,-1,2,237000,15000,252000
6,10,14,-1,2,282000,45000,327000
14,19,5,-1,2,198000,15000,213000
5,18,17,12,2,279000,245000,524000
14,10,8,-1,2,228000,30000,258000
18,15,11,-1,2,201000,45000,246000
16,6,20,-1,2,216000,15000,231000
11,7,9,-1,2,285000,75000,360000
19,14,17,-1,2,174000,75000,249000
20,14,9,-1,1,162000,0,162000
17,18,9,12,2,306000,245000,551000
8,14,9,-1,2,243000,15000,258000
15,13,15,-1,2,147000,15000,162000
18,10,13,-1,2,231000,45000,276000
10,7,12,-1,2,276000,75000,351000
9,16,14,-1,2,219000,45000,264000
19,18,17,-1,2,153000,75000,228000
19,14,20,13,2,186000,75000,261000
20,6,13,-1,1,171000,0,171000
9,6,12,-1,2,303000,45000,348000
12,9,17,-1,2,231000,45000,276000
9,12,5,-1,2,255000,45000,300000
15,6,20,-1,2,189000,15000,204000
11,15,17,-1,2,237000,45000,282000
18,20,8,12,2,276000,215000,491000
9,16,5,-1,2,216000,15000,231000
11,6,15,-1,2,252000,30000,282000
13,8,10,-1,2,240000,45000,285000
17,20,10,-1,2,174000,30000,204000
7,14,6,-1,2,225000,0,225000
9,13,20,-1,2,171000,15000,186000
19,7,9,12,2,333000,295000,628000
14,13,15,-1,2,261000,90000,351000
20,12,9,-1,2,228000,15000,243000
10,12,13,-1,2,276000,90000,366000
12,16,7,-1,2,243000,30000,273000
9,15,13,-1,2,228000,45000,273000
19,14,5,-1,2,216000,15000,231000
18,12,8,11,2,300000,235000,535000
19,18,17,-1,2,189000,75000,264000
12,11,17,-1,2,261000,60000,321000
11,13,19,-1,2,228000,30000,258000
20,10,9,-1,2,231000,30000,261000
6,8,14,-1,2,282000,30000,312000
9,20,15,-1,2,183000,30000,213000
18,5,8,11,2,333000,295000,628000
17,19,18,-1,2,180000,75000,255000
6,17,12,-1,2,246000,30000,276000
19,18,17,-1,2,153000,75000,228000
7,14,16,-1,2,249000,30000,279000
6,17,11,-1,2,216000,15000,231000
13,12,15,-1,2,243000,105000,348000
12,18,17,11,2,228000,75000,303000
5,16,13,-1,2,264000,15000,279000
7,5,8,-1,2,258000,90000,348000
15,14,16,-1,2,198000,90000,288000
20,15,10,-1,2,252000,30000,282000
18,6,16,-1,2,228000,15000,243000
18,19,17,-1,2,171000,75000,246000
10,18,17,13,2,267000,220000,487000
13,12,11,-1,2,243000,90000,333000
17,12,13,-1,2,243000,60000,303000
12,6,18,-1,2,234000,15000,249000
17,14,11,-1,2,240000,45000,285000
14,5,12,-1,2,267000,30000,297000
18,8,15,-1,2,204000,30000,234000
18,5,19,13,2,267000,245000,512000
19,7,17,-1,2,201000,15000,216000
11,9,12,-1,2,276000,90000,366000
8,14,5,-1,2,255000,30000,285000
5,6,11,-1,2,252000,60000,312000
8,9,12,-1,2,252000,90000,342000
5,9,20,-1,2,189000,15000,204000
11,9,10,12,2,318000,400000,718000
8,18,6,-1,2,264000,15000,279000
15,8,14,-1,2,234000,45000,279000
6,12,11,-1,2,264000,75000,339000
20,11,13,-1,2,201000,30000,231000
18,17,7,-1,2,231000,30000,261000
9,7,13,-1,2,285000,45000,330000
9,5,19,13,2,267000,180000,447000
7,20,16,-1,2,234000,15000,249000
17,9,6,-1,2,255000,15000,270000
17,11,20,-1,2,192000,30000,222000
5,15,20,-1,2,189000,15000,204000
11,12,11,-1,2,204000,30000,234000
19,10,16,-1,2,186000,30000,216000
14,20,16,11,2,240000,45000,285000
8,13,17,-1,2,270000,30000,300000
11,5,20,-1,1,189000,0,189000
8,18,15,-1,2,249000,30000,279000
8,20,10,-1,2,228000,15000,243000
19,16,14,-1,2,222000,45000,267000
16,10,14,-1,2,264000,45000,309000
17,10,20,13,2,258000,190000,448000
8,11,13,-1,2,258000,75000,333000
13,7,6,-1,2,261000,60000,321000
17,5,15,-1,2,201000,15000,216000
18,7,12,-1,2,216000,15000,231000
9,17,6,-1,2,246000,15000,261000
17,9,13,-1,2,246000,45000,291000
18,6,12,11,2,291000,235000,526000
12,18,16,-1,2,246000,45000,291000
18,7,9,-1,2,246000,15000,261000
15,5,11,-1,2,246000,30000,276000
5,18,19,-1,2,195000,30000,225000
19,17,10,-1,2,240000,30000,270000
10,11,20,-1,2,231000,30000,261000
6,5,14,11,2,348000,225000,573000
7,18,6,-1,2,249000,30000,279000
17,18,6,-1,2,213000,30000,243000
19,17,8,-1,2,228000,15000,243000
7,5,9,-1,2,285000,75000,360000
10,14,15,-1,2,210000,75000,285000
7,11,9,-1,2,267000,75000,342000
14,20,18,13,2,162000,45000,207000
8,6,12,-1,2,228000,30000,258000
18,20,14,-1,2,162000,45000,207000
11,16,17,-1,2,204000,30000,234000
10,5,17,-1,2,243000,15000,258000
8,9,12,-1,2,270000,90000,360000
9,12,8,-1,2,252000,90000,342000
19,14,9,12,2,252000,220000,472000
10,19,8,-1,1,180000,0,180000
20,12,19,-1,2,192000,45000,237000
14,15,16,-1,2,207000,90000,297000
8,18,13,-1,2,270000,30000,300000
18,5,19,-1,2,204000,30000,234000
19,6,9,-1,2,264000,15000,279000
13,7,19,12,2,279000,235000,514000
9,12,13,-1,2,243000,45000,288000
9,17,16,-1,2,207000,45000,252000
7,8,18,-1,2,249000,30000,279000
20,18,17,-1,2,162000,90000,252000
16,9,11,-1,2,267000,45000,312000
6,10,19,-1,2,207000,15000,222000
16,7,8,12,2,303000,210000,513000
7,5,14,-1,2,282000,30000,312000
19,20,15,-1,2,141000,75000,216000
9,7,19,-1,2,219000,15000,234000
14,15,20,-1,2,225000,60000,285000
8,20,14,-1,2,234000,15000,249000
13,12,5,-1,2,288000,45000,333000
8,15,6,12,2,276000,225000,501000
10,14,11,-1,2,279000,90000,369000
20,11,14,-1,2,219000,30000,249000
12,9,13,-1,2,276000,90000,366000
17,19,18,-1,2,153000,75000,228000
14,11,18,-1,2,249000,45000,294000
8,6,5,-1,2,288000,105000,393000
17,14,12,13,2,231000,265000,496000
5,11,17,-1,2,225000,15000,240000
8,7,6,-1,2,270000,90000,360000
9,17,19,-1,2,183000,15000,198000
19,20,11,-1,2,210000,30000,240000
20,12,18,-1,2,174000,15000,189000
7,8,15,-1,2,303000,45000,348000
5,16,13,11,2,273000,250000,523000
12,17,11,-1,2,279000,60000,339000
12,7,9,-1,2,267000,45000,312000
8,9,7,-1,2,252000,90000,342000
11,5,18,-1,2,207000,15000,222000
18,18,10,-1,1,144000,0,144000
13,6,14,-1,2,252000,45000,297000
19,18,8,11,2,258000,200000,458000
6,14,8,-1,2,225000,15000,240000
14,7,9,-1,2,240000,45000,285000
5,6,10,-1,2,252000,60000,312000
12,17,6,-1,2,210000,30000,240000
14,12,17,-1,2,222000,45000,267000
12,15,17,-1,2,240000,75000,315000
9,16,15,11,2,318000,220000,538000
19,14,18,-1,2,216000,75000,291000
10,12,8,-1,2,231000,30000,261000
15,17,18,-1,2,165000,90000,255000
20,18,15,-1,2,165000,30000,195000
6,15,20,-1,2,180000,15000,195000
14,16,6,-1,2,246000,15000,261000
20,19,13,12,2,165000,45000,210000
7,20,13,-1,2,207000,15000,222000
9,17,12,-1,2,267000,45000,312000
19,13,12,-1,2,234000,60000,294000
5,10,14,-1,2,270000,30000,300000
7,19,8,-1,2,213000,30000,243000
14,15,10,-1,2,237000,75000,312000
9,20,5,13,2,294000,205000,499000
9,17,11,-1,2,273000,30000,303000
20,17,8,-1,2,201000,15000,216000
5,7,20,-1,2,249000,30000,279000
11,16,15,-1,2,237000,75000,312000
8,14,15,-1,2,252000,45000,297000
15,13,11,-1,2,240000,75000,315000
19,20,10,12,2,255000,200000,455000
11,5,20,-1,1,189000,0,189000
12,9,10,-1,2,288000,105000,393000
8,10,12,-1,2,249000,75000,324000
18,13,7,-1,2,201000,30000,231000
6,8,7,-1,2,279000,90000,369000
9,10,11,-1,2,243000,90000,333000
20,11,5,12,2,270000,270000,540000
11,8,16,-1,2,216000,15000,231000
19,6,17,-1,2,192000,15000,207000
6,12,13,-1,2,279000,45000,324000
8,9,16,-1,2,249000,45000,294000
18,19,6,-1,2,195000,30000,225000
16,11,8,-1,2,294000,45000,339000
10,12,18,11,2,282000,235000,517000
12,18,19,-1,2,222000,45000,267000
18,8,12,-1,1,180000,0,180000
13,10,18,-1,2,258000,45000,303000
17,10,15,-1,2,237000,45000,282000
15,19,9,-1,2,210000,30000,240000
12,7,18,-1,2,234000,15000,249000
20,16,10,13,2,267000,205000,472000
9,20,18,-1,2,192000,15000,207000
5,12,9,-1,2,294000,60000,354000
6,9,7,-1,2,252000,105000,357000
17,7,5,-1,2,219000,15000,234000
17,18,10,-1,2,207000,45000,252000
6,12,16,-1,2,255000,30000,285000
8,13,9,11,2,297000,345000,642000
5,18,10,-1,2,252000,15000,267000
20,19,16,-1,2,150000,75000,225000
7,11,18,-1,2,225000,15000,240000
9,18,20,-1,2,210000,15000,225000
14,5,20,-1,1,216000,0,216000
10,7,15,-1,2,303000,45000,348000
7,14,19,12,2,252000,220000,472000
13,12,18,-1,2,216000,15000,231000
5,18,15,-1,2,228000,15000,243000
20,5,6,-1,2,240000,30000,270000
17,7,8,-1,2,249000,30000,279000
7,17,8,-1,2,240000,30000,270000
13,15,13,-1,2,174000,15000,189000
6,13,18,12,2,261000,265000,526000
20,12,10,-1,1,162000,0,162000
14,12,20,-1,2,246000,30000,276000
19,6,10,-1,2,243000,15000,258000
14,6,7,-1,2,276000,45000,321000
17,14,9,-1,2,219000,45000,264000
9,13,8,-1,2,270000,60000,330000
6,14,18,13,2,231000,265000,496000
20,17,5,-1,2,201000,15000,216000
7,19,16,-1,2,246000,15000,261000
19,11,8,-1,2,237000,15000,252000
18,10,8,-1,2,237000,15000,252000
19,6,9,-1,2,246000,15000,261000
17,5,16,-1,2,231000,30000,261000
17,20,5,11,2,297000,185000,482000
20,18,13,-1,2,165000,15000,180000
6,16,11,-1,2,288000,30000,318000
5,12,11,-1,2,243000,45000,288000
7,18,19,-1,2,186000,30000,216000
9,19,11,-1,2,237000,15000,252000
11,6,13,-1,2,282000,45000,327000
9,19,7,11,2,279000,270000,549000
20,18,6,-1,2,219000,15000,234000
10,7,5,-1,2,297000,90000,387000
12,10,14,-1,2,222000,75000,297000
17,18,6,-1,2,213000,30000,243000
9,17,6,-1,2,255000,15000,270000
9,6,5,-1,2,279000,90000,369000
18,6,12,11,2,273000,235000,508000
17,11,15,-1,2,255000,45000,300000
8,14,7,-1,2,288000,60000,348000
12,20,19,-1,2,156000,45000,201000
17,18,7,-1,2,204000,30000,234000
11,19,5,-1,1,216000,0,216000
9,13,20,-1,2,216000,15000,231000
13,16,15,12,2,249000,90000,339000
16,10,17,-1,2,243000,45000,288000
10,19,17,-1,2,231000,30000,261000
12,19,14,-1,2,249000,45000,294000
5,17,18,-1,2,231000,30000,261000
8,14,10,-1,2,285000,45000,330000
18,19,5,-1,2,186000,30000,216000
10,13,11,13,2,267000,240000,507000
7,6,10,-1,2,279000,90000,369000
12,13,14,-1,2,216000,90000,306000
16,15,6,-1,2,249000,30000,279000
20,12,11,-1,2,240000,45000,285000
11,8,17,-1,2,264000,30000,294000
5,11,9,-1,2,255000,45000,300000
17,5,6,13,2,282000,170000,452000
12,20,17,-1,2,228000,45000,273000
7,20,8,-1,2,249000,30000,279000
18,19,12,-1,2,204000,45000,249000
16,20,8,-1,2,180000,15000,195000
19,18,9,-1,2,231000,30000,261000
11,7,12,-1,2,291000,75000,366000
15,12,14,11,2,204000,90000,294000
16,12,6,-1,2,246000,30000,276000
9,19,7,-1,2,219000,15000,234000
8,19,18,-1,2,213000,30000,243000
14,19,11,-1,2,267000,45000,312000
19,15,10,-1,2,234000,30000,264000
13,17,6,-1,2,246000,30000,276000
13,14,7,11,2,291000,225000,516000
9,7,19,-1,2,255000,15000,270000
19,7,14,-1,2,216000,15000,231000
16,19,8,-1,2,228000,15000,243000
6,12,7,-1,2,297000,60000,357000
19,12,5,-1,1,171000,0,171000
18,6,13,-1,2,243000,15000,258000
10,11,12,13,2,288000,400000,688000
11,10,16,-1,2,234000,15000,249000
12,6,5,-1,2,261000,60000,321000
13,8,10,-1,2,240000,45000,285000
15,11,7,-1,2,237000,45000,282000
19,17,9,-1,2,183000,15000,198000
8,6,11,-1,2,285000,45000,330000
8,17,7,12,2,276000,195000,471000
17,9,13,-1,2,264000,45000,309000
17,15,18,-1,2,183000,90000,273000
8,7,12,-1,2,246000,30000,276000
20,6,17,-1,2,183000,15000,198000
15,5,6,-1,2,288000,45000,333000
9,7,8,-1,2,261000,90000,351000
19,17,7,12,2,252000,215000,467000
14,16,13,-1,2,219000,30000,249000
19,9,15,-1,2,210000,30000,240000
19,7,17,-1,2,228000,15000,243000
19,6,8,-1,2,246000,15000,261000
18,8,9,-1,2,231000,30000,261000
7,8,5,-1,2,276000,90000,366000
7,12,18,13,2,240000,315000,555000
6,19,13,-1,2,216000,15000,231000
7,18,9,-1,2,228000,15000,243000
14,11,20,-1,2,228000,30000,258000
9,9,17,-1,1,180000,0,180000
20,7,11,-1,2,198000,15000,213000
12,16,19,-1,2,228000,45000,273000
8,5,14,11,2,333000,355000,688000
17,17,12,-1,2,189000,15000,204000
9,15,18,-1,2,204000,30000,234000
15,14,16,-1,2,243000,90000,333000
5,16,20,-1,2,234000,15000,249000
17,13,8,-1,2,261000,30000,291000
6,15,17,-1,2,219000,15000,234000
12,7,14,11,2,300000,280000,580000
20,7,8,-1,2,258000,30000,288000
14,7,6,-1,2,285000,45000,330000
6,14,18,-1,2,198000,15000,213000
7,12,19,-1,2,216000,15000,231000
15,9,18,-1,2,231000,30000,261000
10,16,11,-1,2,279000,60000,339000
10,9,14,12,2,288000,345000,633000
19,13,16,-1,2,249000,45000,294000
12,8,11,-1,2,294000,90000,384000
5,12,19,-1,1,180000,0,180000
9,8,11,-1,2,297000,105000,402000
14,12,15,-1,2,204000,90000,294000
6,13,20,-1,1,198000,0,198000
19,18,12,11,2,222000,45000,267000
13,10,14,-1,2,234000,45000,279000
19,9,12,-1,2,228000,30000,258000
19,15,20,-1,2,168000,75000,243000
12,13,7,-1,2,255000,75000,330000
14,19,15,-1,2,198000,60000,258000
14,11,12,-1,2,279000,105000,384000
9,17,6,11,2,306000,300000,606000
15,6,16,-1,2,258000,30000,288000
20,12,10,-1,2,201000,15000,216000
10,12,13,-1,2,276000,90000,366000
13,16,5,-1,2,237000,15000,252000
11,10,5,-1,2,255000,75000,330000
17,16,10,-1,2,198000,45000,243000
17,11,18,12,2,297000,245000,542000
17,19,10,-1,2,183000,15000,198000
14,18,16,-1,2,231000,75000,306000
10,12,18,-1,2,264000,30000,294000
6,17,16,-1,2,231000,30000,261000
20,9,14,-1,2,207000,15000,222000
5,19,10,-1,2,252000,15000,267000
17,14,13,13,2,258000,265000,523000
6,13,9,-1,2,267000,45000,312000
17,14,9,-1,2,219000,45000,264000
9,15,11,-1,2,249000,45000,294000
12,5,17,-1,2,216000,15000,231000
17,9,14,-1,2,237000,45000,282000
16,5,18,-1,2,210000,15000,225000
7,19,16,12,2,288000,190000,478000
11,7,16,-1,2,225000,15000,240000
8,13,7,-1,2,252000,60000,312000
16,10,19,-1,2,186000,30000,216000
18,11,9,-1,2,273000,30000,303000
11,17,10,-1,2,252000,60000,312000
12,20,15,-1,2,222000,45000,267000
18,17,6,12,2,297000,245000,542000
15,14,9,-1,2,222000,30000,252000
12,17,16,-1,2,210000,75000,285000
7,19,15,-1,2,234000,15000,249000
17,18,10,-1,2,234000,45000,279000
9,10,19,-1,2,240000,30000,270000
17,20,16,-1,2,201000,90000,291000
10,9,15,12,2,288000,330000,618000
14,12,14,-1,2,210000,15000,225000
9,5,12,-1,2,237000,45000,282000
10,19,5,-1,2,198000,15000,213000
13,14,9,-1,2,246000,75000,321000
16,15,9,-1,2,225000,45000,270000
8,9,15,-1,2,288000,60000,348000
15,5,14,11,2,273000,195000,468000
20,9,10,-1,2,249000,30000,279000
13,15,20,-1,2,240000,45000,285000
9,5,11,-1,2,282000,45000,327000
11,18,16,-1,2,201000,45000,246000
11,16,9,-1,2,267000,45000,312000
12,13,15,-1,2,225000,105000,330000
16,10,9,12,2,306000,315000,621000
8,6,5,-1,2,309000,135000,444000
10,17,13,-1,2,222000,45000,267000
19,9,10,-1,2,222000,30000,252000
11,7,14,-1,2,282000,45000,327000
17,18,19,-1,2,135000,75000,210000
13,6,12,-1,2,270000,45000,315000
16,5,17,13,2,240000,195000,435000
16,8,5,-1,2,237000,15000,252000
8,19,14,-1,2,210000,30000,240000
6,10,19,-1,2,234000,15000,249000
16,14,18,-1,2,213000,75000,288000
11,9,12,-1,2,285000,90000,375000
10,5,8,-1,2,258000,75000,333000
16,11,19,12,2,252000,190000,442000
16,14,6,-1,2,210000,15000,225000
15,14,19,-1,2,216000,60000,276000
16,5,20,-1,2,234000,15000,249000
19,14,18,-1,2,207000,75000,282000
15,9,19,-1,2,189000,15000,204000
5,7,9,-1,2,276000,75000,351000
8,15,13,11,2,273000,250000,523000
17,5,19,-1,2,237000,15000,252000
20,15,9,-1,2,228000,30000,258000
12,20,18,-1,2,201000,30000,231000
14,5,8,-1,2,225000,15000,240000
18,20,12,-1,2,156000,30000,186000
8,10,6,-1,2,231000,30000,261000
15,18,16,11,2,177000,105000,282000
14,17,10,-1,2,210000,15000,225000
16,12,11,-1,2,252000,60000,312000
12,15,17,-1,2,231000,75000,306000
10,6,13,-1,2,282000,45000,327000
14,11,13,-1,2,213000,90000,303000
12,14,6,-1,2,249000,30000,279000
5,8,14,13,2,285000,280000,565000
16,7,6,-1,2,267000,30000,297000
10,20,17,-1,2,192000,30000,222000
10,17,7,-1,1,180000,0,180000
5,7,9,-1,2,267000,75000,342000
17,9,19,-1,2,183000,15000,198000
9,15,16,-1,2,252000,45000,297000
11,16,12,13,2,276000,345000,621000
18,19,6,-1,2,204000,30000,234000
11,19,6,-1,2,252000,15000,267000
9,8,13,-1,2,279000,60000,339000
15,14,19,-1,2,198000,60000,258000
17,18,14,-1,2,228000,90000,318000
10,19,7,-1,1,189000,0,189000
19,8,18,13,2,258000,245000,503000
18,7,10,-1,2,219000,15000,234000
7,10,6,-1,2,288000,90000,378000
17,5,10,-1,2,207000,15000,222000
18,14,9,-1,2,225000,30000,255000
9,11,10,-1,2,270000,90000,360000
17,20,13,-1,2,192000,45000,237000
14,5,5,11,2,348000,225000,573000
20,12,15,-1,2,231000,45000,276000
12,17,16,-1,2,237000,75000,312000
20,18,19,-1,2,159000,60000,219000
5,8,6,-1,2,309000,135000,444000
19,18,8,-1,2,186000,30000,216000
12,11,19,-1,2,267000,45000,312000
17,12,13,12,2,288000,265000,553000
12,19,7,-1,1,180000,0,180000
6,14,16,-1,2,246000,15000,261000
6,15,13,-1,2,240000,30000,270000
6,19,5,-1,2,222000,30000,252000
7,10,20,-1,2,228000,15000,243000
6,19,15,-1,2,225000,15000,240000
11,9,18,13,2,285000,300000,585000
10,18,12,-1,2,198000,15000,213000
12,19,9,-1,2,246000,30000,276000
12,19,17,-1,2,219000,45000,264000
11,18,13,-1,2,258000,45000,303000
17,12,14,-1,2,231000,45000,276000
11,20,7,-1,2,225000,15000,240000
16,15,20,11,2,213000,60000,273000
20,10,5,-1,1,180000,0,180000
6,12,13,-1,2,270000,45000,315000
10,10,13,-1,2,174000,15000,189000
5,10,17,-1,2,207000,15000,222000
17,20,17,-1,2,129000,15000,144000
10,16,14,-1,2,264000,45000,309000
7,17,19,13,2,258000,220000,478000
5,18,19,-1,2,204000,30000,234000
14,19,17,-1,2,228000,75000,303000
8,16,9,-1,2,216000,0,216000
16,15,12,-1,2,222000,90000,312000
16,14,11,-1,2,258000,75000,333000
10,8,12,-1,2,276000,75000,351000
11,20,13,12,2,252000,205000,457000
7,15,10,-1,2,225000,15000,240000
15,8,19,-1,2,192000,30000,222000
15,9,7,-1,2,273000,30000,303000
18,6,14,-1,2,198000,15000,213000
20,9,18,-1,2,201000,15000,216000
15,17,13,-1,2,249000,75000,324000
15,13,5,12,2,297000,280000,577000
10,20,13,-1,1,162000,0,162000
12,13,20,-1,2,258000,45000,303000
12,15,10,-1,2,267000,45000,312000
10,9,15,-1,2,261000,60000,321000
19,11,13,-1,2,210000,30000,240000
9,13,18,-1,2,243000,30000,273000
18,12,17,11,2,219000,75000,294000
8,5,16,-1,2,264000,15000,279000
17,18,16,-1,2,174000,90000,264000
6,8,19,-1,2,219000,15000,234000
6,20,11,-1,2,216000,15000,231000
11,19,12,-1,2,249000,45000,294000
17,8,15,-1,2,240000,30000,270000
10,15,6,11,2,309000,330000,639000
15,13,17,-1,2,249000,75000,324000
16,11,6,-1,2,279000,30000,309000
5,12,18,-1,2,207000,15000,222000
20,11,6,-1,2,207000,15000,222000
15,20,5,-1,2,225000,15000,240000
14,12,12,-1,2,192000,15000,207000
19,18,16,11,2,144000,90000,234000
11,12,15,-1,2,243000,90000,333000
13,8,14,-1,2,255000,75000,330000
17,9,10,-1,2,240000,45000,285000
5,11,9,-1,2,255000,45000,300000
6,11,13,-1,2,237000,45000,282000
19,13,16,-1,2,195000,45000,240000
10,8,14,12,2,324000,345000,669000
5,17,13,-1,2,264000,30000,294000
9,14,8,-1,2,270000,60000,330000
9,20,10,-1,2,195000,30000,225000
20,18,11,-1,2,210000,30000,240000
6,12,7,-1,2,234000,15000,249000
12,20,9,-1,2,183000,15000,198000
10,12,14,11,2,327000,280000,607000
8,5,17,-1,2,276000,30000,306000
16,14,18,-1,2,204000,75000,279000
9,8,12,-1,2,306000,90000,396000
14,16,20,-1,2,186000,45000,231000
18,11,19,-1,2,231000,45000,276000
20,6,5,-1,2,189000,0,189000
14,13,6,11,2,309000,225000,534000
7,17,5,-1,2,276000,30000,306000
20,9,14,-1,2,180000,15000,195000
18,5,13,-1,2,252000,15000,267000
12,11,16,-1,2,252000,60000,312000
9,19,20,-1,2,192000,30000,222000
9,12,7,-1,2,240000,30000,270000
12,19,20,13,2,219000,230000,449000
10,6,17,-1,2,225000,15000,240000
17,20,11,-1,2,192000,30000,222000
14,6,13,-1,2,231000,30000,261000
8,5,19,-1,2,219000,15000,234000
13,20,8,-1,2,207000,15000,222000
20,11,5,-1,1,216000,0,216000
20,7,14,11,2,318000,175000,493000
19,10,11,-1,2,276000,45000,321000
11,14,16,-1,2,240000,75000,315000
6,18,10,-1,2,234000,15000,249000
13,8,15,-1,2,255000,45000,300000
8,6,10,-1,2,249000,75000,324000
18,11,19,-1,2,177000,45000,222000
15,9,17,12,2,267000,190000,457000
12,18,8,-1,2,261000,30000,291000
15,13,11,-1,2,231000,75000,306000
18,16,14,-1,2,213000,75000,288000
13,18,20,-1,2,225000,45000,270000
14,6,5,-1,2,225000,0,225000
6,11,13,-1,2,237000,45000,282000
18,19,13,11,2,171000,75000,246000
17,12,16,-1,2,195000,30000,225000
5,11,20,-1,1,207000,0,207000
15,8,12,-1,2,273000,45000,318000
18,9,17,-1,2,204000,30000,234000
13,12,13,-1,2,213000,30000,243000
7,5,10,-1,2,240000,45000,285000
12,11,9,12,2,225000,240000,465000
10,17,9,-1,2,258000,45000,303000
12,10,18,-1,2,228000,30000,258000
11,14,7,-1,2,264000,45000,309000
14,17,6,-1,2,210000,15000,225000
14,7,17,-1,2,240000,30000,270000
17,9,20,-1,2,210000,15000,225000
19,7,13,13,2,261000,155000,416000
13,20,7,-1,2,225000,15000,240000
8,16,13,-1,2,264000,45000,309000
5,10,11,-1,2,246000,75000,321000
19,6,9,-1,2,210000,15000,225000
19,12,11,-1,2,240000,45000,285000
6,17,8,-1,2,246000,15000,261000
11,9,7,13,2,297000,285000,582000
6,17,5,-1,2,276000,30000,306000
16,14,13,-1,2,216000,105000,321000
5,7,16,-1,2,264000,15000,279000
13,20,18,-1,2,180000,45000,225000
15,7,19,-1,2,180000,15000,195000
19,13,5,-1,1,207000,0,207000
18,17,8,12,2,297000,245000,542000
7,18,14,-1,2,198000,15000,213000
12,14,18,-1,2,231000,45000,276000
12,8,17,-1,2,252000,30000,282000
20,14,7,-1,2,207000,15000,222000
17,19,9,-1,2,219000,15000,234000
13,5,14,-1,2,276000,30000,306000
15,17,8,11,2,282000,220000,502000
5,18,12,-1,2,252000,15000,267000
10,12,18,-1,2,237000,30000,267000
19,14,20,-1,2,177000,75000,252000
5,18,9,-1,2,216000,15000,231000
7,14,16,-1,2,231000,30000,261000
5,9,16,-1,2,225000,15000,240000
7,11,19,13,2,267000,300000,567000
9,19,15,-1,2,189000,15000,204000
6,9,5,-1,2,288000,90000,378000
15,7,13,-1,2,213000,30000,243000
9,18,15,-1,2,213000,30000,243000
12,7,13,-1,2,282000,75000,357000
17,15,5,-1,2,201000,15000,216000
12,14,20,11,2,219000,30000,249000
12,13,18,-1,2,261000,60000,321000
6,10,14,-1,2,273000,45000,318000
9,7,16,-1,2,237000,30000,267000
6,18,15,-1,2,201000,15000,216000
7,18,16,-1,2,228000,15000,243000
17,19,20,-1,2,159000,75000,234000
19,8,12,11,2,309000,205000,514000
19,10,13,-1,2,264000,30000,294000
5,15,13,-1,2,255000,15000,270000
19,20,17,-1,2,132000,75000,207000
12,11,14,-1,2,261000,105000,366000
13,18,5,-1,2,234000,15000,249000
6,13,14,-1,2,252000,45000,297000
6,8,17,12,2,285000,195000,480000
8,9,13,-1,2,297000,60000,357000
11,7,15,-1,2,237000,45000,282000
12,15,6,-1,2,222000,30000,252000
19,8,7,-1,2,231000,30000,261000
18,12,10,-1,2,237000,30000,267000
6,11,19,-1,2,225000,15000,240000
17,11,7,12,2,288000,315000,603000
10,12,5,-1,2,228000,15000,243000
16,17,11,-1,2,201000,75000,276000
14,15,7,-1,2,261000,45000,306000
16,20,7,-1,2,198000,15000,213000
20,17,7,-1,2,228000,15000,243000
16,11,20,-1,2,243000,30000,273000
15,16,17,12,2,222000,90000,312000
12,20,19,-1,2,165000,30000,195000
16,10,14,-1,2,210000,15000,225000
11,9,11,-1,2,174000,15000,189000
7,16,11,-1,2,225000,30000,255000
11,10,9,-1,2,252000,90000,342000
9,10,8,-1,2,261000,90000,351000
19,16,15,13,2,177000,90000,267000
12,20,10,-1,1,162000,0,162000
18,12,8,-1,2,270000,30000,300000
11,8,14,-1,2,258000,45000,303000
11,20,19,-1,2,174000,30000,204000
14,6,8,-1,2,225000,15000,240000
13,5,11,-1,2,231000,30000,261000
19,6,11,11,2,213000,140000,353000
10,11,8,-1,2,267000,90000,357000
11,20,7,-1,2,189000,15000,204000
12,19,18,-1,2,204000,45000,249000
13,19,6,-1,1,171000,0,171000
9,19,16,-1,2,240000,30000,270000
11,16,18,-1,2,246000,45000,291000
6,16,9,13,2,303000,225000,528000
9,20,5,-1,2,246000,30000,276000
14,18,7,-1,2,237000,30000,267000
14,7,11,-1,2,264000,45000,309000
12,9,7,-1,2,240000,45000,285000
5,15,19,-1,2,189000,15000,204000
11,15,19,-1,2,237000,45000,282000
9,19,6,12,2,315000,295000,610000
19,9,15,-1,2,237000,30000,267000
10,8,11,-1,2,285000,90000,375000
14,7,17,-1,2,213000,30000,243000
12,15,9,-1,2,258000,45000,303000
17,9,18,-1,2,213000,30000,243000
10,7,15,-1,2,294000,45000,339000
9,18,8,13,2,267000,195000,462000
6,14,13,-1,2,288000,45000,333000
17,16,11,-1,2,210000,75000,285000
16,9,18,-1,2,231000,30000,261000
17,10,14,-1,2,246000,45000,291000
15,15,16,-1,2,168000,30000,198000
19,11,6,-1,2,225000,15000,240000
15,10,15,13,2,234000,160000,394000
6,11,18,-1,2,234000,15000,249000
6,13,10,-1,2,264000,45000,309000
13,17,19,-1,2,183000,45000,228000
7,13,12,-1,2,291000,75000,366000
13,17,19,-1,2,183000,45000,228000
14,15,11,-1,2,267000,90000,357000
15,14,10,12,2,288000,225000,513000
12,18,13,-1,2,216000,15000,231000
18,15,8,-1,2,231000,30000,261000
16,6,10,-1,2,270000,30000,300000
16,19,13,-1,2,195000,45000,240000
15,9,16,-1,2,261000,45000,306000
7,14,8,-1,2,288000,60000,348000
9,5,8,11,2,300000,310000,610000
7,12,5,-1,2,276000,45000,321000
17,19,9,-1,2,183000,15000,198000
16,15,9,-1,2,252000,45000,297000
16,9,13,-1,2,255000,45000,300000
19,18,14,-1,2,180000,75000,255000
8,9,18,-1,2,216000,0,216000
11,12,16,13,2,258000,345000,603000
6,20,12,-1,1,180000,0,180000
8,14,11,-1,2,294000,45000,339000
6,19,18,-1,2,195000,30000,225000
18,11,17,-1,2,243000,45000,288000
10,9,15,-1,2,297000,60000,357000
6,18,17,-1,2,204000,30000,234000
20,6,14,11,2,318000,175000,493000
6,9,5,-1,2,309000,135000,444000
7,19,8,-1,2,213000,30000,243000
8,15,11,-1,2,267000,45000,312000
16,20,5,-1,2,189000,15000,204000
17,9,11,-1,2,264000,30000,294000
8,9,11,-1,2,270000,105000,375000
17,20,7,13,2,231000,190000,421000
7,8,9,-1,2,270000,90000,360000
20,14,13,-1,2,207000,60000,267000
20,8,10,-1,2,237000,15000,252000
11,12,6,-1,2,273000,75000,348000
18,13,12,-1,2,216000,60000,276000
16,9,13,-1,2,255000,45000,300000
18,12,8,13,2,258000,315000,573000
14,8,13,-1,2,246000,75000,321000
12,11,17,-1,2,234000,60000,294000
20,18,6,-1,2,201000,15000,216000
17,20,15,-1,2,219000,45000,264000
14,9,11,-1,2,231000,30000,261000
12,18,5,-1,2,216000,15000,231000
7,12,16,13,2,258000,345000,603000
18,11,13,-1,2,231000,45000,276000
17,18,20,-1,2,162000,90000,252000
11,9,15,-1,2,267000,45000,312000
14,17,19,-1,2,183000,75000,258000
7,12,13,-1,2,240000,30000,270000
9,10,14,-1,2,243000,60000,303000
19,20,9,12,2,237000,200000,437000
8,6,19,-1,2,219000,15000,234000
7,17,5,-1,2,246000,15000,261000
7,16,12,-1,2,234000,30000,264000
5,11,9,-1,2,246000,45000,291000
14,6,19,-1,2,198000,15000,213000
17,7,12,-1,2,252000,30000,282000
5,17,8,11,2,297000,310000,607000
17,14,7,-1,2,258000,30000,288000
20,16,18,-1,2,171000,75000,246000
17,15,8,-1,2,222000,30000,252000
8,5,11,-1,2,276000,45000,321000
15,10,11,-1,2,234000,60000,294000
16,8,5,-1,2,237000,15000,252000
12,15,18,11,2,222000,45000,267000
8,9,11,-1,2,297000,105000,402000
19,18,10,-1,2,186000,30000,216000
15,6,11,-1,2,288000,30000,318000
19,14,11,-1,2,213000,45000,258000
17,19,12,-1,2,228000,45000,273000
13,18,11,-1,2,258000,45000,303000
7,18,17,12,2,279000,245000,524000
5,15,7,-1,1,207000,0,207000
14,18,5,-1,2,207000,15000,222000
7,8,14,-1,2,279000,60000,339000
13,16,14,-1,2,207000,105000,312000
10,18,19,-1,2,231000,30000,261000
5,6,5,-1,2,225000,45000,270000
6,14,20,13,2,231000,235000,466000
9,10,12,-1,2,261000,105000,366000
9,20,12,-1,2,192000,15000,207000
11,12,7,-1,2,291000,75000,366000
6,17,7,-1,2,222000,30000,252000
10,5,8,-1,2,267000,75000,342000
11,17,16,-1,2,201000,75000,276000
14,16,20,13,2,222000,45000,267000
7,10,17,-1,2,291000,30000,321000
15,10,18,-1,2,219000,45000,264000
10,12,7,-1,2,276000,75000,351000
20,8,7,-1,2,204000,30000,234000
18,15,18,-1,2,165000,15000,180000
13,8,6,-1,2,276000,45000,321000
14,6,15,11,2,273000,195000,468000
18,15,10,-1,2,264000,45000,309000
10,5,10,-1,2,180000,15000,195000
10,17,13,-1,2,222000,45000,267000
6,17,16,-1,2,231000,30000,261000
19,18,17,-1,2,171000,75000,246000
20,5,13,-1,1,207000,0,207000
7,6,17,11,2,330000,180000,510000
19,16,14,-1,2,222000,45000,267000
15,7,11,-1,2,291000,45000,336000
15,18,14,-1,2,198000,90000,288000
17,12,18,-1,2,246000,75000,321000
7,8,9,-1,2,297000,90000,387000
6,10,11,-1,2,237000,75000,312000
14,15,11,13,2,231000,255000,486000
8,19,10,-1,2,210000,15000,225000
5,6,10,-1,2,288000,60000,348000
11,6,8,-1,2,240000,45000,285000
19,17,6,-1,2,183000,15000,198000
11,9,6,-1,2,294000,75000,369000
12,20,19,-1,2,156000,45000,201000
11,7,14,12,2,270000,360000,630000
7,17,20,-1,2,183000,15000,198000
11,10,18,-1,2,276000,45000,321000
7,6,20,-1,2,231000,30000,261000
10,18,9,-1,2,267000,45000,312000
11,12,10,-1,2,252000,90000,342000
15,20,8,-1,2,198000,15000,213000
18,20,17,13,2,180000,90000,270000
9,6,18,-1,2,246000,15000,261000
12,13,20,-1,2,231000,45000,276000
11,19,8,-1,2,237000,15000,252000
11,10,15,-1,2,279000,60000,339000
10,14,12,-1,2,240000,75000,315000
11,20,16,-1,2,207000,30000,237000
10,20,8,12,2,315000,270000,585000
17,20,15,-1,2,219000,45000,264000
17,20,8,-1,2,183000,15000,198000
8,9,10,-1,2,306000,90000,396000
13,6,18,-1,2,198000,15000,213000
10,7,6,-1,2,279000,90000,369000
16,6,12,-1,2,210000,30000,240000
6,15,16,11,2,291000,220000,511000
8,10,19,-1,2,246000,15000,261000
8,6,20,-1,2,228000,15000,243000
12,14,6,-1,2,258000,30000,288000
7,12,17,-1,2,234000,30000,264000
19,11,17,-1,2,186000,30000,216000
16,18,20,-1,2,198000,75000,273000
14,8,9,13,2,285000,280000,565000
16,9,8,-1,2,294000,45000,339000
19,14,8,-1,2,201000,30000,231000
12,13,17,-1,2,252000,60000,312000
11,8,19,-1,2,228000,15000,243000
20,7,9,-1,2,237000,15000,252000
19,11,17,-1,2,213000,30000,243000
15,9,7,11,2,333000,315000,648000
11,18,14,-1,2,258000,45000,303000
19,18,8,-1,2,222000,30000,252000
8,17,11,-1,2,282000,30000,312000
17,9,15,-1,2,213000,30000,243000
8,9,18,-1,2,240000,30000,270000
16,14,9,-1,2,255000,45000,300000
13,14,18,12,2,225000,60000,285000
20,10,7,-1,2,246000,15000,261000
15,7,14,-1,2,261000,45000,306000
18,17,5,-1,2,213000,30000,243000
8,14,5,-1,2,291000,30000,321000
5,9,15,-1,2,234000,30000,264000
6,19,13,-1,2,198000,15000,213000
5,20,7,13,2,300000,180000,480000
20,6,10,-1,2,234000,15000,249000
16,17,6,-1,2,240000,30000,270000
7,6,18,-1,2,258000,30000,288000
17,12,7,-1,2,243000,30000,273000
13,5,19,-1,1,180000,0,180000
7,18,19,-1,2,231000,30000,261000
20,17,13,13,2,285000,190000,475000
11,16,5,-1,2,237000,30000,267000
13,17,18,-1,2,192000,75000,267000
11,17,11,-1,1,171000,0,171000
13,6,8,-1,2,267000,45000,312000
7,5,20,-1,2,192000,15000,207000
20,8,17,-1,2,219000,15000,234000
15,13,20,11,2,249000,45000,294000
11,19,17,-1,2,222000,30000,252000
7,6,9,-1,2,306000,105000,411000
7,10,9,-1,2,240000,90000,330000
9,7,19,-1,2,201000,15000,216000
15,11,9,-1,2,258000,45000,303000
16,14,6,-1,2,219000,15000,234000
5,11,13,11,2,243000,160000,403000
7,6,11,-1,2,270000,60000,330000
19,6,9,-1,2,210000,15000,225000
9,17,5,-1,2,234000,15000,249000
10,18,17,-1,2,216000,45000,261000
8,16,20,-1,2,225000,15000,240000
14,10,6,-1,2,282000,45000,327000
17,16,11,13,2,231000,195000,426000
12,9,20,-1,2,201000,15000,216000
17,6,18,-1,2,249000,30000,279000
16,13,15,-1,2,240000,90000,330000
12,11,10,-1,2,279000,90000,369000
6,5,10,-1,2,270000,60000,330000
12,5,20,-1,1,171000,0,171000
15,17,9,13,2,276000,250000,526000
12,5,20,-1,1,189000,0,189000
12,20,19,-1,2,201000,45000,246000
14,17,19,-1,2,183000,75000,258000
7,8,20,-1,2,198000,0,198000
9,18,14,-1,2,243000,30000,273000
19,13,7,-1,2,216000,15000,231000
19,10,6,13,2,294000,310000,604000
17,19,11,-1,2,183000,15000,198000
8,18,20,-1,2,219000,15000,234000
11,5,17,-1,2,252000,15000,267000
7,5,20,-1,2,219000,15000,234000
10,17,19,-1,2,222000,30000,252000
10,16,11,-1,2,279000,60000,339000
14,19,6,11,2,291000,175000,466000
8,16,5,-1,2,276000,30000,306000
5,20,7,-1,2,210000,15000,225000
15,8,5,-1,2,282000,30000,312000
11,16,18,-1,2,201000,45000,246000
13,6,17,-1,2,246000,30000,276000
5,13,10,-1,2,255000,45000,300000
20,16,12,11,2,192000,45000,237000
14,9,19,-1,2,252000,30000,282000
5,17,20,-1,2,210000,15000,225000
15,16,18,-1,2,231000,105000,336000
8,18,7,-1,2,216000,0,216000
11,16,5,-1,2,237000,30000,267000
12,20,13,-1,2,213000,45000,258000
6,16,5,12,2,327000,170000,497000
15,14,6,-1,2,258000,30000,288000
8,9,6,-1,2,258000,90000,348000
15,18,17,-1,2,165000,90000,255000
16,14,9,-1,2,210000,15000,225000
5,10,19,-1,2,216000,15000,231000
14,6,12,-1,2,249000,30000,279000
6,18,15,11,2,282000,190000,472000
18,17,12,-1,2,246000,75000,321000
5,19,9,-1,2,243000,15000,258000
8,18,9,-1,2,231000,30000,261000
11,8,19,-1,2,228000,15000,243000
12,13,9,-1,2,276000,90000,366000
7,18,8,-1,2,231000,30000,261000
13,15,16,12,2,222000,90000,312000
7,15,13,-1,2,258000,30000,288000
7,8,13,-1,2,270000,60000,330000
14,20,16,-1,2,186000,45000,231000
6,10,20,-1,2,243000,15000,258000
16,8,17,-1,2,240000,30000,270000
15,17,18,-1,2,201000,90000,291000
19,20,14,11,2,165000,30000,195000
7,12,6,-1,2,243000,15000,258000
15,10,7,-1,2,249000,45000,294000
10,9,15,-1,2,243000,60000,303000
19,15,12,-1,2,213000,45000,258000
16,12,19,-1,2,237000,45000,282000
11,19,14,-1,2,258000,45000,303000
8,19,15,13,2,267000,250000,517000
5,7,19,-1,2,219000,15000,234000
18,14,6,-1,2,225000,15000,240000
10,15,9,-1,2,270000,60000,330000
15,17,12,-1,2,213000,75000,288000
15,14,11,-1,2,258000,90000,348000
19,5,11,-1,1,207000,0,207000
18,11,8,12,2,306000,315000,621000
12,18,14,-1,2,192000,30000,222000
5,20,6,-1,2,240000,30000,270000
12,18,17,-1,2,228000,75000,303000
6,9,10,-1,2,294000,90000,384000
7,5,18,-1,2,210000,15000,225000
6,7,8,-1,2,270000,90000,360000
17,15,16,13,2,177000,90000,267000
12,7,5,-1,2,228000,30000,258000
17,12,9,-1,2,231000,45000,276000
5,9,17,-1,2,225000,15000,240000
7,15,8,-1,2,267000,45000,312000
18,19,6,-1,2,186000,30000,216000
14,8,15,-1,2,270000,45000,315000
13,19,9,11,2,300000,190000,490000
17,19,9,-1,2,237000,15000,252000
19,11,5,-1,1,216000,0,216000
5,14,6,-1,2,294000,45000,339000
6,14,12,-1,2,222000,30000,252000
7,18,5,-1,2,219000,15000,234000
12,10,6,-1,2,255000,45000,300000
5,20,19,13,2,219000,230000,449000
16,16,17,-1,2,159000,30000,189000
12,6,14,-1,2,258000,30000,288000
16,7,20,-1,2,189000,15000,204000
6,13,5,-1,2,294000,45000,339000
11,14,8,-1,2,240000,45000,285000
18,11,9,-1,2,228000,30000,258000
19,5,7,11,2,303000,205000,508000
13,7,17,-1,2,237000,30000,267000
19,8,11,-1,2,219000,15000,234000
16,6,20,-1,2,225000,15000,240000
7,5,8,-1,2,285000,90000,375000
11,20,14,-1,2,201000,30000,231000
5,14,18,-1,2,243000,15000,258000
14,9,10,13,2,285000,370000,655000
17,18,8,-1,2,195000,30000,225000
10,15,9,-1,2,288000,60000,348000
15,7,18,-1,2,210000,15000,225000
9,7,11,-1,2,276000,75000,351000
7,15,20,-1,2,189000,15000,204000
5,6,17,-1,2,267000,30000,297000
17,18,10,11,2,270000,245000,515000
16,13,7,-1,2,210000,15000,225000
5,20,8,-1,2,219000,15000,234000
17,15,18,-1,2,201000,90000,291000
8,5,7,-1,2,243000,45000,288000
5,11,10,-1,2,237000,75000,312000
16,11,14,-1,2,213000,75000,288000
7,18,14,13,2,267000,265000,532000
17,7,19,-1,2,201000,15000,216000
20,16,15,-1,2,222000,60000,282000
20,9,13,-1,1,171000,0,171000
20,17,8,-1,2,228000,15000,243000
15,5,10,-1,2,288000,30000,318000
10,8,12,-1,2,240000,75000,315000
20,6,7,11,2,273000,190000,463000
14,17,11,-1,2,258000,45000,303000
16,8,7,-1,2,285000,45000,330000
11,9,7,-1,2,240000,75000,315000
5,17,8,-1,2,219000,15000,234000
8,10,13,-1,2,258000,45000,303000
18,11,19,-1,2,177000,45000,222000
18,11,7,13,2,264000,155000,419000
20,7,9,-1,2,237000,15000,252000
15,19,14,-1,2,234000,60000,294000
17,8,13,-1,2,270000,30000,300000
19,9,7,-1,2,219000,15000,234000
12,5,13,-1,2,270000,45000,315000
6,16,12,-1,2,210000,30000,240000
7,18,15,11,2,291000,190000,481000
7,10,14,-1,2,303000,45000,348000
5,14,13,-1,2,231000,30000,261000
20,15,5,-1,2,198000,15000,213000
8,16,19,-1,2,228000,15000,243000
11,5,5,-1,1,189000,0,189000
20,15,6,-1,2,189000,15000,204000
8,15,9,13,2,303000,265000,568000
19,5,7,-1,2,258000,30000,288000
11,17,19,-1,2,204000,30000,234000
12,11,20,-1,2,267000,45000,312000
6,13,17,-1,2,246000,30000,276000
16,11,5,-1,2,237000,30000,267000
9,10,16,-1,2,252000,60000,312000
6,11,5,13,2,303000,295000,598000
20,6,10,-1,2,216000,15000,231000
5,13,11,-1,2,267000,30000,297000
17,13,19,-1,2,183000,45000,228000
5,11,8,-1,2,306000,90000,396000
5,7,15,-1,2,219000,15000,234000
18,20,8,-1,2,183000,15000,198000
18,5,12,13,2,294000,315000,609000
7,15,8,-1,2,267000,45000,312000
12,19,9,-1,2,219000,30000,249000
14,5,6,-1,2,276000,45000,321000
7,16,20,-1,2,180000,15000,195000
20,17,10,-1,2,219000,30000,249000
12,13,20,-1,2,171000,0,171000
20,19,9,13,2,273000,230000,503000
6,14,10,-1,2,264000,45000,309000
13,16,15,-1,2,195000,90000,285000
5,15,12,-1,2,276000,30000,306000
17,10,13,-1,2,231000,45000,276000
20,8,11,-1,2,219000,15000,234000
5,18,7,-1,2,255000,15000,270000
14,9,15,11,2,291000,195000,486000
14,9,19,-1,2,261000,30000,291000
16,10,5,-1,2,234000,15000,249000
15,20,7,-1,2,207000,15000,222000
19,5,8,-1,2,246000,15000,261000
15,6,9,-1,2,273000,30000,303000
16,15,8,-1,2,216000,45000,261000
15,8,10,12,2,297000,330000,627000
20,17,16,-1,2,210000,90000,300000
7,11,20,-1,2,207000,15000,222000
16,18,6,-1,2,228000,15000,243000
18,19,8,-1,2,222000,30000,252000
12,19,18,-1,2,222000,45000,267000
15,12,9,-1,2,231000,30000,261000
10,13,6,12,2,279000,345000,624000
7,15,14,-1,2,279000,45000,324000
14,7,11,-1,2,255000,45000,300000
19,5,13,-1,1,171000,0,171000
19,13,18,-1,2,216000,75000,291000
14,8,17,-1,2,201000,15000,216000
10,5,12,-1,2,264000,45000,309000
8,13,18,12,2,252000,265000,517000
16,20,12,-1,2,180000,15000,195000
15,11,17,-1,2,246000,45000,291000
17,14,7,-1,2,249000,30000,279000
10,9,13,-1,2,270000,90000,360000
19,10,11,-1,2,231000,45000,276000
14,8,5,-1,2,273000,30000,303000
16,19,12,13,2,231000,235000,466000
10,16,20,-1,2,192000,30000,222000
8,12,6,-1,2,294000,45000,339000
18,16,7,-1,2,192000,15000,207000
12,5,15,-1,2,267000,30000,297000
19,13,9,-1,2,216000,30000,246000
5,19,10,-1,2,225000,15000,240000
19,13,9,11,2,300000,190000,490000
18,19,15,-1,2,207000,90000,297000
10,13,6,-1,2,255000,45000,300000
5,20,13,-1,1,171000,0,171000
18,13,7,-1,2,246000,30000,276000
20,16,5,-1,2,207000,15000,222000
5,11,14,-1,2,276000,30000,306000
15,5,12,12,2,225000,145000,370000
20,6,15,-1,2,216000,15000,231000
17,19,18,-1,2,171000,75000,246000
8,7,19,-1,2,249000,30000,279000
15,6,18,-1,2,228000,15000,243000
20,17,15,-1,2,201000,45000,246000
20,17,16,-1,2,192000,30000,222000
10,6,7,11,2,351000,295000,646000
10,7,17,-1,2,273000,30000,303000
13,16,6,-1,2,231000,30000,261000
8,11,5,-1,2,267000,45000,312000
15,16,12,-1,2,204000,90000,294000
5,16,7,-1,2,264000,15000,279000
8,7,11,-1,2,261000,90000,351000
9,17,19,11,2,261000,215000,476000
5,10,8,-1,2,222000,30000,252000
19,7,12,-1,2,189000,15000,204000
5,14,20,-1,1,198000,0,198000
11,18,8,-1,2,282000,30000,312000
9,15,6,-1,2,264000,30000,294000
11,10,9,-1,2,243000,90000,333000
10,12,7,13,2,279000,295000,574000
5,11,14,-1,2,291000,45000,336000
13,17,7,-1,2,201000,30000,231000
8,18,19,-1,2,213000,30000,243000
7,17,12,-1,2,279000,30000,309000
14,18,11,-1,2,222000,45000,267000
11,9,15,-1,2,267000,45000,312000
5,13,19,13,2,216000,155000,371000
7,6,13,-1,2,288000,60000,348000
19,12,17,-1,2,192000,45000,237000
11,5,14,-1,2,276000,30000,306000
5,15,13,-1,2,228000,15000,243000
14,9,13,-1,2,228000,75000,303000
8,19,18,-1,2,204000,30000,234000
7,11,5,12,2,339000,285000,624000
8,20,13,-1,2,216000,15000,231000
18,10,6,-1,2,243000,15000,258000
20,19,14,-1,2,177000,75000,252000
6,7,17,-1,2,231000,30000,261000
13,5,15,-1,2,237000,15000,252000
6,17,16,-1,2,213000,30000,243000
11,20,16,12,2,288000,160000,448000
19,7,6,-1,2,207000,0,207000
13,17,11,-1,2,240000,45000,285000
18,15,20,-1,2,180000,75000,255000
8,12,9,-1,2,270000,90000,360000
7,6,18,-1,2,222000,30000,252000
14,16,9,-1,2,237000,45000,282000
20,19,13,11,2,165000,45000,210000
11,10,19,-1,2,240000,45000,285000
18,12,19,-1,2,195000,45000,240000
9,9,8,-1,2,162000,0,162000
7,11,10,-1,2,249000,90000,339000
10,12,17,-1,2,222000,45000,267000
13,17,12,-1,2,234000,60000,294000
18,5,6,11,2,330000,205000,535000
16,14,12,-1,2,231000,75000,306000
16,15,13,-1,2,231000,90000,321000
10,11,7,-1,2,294000,90000,384000
9,6,15,-1,2,246000,30000,276000
11,15,13,-1,2,213000,75000,288000
8,9,20,-1,2,231000,30000,261000
6,19,10,11,2,318000,270000,588000
5,19,16,-1,2,246000,15000,261000
17,14,9,-1,2,264000,45000,309000
16,19,11,-1,2,219000,45000,264000
15,14,17,-1,2,234000,105000,339000
18,11,6,-1,2,252000,15000,267000
6,8,6,-1,2,183000,15000,198000
16,18,6,13,2,231000,235000,466000
10,15,8,-1,2,258000,45000,303000
7,8,5,-1,2,240000,90000,330000
9,16,13,-1,2,219000,45000,264000
10,18,17,-1,2,216000,45000,261000
12,13,11,-1,2,270000,90000,360000
19,15,11,-1,2,228000,45000,273000
10,18,14,13,2,267000,265000,532000
20,17,16,-1,2,174000,90000,264000
16,18,20,-1,2,162000,75000,237000
8,11,15,-1,2,258000,45000,303000
11,18,15,-1,2,210000,45000,255000
16,15,13,-1,2,231000,90000,321000
18,15,11,-1,2,246000,45000,291000
16,12,11,13,2,276000,345000,621000
9,8,11,-1,2,270000,105000,375000
6,14,13,-1,2,234000,45000,279000
12,16,14,-1,2,213000,75000,288000
20,6,8,-1,2,228000,15000,243000
5,9,18,-1,2,243000,15000,258000
15,18,10,-1,2,228000,45000,273000
17,7,18,12,2,279000,245000,524000
16,5,12,-1,2,216000,15000,231000
13,20,5,-1,1,180000,0,180000
17,13,5,-1,2,252000,15000,267000
16,7,8,-1,2,267000,45000,312000
7,9,7,-1,2,156000,15000,171000
13,14,12,-1,2,216000,90000,306000
19,20,14,11,2,186000,75000,261000
16,5,20,-1,2,189000,15000,204000
19,8,20,-1,2,210000,30000,240000
11,7,17,-1,1,189000,0,189000
18,19,11,-1,2,204000,45000,249000
7,16,17,-1,2,195000,30000,225000
15,10,14,-1,2,246000,75000,321000
13,19,6,11,2,300000,190000,490000
16,19,8,-1,2,246000,15000,261000
8,15,9,-1,2,297000,60000,357000
8,15,13,-1,2,228000,45000,273000
20,17,7,-1,2,192000,15000,207000
11,7,17,-1,2,279000,30000,309000
10,18,12,-1,2,219000,30000,249000
12,9,6,13,2,306000,295000,601000
10,5,15,-1,2,288000,30000,318000
5,6,19,-1,2,213000,30000,243000
17,13,15,-1,2,222000,75000,297000
8,16,11,-1,2,285000,45000,330000
6,7,18,-1,2,231000,30000,261000
10,8,5,-1,2,267000,75000,342000
18,9,13,12,2,252000,265000,517000
17,15,9,-1,2,201000,15000,216000
11,20,8,-1,2,219000,15000,234000
14,7,19,-1,2,234000,15000,249000
14,16,17,-1,2,222000,90000,312000
17,5,12,-1,2,264000,30000,294000
18,5,9,-1,2,225000,15000,240000
10,6,15,13,2,276000,370000,646000
16,8,6,-1,1,198000,0,198000
20,16,13,-1,2,213000,45000,258000
10,16,5,-1,2,288000,30000,318000
12,15,11,-1,2,225000,90000,315000
9,16,8,-1,2,267000,45000,312000
5,18,9,-1,2,216000,15000,231000
8,17,10,12,2,288000,300000,588000
18,7,20,-1,2,228000,15000,243000
17,12,20,-1,2,246000,45000,291000
19,10,9,-1,2,240000,30000,270000
12,15,10,-1,2,267000,45000,312000
9,8,13,-1,2,270000,60000,330000
16,14,19,-1,2,186000,45000,231000
19,18,11,13,2,285000,245000,530000
14,7,8,-1,2,270000,60000,330000
19,13,9,-1,2,207000,30000,237000
5,6,14,-1,2,276000,45000,321000
14,19,12,-1,2,204000,45000,249000
8,20,16,-1,2,216000,15000,231000
20,11,12,-1,2,258000,45000,303000
16,9,19,11,2,309000,185000,494000
15,13,7,-1,2,267000,30000,297000
8,19,20,-1,2,183000,30000,213000
6,7,11,-1,2,246000,30000,276000
12,8,16,-1,2,228000,45000,273000
14,19,20,-1,2,159000,75000,234000
12,18,15,-1,2,213000,45000,258000
17,13,7,12,2,297000,265000,562000
19,14,16,-1,2,186000,30000,216000
5,14,6,-1,2,306000,60000,366000
19,19,6,-1,1,117000,0,117000
9,14,8,-1,2,279000,60000,339000
17,7,18,-1,2,195000,30000,225000
20,13,11,-1,2,246000,30000,276000
12,11,8,12,2,261000,240000,501000
17,8,10,-1,2,255000,30000,285000
10,6,15,-1,2,243000,30000,273000
17,14,5,-1,2,210000,15000,225000
6,10,15,-1,2,261000,30000,291000
14,20,17,-1,2,174000,45000,219000
19,13,16,-1,2,195000,30000,225000
6,20,5,12,2,315000,165000,480000
13,18,8,-1,2,261000,30000,291000
11,9,8,-1,2,270000,105000,375000
6,10,20,-1,2,189000,15000,204000
20,11,8,-1,2,228000,15000,243000
10,16,14,-1,2,255000,45000,300000
5,15,11,-1,2,246000,30000,276000
20,15,16,11,2,186000,60000,246000
5,20,18,-1,2,174000,15000,189000
11,13,19,-1,2,255000,30000,285000
17,13,10,-1,2,258000,45000,303000
19,17,18,-1,2,162000,75000,237000
9,19,19,-1,1,153000,0,153000
6,10,14,-1,2,264000,45000,309000
17,10,5,12,2,270000,300000,570000
14,8,7,-1,2,306000,60000,366000
16,12,6,-1,2,210000,30000,240000
8,5,10,-1,2,267000,75000,342000
11,8,14,-1,2,240000,45000,285000
13,16,12,-1,2,225000,90000,315000
20,11,14,-1,2,237000,30000,267000
5,9,20,11,2,324000,270000,594000
17,6,12,-1,2,255000,30000,285000
10,7,20,-1,2,219000,15000,234000
17,8,19,-1,2,219000,15000,234000
12,16,20,-1,2,237000,45000,282000
8,6,15,-1,2,282000,30000,312000
6,11,10,-1,2,237000,75000,312000
13,9,14,11,2,273000,225000,498000
14,11,19,-1,2,267000,45000,312000
6,5,10,-1,2,288000,60000,348000
8,19,10,-1,2,192000,15000,207000
14,7,12,-1,2,273000,45000,318000
10,11,15,-1,2,234000,60000,294000
6,17,13,-1,2,228000,30000,258000
8,18,10,11,2,300000,300000,600000
12,5,14,-1,2,276000,30000,306000
16,19,10,-1,2,195000,30000,225000
19,8,10,-1,2,246000,15000,261000
6,20,18,-1,2,210000,15000,225000
12,13,20,-1,2,258000,45000,303000
6,11,18,-1,2,243000,15000,258000
20,7,6,12,2,300000,190000,490000
16,14,17,-1,2,231000,90000,321000
10,7,18,-1,2,255000,15000,270000
17,20,11,-1,2,201000,30000,231000
20,10,6,-1,1,180000,0,180000
10,12,11,-1,2,270000,90000,360000
9,10,19,-1,2,213000,30000,243000
18,19,20,13,2,159000,60000,219000
5,18,8,-1,2,276000,30000,306000
11,19,5,-1,1,189000,0,189000
9,10,19,-1,2,240000,30000,270000
10,16,5,-1,2,252000,15000,267000
8,19,9,-1,2,222000,30000,252000
20,10,17,-1,2,210000,30000,240000
20,19,5,13,2,246000,185000,431000
11,18,10,-1,2,189000,0,189000
5,16,13,-1,2,255000,15000,270000
9,6,20,-1,2,219000,15000,234000
20,16,9,-1,2,219000,30000,249000
15,8,17,-1,2,249000,30000,279000
18,20,17,-1,2,162000,90000,252000
13,8,12,11,2,309000,255000,564000
14,9,20,-1,2,225000,15000,240000
6,5,7,-1,2,309000,120000,429000
9,6,20,-1,2,201000,15000,216000
18,16,13,-1,2,231000,75000,306000
12,19,8,-1,2,234000,15000,249000
10,20,13,-1,2,255000,30000,285000
8,17,14,13,2,267000,265000,532000
5,17,19,-1,2,201000,15000,216000
12,10,20,-1,2,219000,15000,234000
19,13,5,-1,2,252000,15000,267000
8,6,14,-1,2,264000,30000,294000
19,16,5,-1,2,192000,15000,207000
17,9,14,-1,2,264000,45000,309000
15,5,12,13,2,258000,360000,618000
12,14,17,-1,2,222000,45000,267000
19,12,15,-1,2,240000,45000,285000
13,7,17,-1,2,246000,30000,276000
15,19,12,-1,2,231000,45000,276000
16,18,17,-1,2,201000,90000,291000
15,19,5,-1,2,207000,15000,222000
18,11,9,13,2,285000,300000,585000
7,9,11,-1,2,231000,30000,261000
5,12,19,-1,1,171000,0,171000
9,18,12,-1,2,264000,30000,294000
5,6,17,-1,2,258000,30000,288000
12,6,13,-1,2,243000,45000,288000
13,16,18,-1,2,204000,75000,279000
6,8,7,11,2,363000,300000,663000
11,6,5,-1,2,279000,60000,339000
20,11,5,-1,1,171000,0,171000
12,14,13,-1,2,261000,90000,351000
13,8,9,-1,2,288000,60000,348000
7,16,17,-1,2,204000,30000,234000
9,8,16,-1,2,276000,45000,321000
11,9,13,11,2,234000,160000,394000
11,19,6,-1,2,216000,15000,231000
5,8,9,-1,2,276000,90000,366000
16,7,17,-1,2,204000,30000,234000
19,10,13,-1,2,246000,30000,276000
14,10,9,-1,2,279000,60000,339000
13,18,15,-1,2,204000,45000,249000
8,13,18,11,2,318000,220000,538000
12,15,14,-1,2,258000,90000,348000
8,6,10,-1,2,276000,75000,351000
9,14,10,-1,2,243000,60000,303000
11,9,7,-1,2,249000,75000,324000
14,20,17,-1,2,174000,45000,219000
18,17,6,-1,2,195000,30000,225000
18,5,9,11,2,324000,285000,609000
6,10,8,-1,2,285000,75000,360000
14,14,13,-1,2,159000,30000,189000
19,10,18,-1,2,195000,30000,225000
13,6,14,-1,2,288000,45000,333000
11,17,18,-1,2,198000,45000,243000
5,20,12,-1,1,216000,0,216000
10,19,16,11,2,327000,185000,512000
18,19,15,-1,2,207000,90000,297000
15,6,19,-1,2,207000,15000,222000
5,12,13,-1,2,279000,45000,324000
10,12,19,-1,2,210000,30000,240000
17,19,10,-1,2,213000,30000,243000
8,6,14,-1,2,282000,30000,312000
13,20,7,12,2,252000,205000,457000
16,11,6,-1,2,225000,15000,240000
8,7,12,-1,2,252000,60000,312000
16,8,9,-1,2,240000,45000,285000
20,19,13,-1,2,156000,45000,201000
11,10,14,-1,2,252000,90000,342000
17,5,7,-1,2,237000,15000,252000
20,10,11,11,2,186000,125000,311000
15,13,8,-1,2,282000,45000,327000
8,18,10,-1,2,201000,15000,216000
13,20,15,-1,2,231000,45000,276000
9,7,13,-1,2,285000,45000,330000
17,9,12,-1,2,231000,45000,276000
15,20,7,-1,2,207000,15000,222000
15,18,16,13,2,213000,105000,318000
20,14,18,-1,2,174000,15000,189000
9,8,5,-1,2,306000,120000,426000
11,11,6,-1,2,153000,15000,168000
17,20,14,-1,2,174000,45000,219000
16,7,10,-1,2,225000,15000,240000
5,12,14,-1,2,231000,30000,261000
15,10,19,12,2,252000,205000,457000
17,7,14,-1,2,210000,15000,225000
15,5,9,-1,2,261000,30000,291000
12,7,6,-1,2,252000,60000,312000
16,14,9,-1,2,219000,45000,264000
12,13,16,-1,2,234000,90000,324000
17,14,6,-1,2,246000,15000,261000
15,13,7,12,2,279000,280000,559000
16,14,5,-1,2,210000,15000,225000
16,12,9,-1,2,249000,45000,294000
20,9,15,-1,2,201000,30000,231000
19,16,18,-1,2,189000,90000,279000
20,15,8,-1,2,198000,15000,213000
11,5,7,-1,2,285000,45000,330000
11,6,14,12,2,261000,360000,621000
18,19,9,-1,2,186000,30000,216000
18,17,14,-1,2,228000,90000,318000
8,12,13,-1,2,240000,30000,270000
6,5,11,-1,2,252000,60000,312000
11,20,17,-1,2,165000,30000,195000
11,5,15,-1,2,225000,15000,240000
18,19,11,13,2,231000,245000,476000
10,6,12,-1,2,255000,45000,300000
15,7,16,-1,2,213000,30000,243000
13,19,11,-1,2,228000,30000,258000
11,20,17,-1,2,201000,30000,231000
11,16,20,-1,2,180000,15000,195000
8,13,12,-1,2,273000,75000,348000
16,17,14,13,2,195000,90000,285000
13,7,16,-1,2,267000,30000,297000
8,13,20,-1,2,207000,15000,222000
9,7,8,-1,2,297000,90000,387000
6,5,10,-1,2,252000,60000,312000
11,17,16,-1,2,201000,75000,276000
10,12,5,-1,2,273000,45000,318000
15,12,7,12,2,216000,145000,361000
7,13,6,-1,2,279000,60000,339000
19,10,16,-1,2,186000,30000,216000
7,15,20,-1,2,243000,15000,258000
17,18,15,-1,2,201000,90000,291000
7,14,13,-1,2,231000,30000,261000
18,19,17,-1,2,144000,75000,219000
13,14,18,12,2,243000,60000,303000
5,20,13,-1,1,216000,0,216000
14,17,19,-1,2,219000,75000,294000
12,9,8,-1,2,246000,30000,276000
18,15,12,-1,2,204000,45000,249000
9,16,20,-1,2,228000,30000,258000
16,17,9,-1,2,252000,45000,297000
9,12,20,13,2,276000,300000,576000
14,10,20,-1,2,216000,30000,246000
19,10,17,-1,2,222000,30000,252000
8,17,9,-1,2,285000,45000,330000
17,5,12,-1,2,216000,15000,231000
14,15,5,-1,2,240000,30000,270000
9,19,20,-1,2,183000,30000,213000
10,13,15,11,2,285000,205000,490000
14,8,11,-1,2,276000,45000,321000
20,18,15,-1,2,162000,75000,237000
5,17,10,-1,2,225000,15000,240000
18,16,12,-1,2,210000,45000,255000
13,9,6,-1,2,294000,45000,339000
13,17,16,-1,2,195000,90000,285000
13,5,7,11,2,339000,265000,604000
19,9,11,-1,2,219000,15000,234000
5,17,13,-1,2,252000,15000,267000
14,6,19,-1,2,216000,15000,231000
8,18,15,-1,2,231000,30000,261000
11,20,12,-1,2,249000,45000,294000
19,7,5,-1,2,237000,15000,252000
18,15,5,12,2,279000,235000,514000
11,14,19,-1,2,189000,15000,204000
19,15,16,-1,2,213000,90000,303000
18,11,19,-1,2,186000,30000,216000
18,15,6,-1,2,255000,15000,270000
18,15,9,-1,2,231000,30000,261000
19,6,13,-1,2,243000,15000,258000
6,8,11,12,2,315000,295000,610000
17,19,14,-1,2,219000,75000,294000
10,16,20,-1,2,180000,15000,195000
19,15,13,-1,2,240000,45000,285000
6,17,9,-1,2,255000,15000,270000
14,16,11,-1,2,240000,75000,315000
20,15,18,-1,2,189000,75000,264000
5,20,19,13,2,237000,230000,467000
6,16,7,-1,2,249000,30000,279000
10,13,5,-1,2,255000,45000,300000
5,14,16,-1,2,210000,15000,225000
18,17,19,-1,2,153000,75000,228000
12,19,10,-1,2,246000,30000,276000
5,11,8,-1,2,276000,45000,321000
9,13,20,12,2,252000,205000,457000
7,19,16,-1,2,192000,15000,207000
9,18,17,-1,2,240000,30000,270000
18,8,6,-1,2,255000,15000,270000
13,12,6,-1,2,252000,45000,297000
5,16,9,-1,2,216000,15000,231000
8,18,7,-1,2,231000,30000,261000
11,9,12,13,2,288000,400000,688000
6,20,13,-1,1,171000,0,171000
18,15,19,-1,2,198000,90000,288000
7,12,20,-1,2,207000,15000,222000
8,6,12,-1,2,276000,45000,321000
10,13,16,-1,2,222000,45000,267000
7,16,9,-1,2,264000,30000,294000
16,14,12,13,2,231000,280000,511000
7,5,11,-1,2,258000,45000,303000
9,14,7,-1,2,240000,45000,285000
20,9,14,-1,2,171000,15000,186000
6,13,18,-1,2,252000,15000,267000
12,10,13,-1,2,249000,90000,339000
9,18,17,-1,2,213000,30000,243000
13,8,17,12,2,297000,265000,562000
15,12,7,-1,2,228000,15000,243000
19,15,9,-1,2,192000,30000,222000
11,14,7,-1,2,282000,45000,327000
8,12,13,-1,2,228000,75000,303000
13,9,8,-1,2,261000,60000,321000
16,12,17,-1,2,192000,75000,267000
11,8,14,13,2,294000,345000,639000
14,9,8,-1,2,243000,15000,258000
5,16,14,-1,2,210000,15000,225000
15,14,19,-1,2,216000,60000,276000
12,9,14,-1,2,285000,75000,360000
8,6,12,-1,2,258000,45000,303000
18,7,11,-1,2,189000,15000,204000
15,12,16,12,2,288000,195000,483000
20,13,17,-1,2,183000,15000,198000
15,9,17,-1,2,249000,30000,279000
10,13,6,-1,2,273000,45000,318000
14,15,10,-1,2,210000,75000,285000
5,10,10,-1,2,180000,15000,195000
16,9,17,-1,2,207000,45000,252000
19,6,17,13,2,267000,220000,487000
13,16,12,-1,2,234000,90000,324000
8,7,20,-1,2,240000,30000,270000
19,12,6,-1,2,234000,15000,249000
18,9,11,-1,2,246000,30000,276000
10,16,6,-1,2,252000,30000,282000
10,14,13,-1,2,222000,90000,312000
11,18,8,13,2,276000,300000,576000
18,20,10,-1,2,174000,15000,189000
7,17,20,-1,2,237000,15000,252000
7,20,14,-1,2,243000,15000,258000
14,9,19,-1,2,243000,30000,273000
13,17,9,-1,2,246000,45000,291000
7,11,5,-1,2,258000,45000,303000
20,11,9,12,2,261000,270000,531000
13,6,12,-1,2,240000,30000,270000
10,12,19,-1,2,210000,30000,240000
8,14,12,-1,2,255000,45000,300000
19,18,12,-1,2,177000,45000,222000
17,15,5,-1,2,201000,15000,216000
14,17,7,-1,2,240000,30000,270000
20,10,11,12,2,288000,270000,558000
11,7,20,-1,1,180000,0,180000
5,7,20,-1,2,228000,15000,243000
20,11,18,-1,2,201000,30000,231000
19,18,9,-1,2,177000,30000,207000
11,18,20,-1,2,219000,30000,249000
12,6,13,-1,2,231000,30000,261000
19,5,8,11,2,288000,295000,583000
16,20,7,-1,2,225000,15000,240000
9,14,6,-1,2,294000,45000,339000
18,16,12,-1,2,192000,45000,237000
18,14,7,-1,2,246000,30000,276000
12,17,19,-1,2,219000,45000,264000
20,19,11,-1,2,210000,30000,240000
8,10,15,13,2,282000,200000,482000
13,10,5,-1,2,273000,45000,318000
12,5,18,-1,2,207000,15000,222000
18,13,14,-1,2,225000,60000,285000
19,7,10,-1,2,246000,15000,261000
10,6,9,-1,2,285000,90000,375000
9,5,20,-1,2,189000,15000,204000
18,7,15,12,2,288000,235000,523000
15,7,13,-1,2,219000,15000,234000
8,20,14,-1,2,189000,15000,204000
11,16,13,-1,2,258000,45000,303000
6,16,13,-1,2,249000,30000,279000
8,10,15,-1,2,258000,45000,303000
11,6,7,-1,2,252000,60000,312000
9,12,5,13,2,279000,295000,574000
11,15,6,-1,2,288000,30000,318000
10,17,15,-1,2,210000,45000,255000
5,12,19,-1,1,198000,0,198000
10,8,14,-1,2,285000,45000,330000
15,8,19,-1,2,192000,30000,222000
15,12,16,-1,2,240000,90000,330000
17,14,10,12,2,297000,250000,547000
16,12,7,-1,2,216000,15000,231000
8,9,5,-1,2,258000,90000,348000
6,11,9,-1,2,249000,75000,324000
9,17,20,-1,2,183000,15000,198000
8,10,11,-1,2,294000,90000,384000
7,13,12,-1,2,237000,75000,312000
14,18,8,13,2,231000,265000,496000
11,6,20,-1,2,207000,15000,222000
16,9,10,-1,2,279000,60000,339000
16,19,9,-1,2,204000,30000,234000
10,6,7,-1,2,297000,90000,387000
6,11,9,-1,2,249000,75000,324000
14,11,10,-1,2,234000,90000,324000
5,9,12,11,2,297000,345000,642000
6,20,12,-1,1,207000,0,207000
16,5,8,-1,2,276000,30000,306000
6,18,20,-1,2,192000,15000,207000
15,6,10,-1,2,288000,30000,318000
13,6,9,-1,2,249000,45000,294000
6,7,8,-1,2,252000,90000,342000
11,17,5,11,2,225000,155000,380000
17,5,14,-1,2,228000,15000,243000
7,12,5,-1,2,267000,45000,312000
7,15,12,-1,2,237000,45000,282000
12,20,5,-1,1,171000,0,171000
10,11,13,-1,2,279000,105000,384000
13,9,11,-1,2,249000,75000,324000
11,14,20,11,2,282000,175000,457000
7,5,14,-1,2,294000,45000,339000
16,8,12,-1,2,228000,45000,273000
9,5,18,-1,2,216000,15000,231000
20,9,13,-1,2,189000,15000,204000
11,13,18,-1,2,267000,45000,312000
18,7,15,-1,2,228000,15000,243000
16,11,10,13,2,285000,330000,615000
15,8,14,-1,2,222000,30000,252000
11,19,10,-1,2,240000,45000,285000
20,8,9,-1,2,231000,30000,261000
17,5,14,-1,2,246000,15000,261000
7,12,14,-1,2,264000,45000,309000
7,14,8,-1,2,252000,60000,312000
18,17,16,13,2,156000,90000,246000
7,5,9,-1,2,258000,75000,333000
18,7,15,-1,2,201000,15000,216000
7,19,11,-1,2,225000,15000,240000
14,5,19,-1,2,234000,15000,249000
6,13,11,-1,2,264000,45000,309000
7,13,20,-1,2,189000,15000,204000
15,13,16,11,2,231000,90000,321000
7,19,17,-1,2,228000,15000,243000
18,11,6,-1,2,243000,15000,258000
10,11,18,-1,2,249000,45000,294000
14,8,5,-1,2,273000,30000,303000
13,15,19,-1,2,195000,45000,240000
6,14,16,-1,2,255000,15000,270000
17,9,10,11,2,300000,315000,615000
6,20,7,-1,2,258000,30000,288000
7,18,5,-1,2,246000,15000,261000
10,11,8,-1,2,258000,90000,348000
15,17,12,-1,2,204000,75000,279000
16,5,10,-1,2,252000,15000,267000
5,12,14,-1,2,249000,30000,279000
19,16,9,13,2,231000,235000,466000
12,17,7,-1,2,243000,30000,273000
8,20,16,-1,2,189000,15000,204000
7,15,13,-1,2,258000,30000,288000
13,8,19,-1,2,198000,15000,213000
10,16,12,-1,2,267000,45000,312000
12,19,10,-1,2,228000,30000,258000
9,16,13,11,2,300000,250000,550000
18,5,14,-1,2,252000,15000,267000
10,8,6,-1,2,267000,75000,342000
5,13,19,-1,1,171000,0,171000
7,17,9,-1,2,246000,15000,261000
17,14,20,-1,2,201000,45000,246000
12,20,16,-1,2,180000,15000,195000
17,16,11,12,2,297000,220000,517000
12,13,19,-1,2,216000,15000,231000
7,15,16,-1,2,240000,30000,270000
20,19,12,-1,2,183000,45000,228000
19,15,15,-1,2,126000,15000,141000
15,9,11,-1,2,267000,45000,312000
6,18,13,-1,2,207000,15000,222000
15,12,19,13,2,258000,250000,508000
5,10,15,-1,2,252000,30000,282000
16,9,15,-1,2,207000,45000,252000
11,14,20,-1,2,237000,30000,267000
12,10,8,-1,2,285000,75000,360000
17,5,11,-1,2,207000,15000,222000
9,18,11,-1,2,237000,30000,267000
10,9,11,13,2,300000,310000,610000
13,10,11,-1,2,288000,105000,393000
9,13,6,-1,2,267000,45000,312000
13,11,12,-1,2,225000,90000,315000
10,14,15,-1,2,237000,75000,312000
13,17,11,-1,2,240000,45000,285000
14,8,6,-1,2,264000,30000,294000
18,7,8,13,2,276000,195000,471000
10,18,12,-1,2,255000,30000,285000
7,14,15,-1,2,252000,45000,297000
6,13,15,-1,2,240000,30000,270000
15,20,7,-1,2,198000,15000,213000
18,5,13,-1,2,243000,15000,258000
8,19,13,-1,2,198000,15000,213000
20,9,10,12,2,315000,270000,585000
6,14,12,-1,2,276000,30000,306000
7,11,19,-1,2,198000,15000,213000
16,17,14,-1,2,222000,90000,312000
9,18,17,-1,2,249000,30000,279000
10,11,8,-1,2,285000,90000,375000
14,9,6,-1,2,249000,45000,294000
5,13,9,12,2,279000,370000,649000
16,14,19,-1,2,240000,45000,285000
19,6,10,-1,2,252000,15000,267000
19,14,7,-1,2,216000,15000,231000
13,19,5,-1,1,207000,0,207000
18,6,19,-1,2,231000,30000,261000
18,11,17,-1,2,243000,45000,288000
10,11,10,13,2,336000,310000,646000
14,15,20,-1,2,252000,60000,312000
12,17,16,-1,2,246000,75000,321000
10,6,17,-1,2,243000,15000,258000
17,12,18,-1,2,219000,75000,294000
18,19,16,-1,2,189000,90000,279000
8,19,6,-1,2,219000,15000,234000
14,16,12,11,2,231000,75000,306000
12,20,17,-1,2,228000,45000,273000
15,14,13,-1,2,252000,90000,342000
14,5,6,-1,2,294000,45000,339000
16,6,9,-1,2,246000,30000,276000
18,14,5,-1,2,198000,15000,213000
17,19,7,-1,2,210000,15000,225000
14,9,8,12,2,324000,370000,694000
20,9,14,-1,2,225000,15000,240000
18,19,10,-1,2,240000,30000,270000
13,15,18,-1,2,249000,45000,294000
20,11,8,-1,2,237000,15000,252000
18,16,14,-1,2,231000,75000,306000
5,7,8,-1,2,297000,120000,417000
13,8,11,12,2,261000,360000,621000
12,10,18,-1,2,198000,15000,213000
8,16,11,-1,2,267000,45000,312000
11,9,8,-1,2,261000,105000,366000
15,18,20,-1,2,153000,75000,228000
6,19,18,-1,2,204000,30000,234000
13,10,9,-1,2,297000,90000,387000
14,18,9,13,2,240000,265000,505000
17,10,8,-1,2,246000,30000,276000
8,15,14,-1,2,225000,45000,270000
6,8,15,-1,2,264000,30000,294000
8,11,8,-1,2,165000,15000,180000
13,18,6,-1,2,198000,15000,213000
5,12,9,-1,2,264000,45000,309000
12,9,19,11,2,273000,205000,478000
18,11,10,-1,2,276000,45000,321000
11,18,15,-1,2,228000,45000,273000
6,8,19,-1,2,237000,15000,252000
13,5,16,-1,2,246000,15000,261000
5,13,20,-1,1,189000,0,189000
17,20,11,-1,2,210000,30000,240000
14,13,12,11,2,228000,45000,273000
18,7,8,-1,2,231000,30000,261000
20,10,18,-1,2,201000,15000,216000
12,14,13,-1,2,270000,90000,360000
6,10,8,-1,2,276000,75000,351000
9,11,8,-1,2,252000,105000,357000
17,16,13,-1,2,195000,90000,285000
7,20,18,13,2,285000,215000,500000
11,20,16,-1,2,207000,30000,237000
12,6,10,-1,2,282000,45000,327000
8,12,16,-1,2,228000,45000,273000
16,19,8,-1,2,201000,15000,216000
13,17,6,-1,2,255000,30000,285000
9,17,18,-1,2,213000,30000,243000
16,11,10,13,2,294000,330000,624000
18,13,8,-1,2,207000,15000,222000
11,20,6,-1,2,207000,15000,222000
7,14,15,-1,2,261000,45000,306000
8,6,17,-1,2,228000,15000,243000
15,14,9,-1,2,237000,75000,312000
10,13,8,-1,2,258000,45000,303000
18,17,14,12,2,174000,90000,264000
12,6,7,-1,2,243000,15000,258000
10,9,7,-1,2,240000,90000,330000
9,17,12,-1,2,231000,45000,276000
20,10,13,-1,2,228000,30000,258000
9,17,12,-1,2,267000,45000,312000
11,12,9,-1,2,249000,90000,339000
13,9,6,11,2,288000,345000,633000
11,6,20,-1,2,234000,15000,249000
6,13,15,-1,2,258000,30000,288000
20,10,9,-1,2,204000,30000,234000
16,14,20,-1,2,231000,45000,276000
11,8,17,-1,2,282000,30000,312000
19,11,7,-1,2,207000,15000,222000
12,14,7,13,2,276000,360000,636000
11,6,20,-1,2,207000,15000,222000
7,9,13,-1,2,276000,45000,321000
12,15,17,-1,2,204000,75000,279000
8,17,10,-1,2,273000,30000,303000
10,20,5,-1,2,198000,15000,213000
18,8,20,-1,2,210000,15000,225000
10,12,19,13,2,294000,315000,609000
12,11,5,-1,2,261000,45000,306000
10,16,14,-1,2,210000,45000,255000
7,20,15,-1,2,216000,15000,231000
7,15,19,-1,2,225000,15000,240000
7,5,8,-1,2,276000,90000,366000
10,6,16,-1,2,234000,30000,264000
8,11,17,13,2,249000,315000,564000
16,10,8,-1,2,216000,15000,231000
6,15,20,-1,2,198000,15000,213000
7,19,10,-1,2,237000,15000,252000
17,20,18,-1,2,171000,90000,261000
14,17,10,-1,2,246000,45000,291000
14,9,20,-1,2,198000,15000,213000
11,15,17,13,2,285000,250000,535000
14,13,18,-1,2,225000,60000,285000
9,12,10,-1,2,288000,105000,393000
18,7,11,-1,2,198000,15000,213000
9,20,8,-1,2,240000,30000,270000
5,18,17,-1,2,231000,30000,261000
7,15,18,-1,2,246000,15000,261000
7,18,6,13,2,309000,155000,464000
9,8,17,-1,2,285000,45000,330000
19,12,7,-1,2,198000,15000,213000
16,8,6,-1,2,246000,15000,261000
20,6,7,-1,2,222000,30000,252000
11,12,19,-1,2,249000,45000,294000
10,11,14,-1,2,270000,90000,360000
17,19,7,13,2,249000,220000,469000
13,18,5,-1,2,225000,15000,240000
12,7,13,-1,2,255000,75000,330000
20,10,6,-1,2,189000,15000,204000
19,10,6,-1,2,234000,15000,249000
11,5,15,-1,2,246000,30000,276000
16,18,7,-1,2,201000,15000,216000
10,18,6,11,2,318000,300000,618000
20,12,13,-1,2,258000,45000,303000
14,5,18,-1,2,243000,15000,258000
12,5,8,-1,2,276000,45000,321000
11,5,20,-1,1,171000,0,171000
19,14,12,-1,2,249000,45000,294000
7,8,12,-1,2,288000,60000,348000
8,14,6,11,2,288000,355000,643000
8,13,5,-1,2,294000,45000,339000
16,9,10,-1,2,243000,60000,303000
15,12,8,-1,2,237000,45000,282000
18,17,8,-1,2,204000,30000,234000
16,12,20,-1,2,237000,45000,282000
8,7,13,-1,2,297000,60000,357000
18,16,12,13,2,231000,235000,466000
11,9,5,-1,2,255000,45000,300000
14,19,15,-1,2,198000,60000,258000
15,7,13,-1,2,267000,30000,297000
5,16,8,-1,2,237000,15000,252000
10,7,13,-1,2,267000,45000,312000
8,16,9,-1,2,240000,45000,285000
12,10,18,13,2,249000,315000,564000
16,8,6,-1,2,228000,15000,243000
5,12,9,-1,2,255000,45000,300000
14,6,12,-1,2,222000,30000,252000
20,19,17,-1,2,132000,75000,207000
7,11,12,-1,2,273000,75000,348000
9,17,11,-1,2,219000,30000,249000
16,15,17,13,2,195000,90000,285000
14,10,16,-1,2,210000,15000,225000
6,9,17,-1,2,228000,15000,243000
16,17,18,-1,2,183000,90000,273000
14,20,10,-1,2,216000,30000,246000
20,15,11,-1,2,225000,30000,255000
19,16,11,-1,2,246000,45000,291000
16,9,12,11,2,309000,265000,574000
15,17,8,-1,2,258000,30000,288000
20,8,14,-1,2,207000,15000,222000
15,8,9,-1,2,297000,60000,357000
15,11,7,-1,2,237000,45000,282000
19,9,7,-1,2,201000,15000,216000
7,11,14,-1,2,264000,45000,309000
18,11,19,13,2,231000,245000,476000
15,9,6,-1,2,264000,30000,294000
9,16,8,-1,2,240000,45000,285000
8,11,9,-1,2,261000,105000,366000
12,8,16,-1,2,228000,45000,273000
15,17,9,-1,2,204000,30000,234000
18,19,15,-1,2,189000,90000,279000
6,13,20,12,2,270000,205000,475000
20,6,16,-1,2,180000,15000,195000
16,10,18,-1,2,231000,30000,261000
15,17,11,-1,2,246000,45000,291000
7,17,9,-1,2,237000,15000,252000
6,7,15,-1,2,276000,45000,321000
19,13,18,-1,2,171000,75000,246000
5,14,11,13,2,264000,240000,504000
10,19,20,-1,2,210000,30000,240000
5,8,12,-1,2,228000,30000,258000
16,19,15,-1,2,177000,90000,267000
17,11,13,-1,2,201000,30000,231000
18,8,5,-1,2,246000,15000,261000
18,6,20,-1,2,192000,15000,207000
9,7,20,12,2,333000,295000,628000
14,8,12,-1,2,282000,45000,327000
7,11,20,-1,2,198000,15000,213000
5,13,15,-1,2,255000,15000,270000
20,9,19,-1,2,174000,30000,204000
8,9,6,-1,2,243000,45000,288000
19,16,11,-1,2,201000,45000,246000
15,12,9,11,2,309000,265000,574000
17,20,9,-1,2,237000,15000,252000
11,15,13,-1,2,267000,75000,342000
20,9,7,-1,2,219000,15000,234000
17,11,6,-1,2,234000,15000,249000
9,13,16,-1,2,246000,45000,291000
18,6,10,-1,2,216000,15000,231000
14,10,5,13,2,285000,370000,655000
5,16,6,-1,2,234000,0,234000
7,15,8,-1,2,249000,45000,294000
6,7,20,-1,2,204000,30000,234000
6,9,8,-1,2,276000,90000,366000
15,5,14,-1,2,222000,30000,252000
12,5,20,-1,1,189000,0,189000
14,12,13,11,2,261000,90000,351000
20,11,14,-1,2,237000,30000,267000
20,11,14,-1,2,246000,30000,276000
6,15,14,-1,2,267000,30000,297000
9,20,18,-1,2,192000,15000,207000
19,6,9,-1,2,264000,15000,279000
13,20,14,-1,2,234000,60000,294000
15,12,17,13,2,276000,250000,526000
16,7,9,-1,2,255000,30000,285000
18,11,17,-1,2,189000,45000,234000
13,8,14,-1,2,282000,75000,357000
11,6,5,-1,2,261000,60000,321000
8,15,18,-1,2,204000,30000,234000
8,18,15,-1,2,240000,30000,270000
11,13,12,11,2,309000,255000,564000
10,19,8,-1,2,246000,15000,261000
16,15,7,-1,2,249000,30000,279000
5,17,6,-1,2,258000,30000,288000
16,15,8,-1,2,225000,45000,270000
5,8,17,-1,2,246000,15000,261000
15,16,19,-1,2,195000,90000,285000
16,19,7,13,2,267000,175000,442000
7,18,16,-1,2,246000,15000,261000
14,5,20,-1,1,198000,0,198000
14,19,9,-1,2,261000,30000,291000
19,13,12,-1,2,243000,60000,303000
14,19,6,-1,2,234000,15000,249000
15,14,9,-1,2,246000,75000,321000
17,19,15,13,2,183000,75000,258000
12,19,17,-1,2,183000,15000,198000
9,17,19,-1,2,228000,15000,243000
12,11,9,-1,2,276000,90000,366000
15,5,19,-1,2,198000,15000,213000
12,20,15,-1,2,240000,45000,285000
18,12,5,-1,2,252000,15000,267000
19,18,11,12,2,258000,245000,503000
9,13,8,-1,2,261000,60000,321000
7,5,9,-1,2,240000,75000,315000
20,5,7,-1,2,192000,15000,207000
17,12,7,-1,2,261000,30000,291000
10,5,8,-1,2,258000,75000,333000
16,8,14,-1,2,204000,30000,234000
9,7,10,11,2,318000,400000,718000
19,15,16,-1,2,222000,90000,312000
17,8,15,-1,2,201000,15000,216000
6,16,19,-1,2,219000,15000,234000
9,10,14,-1,2,288000,60000,348000
14,11,7,-1,2,246000,45000,291000
11,18,13,-1,2,213000,45000,258000
14,5,6,11,2,321000,225000,546000
13,10,12,-1,2,249000,90000,339000
20,19,9,-1,2,183000,30000,213000
17,7,18,-1,2,195000,30000,225000
8,15,8,-1,1,189000,0,189000
13,15,7,-1,2,213000,30000,243000
9,20,10,-1,2,213000,30000,243000
12,20,8,13,2,285000,300000,585000
11,14,10,-1,2,252000,90000,342000
18,20,9,-1,2,192000,15000,207000
8,17,13,-1,2,270000,30000,300000
14,20,13,-1,2,225000,60000,285000
15,17,10,-1,2,255000,45000,300000
20,20,9,-1,1,135000,0,135000
6,12,13,11,2,309000,255000,564000
12,14,8,-1,2,282000,45000,327000
10,18,5,-1,2,216000,15000,231000
7,9,19,-1,2,219000,15000,234000
13,9,16,-1,2,246000,45000,291000
10,8,14,-1,2,258000,45000,303000
15,17,19,-1,2,165000,75000,240000
10,15,20,13,2,267000,175000,442000
15,13,12,-1,2,270000,105000,375000
17,8,10,-1,2,264000,30000,294000
5,19,18,-1,2,195000,30000,225000
9,5,7,-1,2,297000,120000,417000
13,8,14,-1,2,228000,75000,303000
14,8,18,-1,2,201000,30000,231000
17,16,18,13,2,192000,90000,282000
18,9,13,-1,2,225000,30000,255000
11,7,17,-1,2,252000,30000,282000
12,7,6,-1,2,261000,60000,321000
8,12,15,-1,2,228000,45000,273000
11,13,18,-1,2,222000,45000,267000
19,10,7,-1,2,228000,15000,243000
5,17,7,13,2,309000,170000,479000
6,11,19,-1,2,243000,15000,258000
20,9,5,-1,2,216000,15000,231000
7,20,5,-1,2,228000,15000,243000
15,19,18,-1,2,189000,90000,279000
8,14,18,-1,2,210000,30000,240000
11,16,9,-1,2,267000,45000,312000
10,16,13,12,2,261000,265000,526000
17,16,11,-1,2,204000,30000,234000
12,9,14,-1,2,267000,75000,342000
12,8,20,-1,2,198000,15000,213000
14,10,12,-1,2,267000,75000,342000
5,17,8,-1,2,237000,15000,252000
5,16,9,-1,2,225000,15000,240000
17,16,18,12,2,174000,90000,264000
16,9,12,-1,2,249000,45000,294000
8,12,7,-1,2,270000,60000,330000
12,18,17,-1,2,192000,75000,267000
17,19,8,-1,2,228000,15000,243000
9,13,15,-1,2,264000,45000,309000
14,13,8,-1,2,246000,75000,321000
5,15,12,11,2,282000,265000,547000
5,6,17,-1,2,288000,45000,333000
12,14,5,-1,2,240000,30000,270000
12,20,15,-1,2,204000,45000,249000
11,19,7,-1,2,234000,15000,249000
16,7,19,-1,2,228000,15000,243000
10,12,11,-1,2,279000,90000,369000
12,11,10,13,2,279000,400000,679000
16,18,15,-1,2,201000,30000,231000
12,10,11,-1,2,279000,90000,369000
6,9,17,-1,2,228000,15000,243000
12,13,5,-1,2,270000,45000,315000
12,7,11,-1,2,237000,75000,312000
13,12,15,-1,2,216000,105000,321000
16,10,5,13,2,294000,355000,649000
20,19,17,-1,2,147000,45000,192000
10,20,16,-1,2,192000,30000,222000
7,20,17,-1,2,237000,15000,252000
5,13,7,-1,2,294000,45000,339000
20,17,13,-1,2,183000,45000,228000
18,8,16,-1,2,246000,15000,261000
6,20,14,13,2,267000,235000,502000
12,19,11,-1,2,231000,45000,276000
7,18,19,-1,2,222000,30000,252000
13,18,11,-1,2,267000,45000,312000
17,8,5,-1,2,246000,15000,261000
18,9,16,-1,2,213000,30000,243000
8,7,6,-1,2,288000,90000,378000
18,15,13,11,2,195000,45000,240000
9,17,20,-1,2,228000,15000,243000
19,11,15,-1,2,255000,45000,300000
11,8,12,-1,2,276000,90000,366000
10,11,5,-1,2,246000,75000,321000
20,15,12,-1,2,204000,45000,249000
16,15,10,-1,2,255000,75000,330000
14,11,13,12,2,279000,255000,534000
15,6,5,-1,2,234000,0,234000
18,7,12,-1,2,189000,15000,204000
9,6,15,-1,2,282000,30000,312000
9,11,6,-1,2,249000,75000,324000
12,18,19,-1,2,168000,45000,213000
6,10,11,-1,2,240000,30000,270000
20,11,6,12,2,261000,270000,531000
12,7,11,-1,2,240000,30000,270000
15,8,17,-1,2,204000,30000,234000
12,6,7,-1,2,279000,60000,339000
14,15,11,-1,2,213000,90000,303000
13,8,14,-1,2,264000,75000,339000
6,12,7,-1,2,261000,60000,321000
10,15,16,12,2,252000,195000,447000
5,14,15,-1,2,222000,30000,252000
14,9,13,-1,2,237000,75000,312000
16,6,10,-1,2,252000,30000,282000
14,13,15,-1,2,207000,90000,297000
16,17,13,-1,2,240000,90000,330000
13,17,15,-1,2,249000,75000,324000
11,6,5,13,2,339000,295000,634000
9,15,5,-1,2,261000,30000,291000
17,15,18,-1,2,165000,90000,255000
17,9,5,-1,1,207000,0,207000
16,8,11,-1,2,249000,45000,294000
5,16,19,-1,2,201000,15000,216000
7,15,19,-1,2,234000,15000,249000
10,14,12,11,2,309000,280000,589000
17,9,20,-1,2,237000,15000,252000
5,12,11,-1,2,291000,75000,366000
9,7,18,-1,2,201000,15000,216000
9,11,13,-1,2,258000,75000,333000
12,6,18,-1,2,207000,15000,222000
18,20,15,-1,2,180000,75000,255000
19,7,5,13,2,291000,180000,471000
14,11,6,-1,2,282000,45000,327000
11,6,14,-1,2,237000,45000,282000
16,9,8,-1,2,240000,45000,285000
5,14,6,-1,2,258000,45000,303000
19,15,6,-1,2,189000,15000,204000
18,14,10,-1,2,246000,45000,291000
7,16,20,11,2,300000,185000,485000
18,17,20,-1,2,189000,90000,279000
8,13,19,-1,2,216000,15000,231000
9,15,8,-1,2,297000,60000,357000
17,12,7,-1,2,225000,30000,255000
20,8,14,-1,2,189000,15000,204000
7,20,17,-1,2,228000,15000,243000
8,17,10,12,2,324000,300000,624000
6,18,14,-1,2,252000,15000,267000
18,7,17,-1,2,222000,30000,252000
19,8,6,-1,2,246000,15000,261000
10,18,14,-1,2,237000,45000,282000
13,19,14,-1,2,234000,60000,294000
5,6,16,-1,2,276000,30000,306000
5,6,13,11,2,303000,265000,568000
14,12,5,-1,2,258000,30000,288000
12,11,7,-1,2,237000,75000,312000
8,20,6,-1,2,192000,15000,207000
20,17,15,-1,2,201000,45000,246000
12,5,10,-1,2,228000,15000,243000
13,9,15,-1,2,219000,45000,264000
19,20,12,13,2,237000,230000,467000
7,12,11,-1,2,264000,75000,339000
6,13,5,-1,2,249000,45000,294000
8,16,16,-1,1,144000,0,144000
6,19,10,-1,2,198000,15000,213000
18,20,11,-1,2,192000,30000,222000
14,17,17,-1,1,117000,0,117000
13,7,9,12,2,297000,370000,667000
14,15,17,-1,2,252000,105000,357000
6,11,13,-1,2,291000,45000,336000
17,15,8,-1,2,204000,30000,234000
9,8,5,-1,2,276000,90000,366000
18,16,7,-1,2,192000,15000,207000
17,15,6,-1,2,237000,15000,252000
14,18,5,12,2,279000,250000,529000
19,14,13,-1,2,207000,15000,222000
14,5,12,-1,2,267000,30000,297000
10,19,19,-1,1,117000,0,117000
9,17,13,-1,2,246000,45000,291000
10,18,16,-1,2,204000,30000,234000
16,15,20,-1,2,222000,60000,282000
9,18,16,13,2,267000,190000,457000
14,8,20,-1,2,234000,15000,249000
14,9,20,-1,2,216000,15000,231000
16,10,8,-1,2,282000,30000,312000
14,5,9,-1,2,243000,30000,273000
19,14,5,-1,2,198000,15000,213000
17,15,11,-1,2,228000,45000,273000
5,11,10,12,2,318000,400000,718000
11,7,5,-1,2,297000,60000,357000
14,12,9,-1,2,231000,75000,306000
15,16,8,-1,2,234000,45000,279000
20,15,19,-1,2,168000,75000,243000
12,16,8,-1,2,246000,45000,291000
9,13,20,-1,2,180000,15000,195000
19,7,14,13,2,285000,265000,550000
19,8,16,-1,2,210000,15000,225000
5,20,15,-1,2,234000,15000,249000
14,13,7,-1,2,261000,45000,306000
16,12,17,-1,2,210000,75000,285000
7,13,10,-1,2,294000,45000,339000
14,20,17,-1,2,174000,45000,219000
7,12,6,11,2,297000,175000,472000
17,18,14,-1,2,192000,90000,282000
17,11,15,-1,2,201000,15000,216000
7,10,9,-1,2,267000,90000,357000
6,8,10,-1,2,240000,75000,315000
5,20,14,-1,1,162000,0,162000
13,17,19,-1,2,237000,45000,282000
12,5,15,11,2,327000,265000,592000
9,17,6,-1,2,264000,15000,279000
15,17,7,-1,2,228000,15000,243000
17,14,9,-1,2,246000,45000,291000
17,16,11,-1,2,219000,75000,294000
9,11,5,-1,2,273000,45000,318000
10,16,20,-1,2,174000,30000,204000
17,7,18,11,2,315000,245000,560000
13,6,15,-1,2,210000,15000,225000
14,13,6,-1,2,243000,45000,288000
12,14,16,-1,2,213000,75000,288000
6,13,18,-1,2,234000,15000,249000
19,13,20,-1,2,174000,45000,219000
8,5,11,-1,2,267000,45000,312000
6,5,19,11,2,282000,190000,472000
8,16,10,-1,2,264000,30000,294000
9,15,17,-1,2,204000,30000,234000
19,9,17,-1,2,219000,15000,234000
16,8,17,-1,2,249000,30000,279000
16,15,6,-1,2,249000,30000,279000
7,11,5,-1,2,267000,45000,312000
19,13,16,12,2,195000,45000,240000
7,10,20,-1,2,255000,15000,270000
13,19,5,-1,1,207000,0,207000
16,17,14,-1,2,231000,90000,321000
12,11,17,-1,2,279000,60000,339000
20,18,10,-1,2,201000,15000,216000
5,10,13,-1,2,291000,45000,336000
8,12,14,13,2,240000,360000,600000
19,16,17,-1,2,174000,105000,279000
20,14,9,-1,2,189000,15000,204000
18,12,16,-1,2,246000,45000,291000
13,12,6,-1,2,279000,45000,324000
13,11,9,-1,2,240000,75000,315000
11,14,6,-1,2,246000,45000,291000
5,19,14,13,2,231000,265000,496000
7,8,16,-1,2,267000,45000,312000
17,5,13,-1,2,207000,15000,222000
8,20,9,-1,2,222000,30000,252000
20,5,17,-1,2,219000,15000,234000
19,11,20,-1,2,219000,30000,249000
10,16,9,-1,2,243000,15000,258000
8,11,18,13,2,249000,300000,549000
19,10,9,-1,2,207000,0,207000
20,17,5,-1,2,210000,15000,225000
18,10,13,-1,2,276000,45000,321000
10,9,14,-1,2,270000,60000,330000
19,12,6,-1,2,207000,15000,222000
6,7,15,-1,2,276000,45000,321000
5,16,19,12,2,252000,190000,442000
18,5,12,-1,1,180000,0,180000
9,18,17,-1,2,231000,30000,261000
17,16,9,-1,2,252000,45000,297000
9,14,19,-1,2,243000,30000,273000
17,5,18,-1,2,222000,30000,252000
18,20,10,-1,2,219000,15000,234000
11,20,19,13,2,273000,230000,503000
9,12,8,-1,2,279000,90000,369000
7,19,6,-1,2,213000,30000,243000
15,18,5,-1,2,228000,15000,243000
12,8,17,-1,2,252000,30000,282000
11,11,17,-1,1,135000,0,135000
11,6,16,-1,2,261000,30000,291000
12,16,14,13,2,231000,280000,511000
18,6,8,-1,2,228000,15000,243000
8,16,13,-1,2,246000,45000,291000
8,12,5,-1,2,258000,45000,303000
14,8,13,-1,2,228000,75000,303000
12,16,13,-1,2,225000,90000,315000
18,8,13,-1,2,252000,30000,282000
19,20,15,12,2,159000,75000,234000
17,9,7,-1,2,219000,15000,234000
20,14,13,-1,2,234000,60000,294000
18,19,7,-1,2,231000,30000,261000
19,6,16,-1,2,246000,15000,261000
20,19,11,-1,2,210000,30000,240000
5,14,17,-1,2,210000,15000,225000
8,13,6,13,2,255000,175000,430000
8,17,19,-1,2,192000,15000,207000
13,9,16,-1,2,264000,45000,309000
18,20,14,-1,2,180000,45000,225000
10,6,8,-1,2,231000,30000,261000
9,5,20,-1,2,189000,15000,204000
12,17,13,-1,2,252000,60000,312000
11,5,10,12,2,318000,400000,718000
19,13,16,-1,2,249000,45000,294000
11,17,20,-1,2,219000,30000,249000
16,8,9,-1,2,216000,0,216000
7,8,6,-1,2,270000,90000,360000
15,14,12,-1,2,204000,90000,294000
5,9,20,-1,2,225000,15000,240000
14,18,10,11,2,309000,205000,514000
17,18,7,-1,2,249000,30000,279000
13,9,10,-1,2,288000,90000,378000
10,9,8,-1,2,261000,90000,351000
5,8,10,-1,2,249000,75000,324000
10,14,13,-1,2,222000,90000,312000
17,8,19,-1,2,210000,15000,225000
10,8,5,13,2,333000,295000,628000
17,6,14,-1,2,246000,15000,261000
15,16,13,-1,2,222000,90000,312000
14,7,15,-1,2,270000,45000,315000
8,13,9,-1,2,270000,60000,330000
5,7,15,-1,2,219000,15000,234000
18,7,19,-1,2,195000,30000,225000
7,18,10,13,2,312000,325000,637000
18,15,14,-1,2,210000,30000,240000
19,7,11,-1,2,225000,15000,240000
14,11,7,-1,2,273000,45000,318000
8,9,20,-1,2,204000,30000,234000
10,13,13,-1,2,201000,15000,216000
9,5,11,-1,2,237000,45000,282000
7,6,17,13,2,273000,170000,443000
13,7,15,-1,2,258000,30000,288000
14,11,5,-1,2,249000,30000,279000
16,7,13,-1,2,222000,30000,252000
20,17,10,-1,2,201000,30000,231000
14,6,19,-1,2,189000,15000,204000
6,11,19,-1,2,225000,15000,240000
17,15,18,13,2,192000,90000,282000
13,15,18,-1,2,195000,30000,225000
19,6,8,-1,2,246000,15000,261000
13,17,7,-1,2,228000,30000,258000
15,8,16,-1,2,243000,45000,288000
15,13,18,-1,2,222000,45000,267000
19,6,7,-1,2,258000,30000,288000
9,8,5,13,2,327000,310000,637000
10,17,19,-1,2,222000,30000,252000
8,18,6,-1,2,255000,15000,270000
17,5,17,-1,1,153000,0,153000
8,16,15,-1,2,225000,45000,270000
7,5,15,-1,2,246000,15000,261000
6,5,15,-1,2,240000,30000,270000
14,17,16,12,2,195000,90000,285000
7,15,13,-1,2,267000,30000,297000
17,13,20,-1,2,201000,45000,246000
17,6,16,-1,2,258000,30000,288000
13,6,19,-1,2,234000,15000,249000
9,15,12,-1,2,258000,45000,303000
20,13,16,-1,2,213000,45000,258000
11,16,18,13,2,285000,235000,520000
8,7,19,-1,2,231000,30000,261000
10,6,20,-1,2,216000,15000,231000
16,18,7,-1,2,228000,15000,243000
11,5,19,-1,1,207000,0,207000
14,11,20,-1,2,246000,30000,276000
9,12,7,-1,2,285000,45000,330000
20,16,15,13,2,177000,60000,237000
18,13,19,-1,2,186000,30000,216000
7,20,7,-1,1,162000,0,162000
6,12,5,-1,2,288000,60000,348000
7,15,8,-1,2,249000,45000,294000
15,11,19,-1,2,201000,45000,246000
13,20,17,-1,2,219000,45000,264000
17,11,20,13,2,285000,190000,475000
16,13,18,-1,2,213000,75000,288000
11,6,18,-1,2,252000,15000,267000
10,12,15,-1,2,249000,45000,294000
5,16,14,-1,2,228000,15000,243000
6,5,13,-1,2,267000,45000,312000
8,18,20,-1,2,174000,15000,189000
20,7,11,13,2,303000,285000,588000
16,5,14,-1,2,210000,15000,225000
14,18,17,-1,2,192000,90000,282000
13,9,11,-1,2,231000,30000,261000
9,9,8,-1,2,168000,30000,198000
17,15,16,-1,2,177000,90000,267000
5,18,10,-1,1,198000,0,198000
19,14,7,11,2,291000,175000,466000
15,17,19,-1,2,219000,75000,294000
16,7,13,-1,2,219000,15000,234000
9,8,19,-1,2,222000,30000,252000
13,7,8,-1,2,288000,60000,348000
11,7,20,-1,2,189000,15000,204000
18,13,14,-1,2,243000,60000,303000
13,17,11,13,2,252000,130000,382000
17,10,19,-1,2,222000,30000,252000
18,19,7,-1,2,231000,30000,261000
20,17,7,-1,2,237000,15000,252000
10,15,19,-1,2,252000,30000,282000
13,12,20,-1,2,240000,45000,285000
12,8,10,-1,2,285000,75000,360000
19,15,12,13,2,231000,250000,481000
12,5,8,-1,2,267000,45000,312000
18,13,11,-1,2,213000,45000,258000
18,20,14,-1,2,189000,45000,234000
9,20,14,-1,1,162000,0,162000
16,5,11,-1,2,288000,30000,318000
17,6,15,-1,2,201000,15000,216000
15,8,12,11,2,300000,265000,565000
11,18,5,-1,2,252000,15000,267000
8,12,20,-1,2,207000,15000,222000
13,11,10,-1,2,279000,105000,384000
11,9,7,-1,2,258000,75000,333000
19,16,20,-1,2,132000,75000,207000
19,12,6,-1,2,234000,15000,249000
7,11,17,12,2,288000,315000,603000
12,10,17,-1,2,210000,30000,240000
19,8,10,-1,2,210000,15000,225000
14,19,16,-1,2,222000,45000,267000
12,7,16,-1,2,279000,30000,309000
20,10,14,-1,2,207000,30000,237000
20,18,5,-1,2,210000,15000,225000
13,9,19,11,2,327000,190000,517000
15,16,20,-1,2,231000,60000,291000
6,9,8,-1,2,243000,45000,288000
14,10,20,-1,2,198000,30000,228000
17,10,13,-1,2,258000,45000,303000
17,7,16,-1,2,231000,30000,261000
19,15,11,-1,2,237000,45000,282000
20,8,12,11,2,309000,205000,514000
15,16,8,-1,2,270000,45000,315000
14,19,5,-1,2,225000,15000,240000
17,6,15,-1,2,228000,15000,243000
8,6,5,-1,2,279000,105000,384000
16,12,20,-1,2,192000,45000,237000
17,16,5,-1,2,249000,30000,279000
6,16,10,13,2,294000,355000,649000
6,20,15,-1,2,189000,15000,204000
15,10,5,-1,2,270000,30000,300000
5,18,14,-1,2,198000,15000,213000
7,20,11,-1,2,216000,15000,231000
5,15,12,-1,2,267000,30000,297000
11,10,9,-1,2,252000,90000,342000
17,14,13,12,2,216000,90000,306000
5,18,16,-1,2,237000,15000,252000
18,17,6,-1,2,231000,30000,261000
18,19,7,-1,2,231000,30000,261000
16,11,8,-1,2,294000,45000,339000
5,7,6,-1,2,261000,90000,351000
19,19,12,-1,1,108000,0,108000
5,20,8,13,2,312000,205000,517000
7,18,11,-1,2,234000,15000,249000
20,12,8,-1,2,216000,15000,231000
16,18,6,-1,2,237000,15000,252000
13,5,17,-1,2,243000,15000,258000
20,10,12,-1,2,192000,15000,207000
20,6,17,-1,2,237000,15000,252000
17,7,19,12,2,306000,215000,521000
17,19,13,-1,2,183000,15000,198000
8,6,7,-1,2,297000,90000,387000
8,17,14,-1,2,204000,30000,234000
20,16,11,-1,2,225000,30000,255000
10,13,14,-1,2,267000,90000,357000
14,9,13,-1,2,246000,75000,321000
14,6,18,11,2,291000,205000,496000
10,9,5,-1,2,294000,120000,414000
15,20,18,-1,2,153000,75000,228000
8,10,19,-1,2,210000,15000,225000
9,8,14,-1,2,288000,60000,348000
8,15,13,-1,2,228000,45000,273000
6,9,19,-1,2,219000,15000,234000
19,19,12,11,1,135000,0,135000
19,12,6,-1,2,234000,15000,249000
18,9,20,-1,2,201000,15000,216000
12,19,9,-1,2,273000,30000,303000
8,7,16,-1,2,276000,45000,321000
14,18,9,-1,2,207000,30000,237000
9,5,10,-1,2,264000,75000,339000
18,7,13,11,2,273000,220000,493000
8,7,14,-1,2,306000,60000,366000
13,15,6,-1,2,222000,30000,252000
5,15,18,-1,2,210000,15000,225000
5,18,20,-1,2,210000,15000,225000
16,10,17,-1,2,252000,45000,297000
12,8,16,-1,2,273000,45000,318000
13,17,8,12,2,261000,265000,526000
16,8,6,-1,1,198000,0,198000
18,5,12,-1,2,225000,15000,240000
18,10,15,-1,2,228000,45000,273000
10,14,20,-1,2,225000,30000,255000
16,13,12,-1,2,252000,90000,342000
20,15,11,-1,2,225000,30000,255000
17,19,11,12,2,297000,215000,512000
20,18,16,-1,2,156000,30000,186000
13,7,15,-1,2,219000,15000,234000
5,18,7,-1,2,219000,15000,234000
19,14,9,-1,2,225000,30000,255000
7,15,11,-1,2,264000,45000,309000
19,16,12,-1,2,192000,45000,237000
19,18,14,12,2,207000,75000,282000
12,5,7,-1,2,228000,30000,258000
13,18,7,-1,2,201000,30000,231000
12,14,9,-1,2,258000,75000,333000
19,11,6,-1,2,216000,15000,231000
14,15,8,-1,2,243000,45000,288000
9,17,15,-1,2,222000,30000,252000
19,8,20,12,2,264000,200000,464000
10,19,15,-1,2,216000,30000,246000
6,15,18,-1,2,237000,15000,252000
14,15,7,-1,2,261000,45000,306000
11,5,19,-1,1,189000,0,189000
9,6,12,-1,2,294000,45000,339000
5,9,17,-1,2,207000,15000,222000
8,13,11,12,2,279000,360000,639000
14,16,20,-1,2,174000,30000,204000
18,5,13,-1,2,252000,15000,267000
15,13,18,-1,2,222000,45000,267000
18,9,14,-1,2,252000,30000,282000
6,10,5,-1,2,279000,60000,339000
16,20,5,-1,2,180000,15000,195000
11,16,17,13,2,276000,195000,471000
6,8,16,-1,2,228000,15000,243000
17,15,11,-1,2,219000,45000,264000
9,20,13,-1,2,207000,15000,222000
7,19,18,-1,2,240000,30000,270000
12,10,9,-1,2,297000,105000,402000
10,17,18,-1,2,207000,45000,252000
14,18,10,13,2,276000,265000,541000
7,18,9,-1,2,219000,15000,234000
14,9,8,-1,2,279000,60000,339000
10,5,20,-1,2,189000,15000,204000
7,10,9,-1,2,276000,90000,366000
12,19,17,-1,2,192000,45000,237000
7,20,19,-1,2,210000,30000,240000
9,13,10,12,2,282000,240000,522000
10,19,20,-1,2,201000,30000,231000
18,6,12,-1,1,180000,0,180000
13,14,11,-1,2,249000,90000,339000
6,9,5,-1,2,279000,90000,369000
18,13,10,-1,2,222000,45000,267000
8,7,6,-1,2,279000,90000,369000
20,14,9,12,2,252000,190000,442000
16,19,11,-1,2,192000,15000,207000
19,9,7,-1,2,246000,15000,261000
14,7,13,-1,2,252000,45000,297000
14,17,16,-1,2,204000,90000,294000
5,10,17,-1,2,252000,15000,267000
18,10,8,-1,2,219000,15000,234000
20,17,18,13,2,171000,90000,261000
13,7,6,-1,2,288000,60000,348000
15,18,7,-1,2,201000,15000,216000
15,8,17,-1,2,240000,30000,270000
17,15,5,-1,2,228000,15000,243000
20,13,8,-1,2,207000,15000,222000
14,7,12,-1,2,282000,45000,327000
19,20,17,11,2,123000,75000,198000
9,13,8,-1,2,288000,60000,348000
15,10,20,-1,2,198000,30000,228000
18,15,5,-1,2,237000,15000,252000
16,14,6,-1,2,246000,15000,261000
20,15,5,-1,2,207000,15000,222000
6,10,13,-1,2,273000,45000,318000
19,12,16,13,2,231000,235000,466000
11,15,16,-1,2,219000,75000,294000
13,14,18,-1,2,243000,60000,303000
16,11,13,-1,2,258000,45000,303000
18,7,9,-1,2,228000,15000,243000
15,19,12,-1,2,231000,45000,276000
17,6,11,-1,2,243000,15000,258000
11,10,8,12,2,309000,400000,709000
16,6,5,-1,2,288000,45000,333000
11,15,19,-1,2,210000,45000,255000
15,11,17,-1,2,237000,45000,282000
14,20,19,-1,2,186000,75000,261000
18,17,11,-1,2,198000,45000,243000
20,18,15,-1,2,207000,75000,282000
12,20,10,13,2,258000,300000,558000
20,17,8,-1,2,201000,15000,216000
5,13,11,-1,2,291000,45000,336000
14,20,9,-1,2,171000,15000,186000
19,11,17,-1,2,231000,30000,261000
5,12,15,-1,2,276000,30000,306000
10,11,13,-1,2,252000,105000,357000
5,11,8,12,2,306000,295000,601000
20,11,10,-1,2,231000,30000,261000
19,20,11,-1,2,219000,30000,249000
17,5,8,-1,1,207000,0,207000
17,13,18,-1,2,192000,75000,267000
9,6,20,-1,2,255000,15000,270000
5,17,14,-1,2,246000,15000,261000
17,8,14,12,2,279000,250000,529000
18,12,14,-1,2,192000,30000,222000
15,20,7,-1,2,225000,15000,240000
17,14,9,-1,2,255000,45000,300000
7,9,18,-1,2,219000,15000,234000
10,8,13,-1,2,267000,45000,312000
17,19,12,-1,2,192000,45000,237000
20,5,16,13,2,276000,205000,481000
11,17,6,-1,2,216000,15000,231000
11,15,10,-1,2,261000,60000,321000
9,8,20,-1,2,222000,30000,252000
15,9,14,-1,2,255000,75000,330000
16,15,17,-1,2,195000,90000,285000
20,13,15,-1,2,183000,30000,213000
15,13,16,12,2,240000,90000,330000
16,11,7,-1,2,270000,30000,300000
19,6,14,-1,2,207000,15000,222000
15,19,10,-1,2,225000,30000,255000
20,14,11,-1,2,237000,30000,267000
20,18,10,-1,2,219000,15000,234000
6,18,9,-1,2,264000,15000,279000
20,17,10,13,2,258000,190000,448000
15,19,16,-1,2,195000,90000,285000
7,5,8,-1,2,243000,45000,288000
20,17,18,-1,2,135000,90000,225000
7,16,17,-1,2,240000,30000,270000
9,6,19,-1,2,246000,15000,261000
8,9,18,-1,2,231000,30000,261000
6,8,15,11,2,324000,340000,664000
10,16,8,-1,2,273000,30000,303000
20,11,9,-1,2,192000,15000,207000
13,19,8,-1,2,225000,15000,240000
8,5,17,-1,2,264000,15000,279000
15,20,14,-1,2,216000,60000,276000
7,11,17,-1,2,279000,30000,309000
19,17,6,12,2,261000,215000,476000
20,6,9,-1,1,180000,0,180000
12,13,7,-1,2,273000,75000,348000
8,16,7,-1,2,249000,45000,294000
11,10,19,-1,2,222000,45000,267000
6,10,14,-1,2,264000,45000,309000
19,20,18,-1,2,114000,60000,174000
13,16,8,12,2,306000,265000,571000
16,18,6,-1,2,192000,15000,207000
17,8,12,-1,2,252000,30000,282000
5,12,14,-1,2,249000,30000,279000
18,8,15,-1,2,204000,30000,234000
17,6,11,-1,2,234000,15000,249000
10,17,18,-1,2,225000,45000,270000
17,14,13,11,2,252000,90000,342000
16,5,17,-1,2,249000,30000,279000
8,11,10,-1,2,276000,90000,366000
17,13,7,-1,2,201000,30000,231000
17,6,18,-1,2,222000,30000,252000
5,14,12,-1,2,276000,30000,306000
7,17,13,-1,2,201000,30000,231000
15,19,13,12,2,222000,45000,267000
19,9,10,-1,2,240000,30000,270000
14,20,16,-1,2,231000,45000,276000
6,13,20,-1,1,216000,0,216000
6,19,5,-1,2,270000,45000,315000
9,8,7,-1,2,279000,90000,369000
13,17,8,-1,2,216000,30000,246000
18,11,5,11,2,231000,140000,371000
20,13,16,-1,2,222000,45000,267000
5,9,14,-1,2,291000,45000,336000
14,16,6,-1,2,210000,15000,225000
5,6,19,-1,2,231000,30000,261000
9,8,10,-1,2,279000,90000,369000
16,11,18,-1,2,201000,45000,246000
7,13,15,11,2,309000,250000,559000
15,16,13,-1,2,249000,90000,339000
10,11,14,-1,2,279000,90000,369000
14,8,19,-1,2,210000,30000,240000
14,13,8,-1,2,264000,75000,339000
18,5,15,-1,2,210000,15000,225000
9,20,7,-1,2,228000,15000,243000
14,20,15,12,2,234000,60000,294000
13,5,17,-1,2,264000,30000,294000
19,17,15,-1,2,183000,75000,258000
6,9,18,-1,1,198000,0,198000
5,19,10,-1,2,216000,15000,231000
11,17,15,-1,2,228000,45000,273000
13,8,17,-1,2,252000,30000,282000
10,20,9,11,2,300000,270000,570000
6,5,12,-1,2,309000,75000,384000
16,17,13,-1,2,195000,90000,285000
5,9,8,-1,2,306000,120000,426000
14,16,6,-1,2,210000,15000,225000
11,17,14,-1,2,231000,45000,276000
7,6,13,-1,2,288000,60000,348000
6,12,19,13,2,240000,315000,555000
20,9,12,-1,2,201000,15000,216000
7,10,6,-1,2,306000,90000,396000
12,17,9,-1,2,231000,45000,276000
17,9,11,-1,2,237000,30000,267000
20,9,20,-1,1,126000,0,126000
6,14,19,-1,2,234000,15000,249000
19,12,5,11,2,300000,205000,505000
14,7,18,-1,2,255000,30000,285000
10,8,15,-1,2,267000,45000,312000
11,17,16,-1,2,201000,75000,276000
13,8,16,-1,2,264000,45000,309000
13,16,7,-1,2,222000,30000,252000
10,14,8,-1,2,267000,45000,312000
6,11,7,13,2,285000,295000,580000
8,11,8,-1,2,201000,15000,216000
17,18,19,-1,2,135000,75000,210000
12,20,13,-1,2,240000,45000,285000
15,17,9,-1,2,240000,30000,270000
6,7,10,-1,2,288000,90000,378000
14,5,6,-1,2,249000,45000,294000
6,17,14,11,2,273000,235000,508000
9,11,20,-1,2,237000,15000,252000
11,18,9,-1,2,264000,30000,294000
14,12,7,-1,2,255000,45000,300000
11,12,9,-1,2,231000,90000,321000
14,18,12,-1,2,213000,45000,258000
12,9,5,-1,2,273000,45000,318000
7,16,8,13,2,276000,225000,501000
17,14,10,-1,2,255000,45000,300000
8,7,12,-1,2,279000,60000,339000
8,17,18,-1,2,195000,30000,225000
13,16,18,-1,2,240000,75000,315000
9,11,20,-1,2,237000,15000,252000
15,8,9,-1,2,297000,60000,357000
9,18,8,11,2,279000,285000,564000
14,17,12,-1,2,249000,45000,294000
17,12,18,-1,2,228000,75000,303000
17,11,14,-1,2,258000,45000,303000
7,14,5,-1,2,273000,30000,303000
16,11,5,-1,2,219000,30000,249000
5,16,8,-1,2,228000,15000,243000
6,12,17,11,2,291000,265000,556000
14,15,8,-1,2,270000,45000,315000
9,14,18,-1,2,234000,30000,264000
10,17,8,-1,2,255000,30000,285000
19,18,13,-1,2,180000,75000,255000
19,5,10,-1,1,180000,0,180000
7,15,5,-1,2,246000,15000,261000
17,7,16,12,2,261000,220000,481000
15,10,11,-1,2,246000,30000,276000
6,20,10,-1,2,189000,15000,204000
11,16,14,-1,2,249000,75000,324000
12,5,10,-1,2,273000,45000,318000
6,18,20,-1,2,174000,15000,189000
18,20,8,-1,2,228000,15000,243000
7,19,8,13,2,330000,180000,510000
5,12,15,-1,2,276000,30000,306000
11,8,16,-1,2,249000,45000,294000
10,13,20,-1,2,219000,30000,249000
9,13,8,-1,2,288000,60000,348000
10,9,15,-1,2,243000,60000,303000
17,15,13,-1,2,204000,75000,279000
9,20,5,11,2,324000,270000,594000
12,7,14,-1,2,282000,45000,327000
12,5,11,-1,2,243000,45000,288000
11,15,5,-1,2,219000,30000,249000
9,12,9,-1,2,174000,15000,189000
13,8,11,-1,2,240000,75000,315000
12,8,17,-1,2,225000,30000,255000
17,13,8,12,2,270000,265000,535000
7,17,9,-1,1,189000,0,189000
6,11,19,-1,2,225000,15000,240000
11,9,13,-1,2,258000,75000,333000
17,6,13,-1,2,219000,30000,249000
11,16,15,-1,2,219000,75000,294000
9,19,13,-1,2,243000,30000,273000
18,6,16,13,2,258000,235000,493000
13,12,14,-1,2,234000,90000,324000
13,6,8,-1,2,276000,45000,321000
5,6,17,-1,2,231000,30000,261000
18,6,20,-1,2,183000,15000,198000
9,15,18,-1,2,249000,30000,279000
16,16,18,-1,2,165000,15000,180000
10,8,11,13,2,318000,310000,628000
7,14,5,-1,2,294000,45000,339000
11,14,5,-1,2,231000,30000,261000
14,7,8,-1,2,261000,60000,321000
18,14,15,-1,2,198000,90000,288000
17,12,10,-1,2,276000,45000,321000
13,8,7,-1,2,270000,60000,330000
19,17,18,13,2,135000,75000,210000
20,17,12,-1,2,228000,45000,273000
20,15,17,-1,2,210000,45000,255000
5,10,16,-1,1,198000,0,198000
10,14,20,-1,2,216000,30000,246000
7,13,14,-1,2,261000,45000,306000
9,12,14,-1,2,249000,75000,324000
18,19,13,12,2,189000,75000,264000
15,5,8,-1,1,198000,0,198000
13,14,17,-1,2,216000,90000,306000
6,18,7,-1,2,267000,30000,297000
10,6,16,-1,2,252000,30000,282000
9,12,19,-1,2,219000,30000,249000
11,12,9,-1,2,258000,90000,348000
6,16,9,13,2,276000,225000,501000
10,16,6,-1,2,288000,30000,318000
16,8,17,-1,2,204000,30000,234000
9,5,7,-1,2,276000,75000,351000
17,16,12,-1,2,192000,75000,267000
12,19,10,-1,2,255000,30000,285000
19,13,11,-1,2,228000,30000,258000
13,12,9,13,2,252000,240000,492000
19,9,16,-1,2,231000,30000,261000
16,6,5,-1,2,276000,30000,306000
11,17,10,-1,2,243000,60000,303000
10,5,14,-1,2,252000,30000,282000
6,17,19,-1,2,183000,15000,198000
10,6,14,-1,2,282000,45000,327000
13,9,5,12,2,279000,370000,649000
10,19,17,-1,2,240000,30000,270000
20,13,17,-1,2,228000,45000,273000
13,9,8,-1,2,306000,60000,366000
8,17,15,-1,2,204000,30000,234000
8,18,14,-1,2,219000,30000,249000
7,14,10,-1,2,285000,45000,330000
8,15,18,13,2,231000,250000,481000
8,11,19,-1,2,210000,15000,225000
13,16,9,-1,2,264000,45000,309000
11,8,17,-1,2,246000,30000,276000
18,14,20,-1,2,180000,45000,225000
20,8,13,-1,1,171000,0,171000
10,17,5,-1,2,252000,15000,267000
13,7,14,11,2,291000,225000,516000
11,18,13,-1,2,267000,45000,312000
18,9,16,-1,2,222000,30000,252000
14,9,10,-1,2,279000,60000,339000
11,14,16,-1,2,222000,75000,297000
18,7,14,-1,2,237000,30000,267000
16,20,6,-1,2,207000,15000,222000
20,10,12,12,2,249000,140000,389000
20,15,7,-1,2,225000,15000,240000
18,8,16,-1,2,228000,15000,243000
20,11,9,-1,2,219000,15000,234000
9,18,7,-1,2,246000,15000,261000
9,14,15,-1,2,246000,75000,321000
19,11,8,-1,2,210000,15000,225000
8,10,5,12,2,333000,285000,618000
14,17,6,-1,2,246000,15000,261000
7,17,5,-1,2,246000,15000,261000
19,14,8,-1,2,201000,30000,231000
5,9,20,-1,2,225000,15000,240000
9,11,10,-1,2,279000,90000,369000
14,12,8,-1,2,237000,45000,282000
12,10,11,12,2,234000,240000,474000
19,16,6,-1,2,219000,15000,234000
20,11,6,-1,2,234000,15000,249000
10,20,18,-1,2,210000,15000,225000
12,9,6,-1,2,303000,45000,348000
19,7,20,-1,2,165000,30000,195000
14,18,20,-1,2,174000,15000,189000
19,14,20,12,2,204000,75000,279000
11,6,13,-1,2,246000,45000,291000
6,13,11,-1,2,237000,45000,282000
13,8,14,-1,2,228000,75000,303000
17,15,7,-1,2,210000,15000,225000
7,16,10,-1,2,264000,30000,294000
19,8,13,-1,2,189000,15000,204000
10,16,8,11,2,327000,315000,642000
18,7,17,-1,2,249000,30000,279000
19,15,17,-1,2,210000,75000,285000
13,5,19,-1,1,171000,0,171000
19,16,5,-1,2,237000,15000,252000
8,10,20,-1,2,237000,15000,252000
16,7,19,-1,2,228000,15000,243000
5,18,14,13,2,276000,265000,541000
17,11,16,-1,2,219000,75000,294000
12,10,16,-1,2,258000,45000,303000
10,13,15,-1,2,240000,75000,315000
18,17,16,-1,2,183000,90000,273000
8,10,18,-1,2,210000,15000,225000
19,9,5,-1,2,234000,15000,249000
7,9,14,12,2,306000,370000,676000
5,15,16,-1,2,267000,30000,297000
20,5,20,-1,1,135000,0,135000
8,19,9,-1,2,240000,30000,270000
13,19,5,-1,1,207000,0,207000
18,12,16,-1,2,237000,45000,282000
8,15,12,-1,2,273000,45000,318000
18,19,7,11,2,258000,200000,458000
17,18,5,-1,2,195000,30000,225000
11,13,14,-1,2,258000,90000,348000
8,9,10,-1,2,279000,90000,369000
12,9,11,-1,2,231000,90000,321000
6,14,10,-1,2,246000,45000,291000
10,5,8,-1,2,249000,75000,324000
7,19,15,11,2,273000,160000,433000
11,15,16,-1,2,255000,75000,330000
11,8,14,-1,2,276000,45000,321000
15,8,20,-1,2,189000,15000,204000
5,13,16,-1,2,264000,15000,279000
9,7,16,-1,2,255000,30000,285000
6,7,19,-1,2,213000,30000,243000
10,9,16,11,2,309000,315000,624000
20,5,19,-1,2,219000,30000,249000
19,5,15,-1,2,189000,15000,204000
14,6,15,-1,2,258000,30000,288000
15,9,12,-1,2,249000,45000,294000
16,5,13,-1,2,237000,15000,252000
5,19,15,-1,2,207000,15000,222000
20,17,5,12,2,288000,185000,473000
11,17,18,-1,2,195000,30000,225000
18,12,6,-1,2,243000,15000,258000
9,19,14,-1,2,234000,30000,264000
16,12,14,-1,2,231000,75000,306000
19,14,17,-1,2,210000,75000,285000
20,7,18,-1,2,174000,15000,189000
11,10,13,11,2,279000,160000,439000
11,19,9,-1,2,201000,15000,216000
18,14,12,-1,2,249000,45000,294000
20,15,13,-1,2,231000,45000,276000
7,11,16,-1,2,270000,30000,300000
7,11,15,-1,2,246000,45000,291000
11,5,9,-1,2,237000,45000,282000
17,16,12,11,2,192000,75000,267000
20,6,8,-1,2,237000,15000,252000
20,18,12,-1,2,192000,30000,222000
13,20,11,-1,2,189000,15000,204000
17,19,7,-1,2,219000,15000,234000
18,16,7,-1,2,237000,15000,252000
13,7,11,-1,2,273000,45000,318000
5,8,15,13,2,276000,265000,541000
10,8,13,-1,2,285000,45000,330000
9,8,6,-1,2,240000,90000,330000
18,13,12,-1,2,216000,60000,276000
20,10,18,-1,2,210000,15000,225000
16,15,16,-1,2,195000,30000,225000
13,5,8,-1,2,276000,45000,321000
12,13,7,11,2,273000,255000,528000
5,10,9,-1,2,294000,120000,414000
9,17,14,-1,2,219000,45000,264000
14,7,20,-1,2,207000,15000,222000
6,13,14,-1,2,270000,45000,315000
18,5,15,-1,2,210000,15000,225000
19,11,16,-1,2,237000,45000,282000
5,11,7,13,2,321000,295000,616000
17,7,13,-1,2,237000,30000,267000
19,11,13,-1,2,228000,30000,258000
5,16,7,-1,2,255000,15000,270000
11,5,6,-1,2,261000,60000,321000
7,17,10,-1,2,237000,30000,267000
7,10,18,-1,2,210000,15000,225000
20,9,13,13,2,231000,140000,371000
13,19,16,-1,2,240000,45000,285000
8,11,5,-1,2,306000,90000,396000
6,14,8,-1,2,237000,30000,267000
15,10,8,-1,2,240000,45000,285000
6,14,9,-1,2,249000,45000,294000
11,17,5,-1,2,207000,15000,222000
18,17,9,12,2,270000,245000,515000
6,20,18,-1,2,174000,15000,189000
14,11,8,-1,2,294000,45000,339000
12,13,9,-1,2,240000,90000,330000
7,20,19,-1,2,183000,30000,213000
5,12,14,-1,2,228000,15000,243000
6,12,8,-1,2,240000,45000,285000
10,13,15,12,2,252000,280000,532000
20,5,14,-1,1,162000,0,162000
20,14,8,-1,2,234000,15000,249000
14,10,13,-1,2,267000,90000,357000
17,14,5,-1,2,237000,15000,252000
8,14,11,-1,2,267000,45000,312000
6,17,5,-1,2,240000,30000,270000
12,19,17,11,2,201000,45000,246000
16,17,11,-1,2,246000,75000,321000
9,14,18,-1,2,243000,30000,273000
20,12,6,-1,1,189000,0,189000
16,14,18,-1,2,240000,75000,315000
20,15,19,-1,2,195000,75000,270000
10,9,6,-1,2,267000,90000,357000
8,7,19,13,2,276000,180000,456000
14,6,8,-1,2,282000,30000,312000
13,5,20,-1,1,171000,0,171000
11,13,9,-1,2,276000,75000,351000
16,11,20,-1,2,198000,30000,228000
15,12,16,-1,2,249000,90000,339000
19,15,9,-1,2,228000,30000,258000
5,12,16,11,2,318000,265000,583000
7,13,11,-1,2,291000,45000,336000
9,18,7,-1,2,201000,15000,216000
19,7,5,-1,2,228000,15000,243000
10,9,16,-1,2,270000,60000,330000
13,12,19,-1,2,225000,60000,285000
14,5,15,-1,2,258000,30000,288000
16,12,15,12,2,270000,195000,465000
15,10,17,-1,2,201000,15000,216000
16,13,15,-1,2,222000,90000,312000
18,19,14,-1,2,207000,75000,282000
9,11,10,-1,2,246000,45000,291000
10,16,9,-1,2,243000,60000,303000
19,18,12,-1,2,177000,45000,222000
5,9,15,12,2,291000,185000,476000
12,5,6,-1,2,279000,60000,339000
10,14,19,-1,2,198000,30000,228000
13,14,12,-1,2,252000,90000,342000
12,13,18,-1,2,252000,60000,312000
12,7,11,-1,2,273000,75000,348000
8,15,16,-1,2,216000,45000,261000
16,20,7,12,2,279000,160000,439000
20,18,8,-1,2,174000,15000,189000
6,8,15,-1,2,291000,30000,321000
20,10,13,-1,2,210000,30000,240000
13,5,15,-1,2,255000,15000,270000
13,20,10,-1,2,219000,30000,249000
9,10,7,-1,2,276000,90000,366000
16,15,17,13,2,177000,90000,267000
12,17,15,-1,2,204000,30000,234000
19,8,18,-1,2,213000,30000,243000
17,8,13,-1,2,270000,30000,300000
18,7,19,-1,2,204000,30000,234000
15,7,17,-1,2,255000,15000,270000
16,8,9,-1,2,267000,45000,312000
13,17,7,11,2,282000,250000,532000
17,6,14,-1,2,264000,15000,279000
9,13,12,-1,2,258000,90000,348000
5,7,12,-1,2,258000,45000,303000
17,11,8,-1,2,228000,30000,258000
9,6,20,-1,2,219000,15000,234000
6,15,7,-1,2,285000,45000,330000
17,15,19,11,2,165000,75000,240000
18,11,19,-1,2,186000,30000,216000
12,10,17,-1,2,276000,45000,321000
11,5,17,-1,2,225000,15000,240000
17,20,19,-1,2,141000,75000,216000
19,12,13,-1,2,252000,60000,312000
12,13,16,-1,2,252000,90000,342000
16,5,20,13,2,267000,205000,472000
9,19,14,-1,2,225000,30000,255000
13,12,8,-1,2,255000,75000,330000
18,13,10,-1,2,231000,45000,276000
14,16,20,-1,2,213000,45000,258000
13,17,16,-1,2,249000,90000,339000
12,6,18,-1,2,252000,15000,267000
11,19,6,12,2,288000,300000,588000
9,11,8,-1,2,246000,30000,276000
7,14,5,-1,2,237000,30000,267000
9,14,10,-1,2,243000,60000,303000
9,7,19,-1,2,210000,15000,225000
15,13,16,-1,2,222000,90000,312000
14,6,8,-1,2,282000,30000,312000
13,8,18,11,2,273000,220000,493000
10,13,5,-1,2,291000,45000,336000
17,14,5,-1,2,210000,15000,225000
9,19,12,-1,2,246000,30000,276000
17,7,6,-1,2,249000,30000,279000
20,17,5,-1,2,201000,15000,216000
18,14,19,-1,2,216000,75000,291000
14,20,8,13,2,267000,190000,457000
19,7,17,-1,2,237000,15000,252000
16,10,19,-1,2,231000,30000,261000
9,20,14,-1,2,225000,15000,240000
5,7,17,-1,2,276000,30000,306000
14,20,17,-1,2,183000,45000,228000
15,6,11,-1,2,225000,15000,240000
14,10,5,12,2,270000,345000,615000
19,14,13,-1,2,261000,60000,321000
7,14,13,-1,2,270000,45000,315000
18,9,16,-1,2,213000,30000,243000
12,7,15,-1,2,273000,45000,318000
13,15,20,-1,2,195000,45000,240000
8,18,14,-1,2,237000,30000,267000
17,6,8,11,2,324000,310000,634000
17,19,12,-1,2,237000,45000,282000
16,8,12,-1,2,273000,45000,318000
5,13,19,-1,1,180000,0,180000
19,17,9,-1,2,228000,15000,243000
12,9,15,-1,2,276000,45000,321000
12,5,8,-1,2,267000,45000,312000
7,16,19,12,2,252000,190000,442000
20,7,18,-1,2,174000,15000,189000
5,19,10,-1,2,252000,15000,267000
11,20,9,-1,2,210000,15000,225000
8,19,7,-1,2,258000,30000,288000
10,7,13,-1,2,276000,45000,321000
16,6,15,-1,2,213000,30000,243000
10,20,12,13,2,267000,300000,567000
17,14,7,-1,2,231000,30000,261000
6,19,14,-1,2,225000,15000,240000
15,18,16,-1,2,204000,105000,309000
12,11,5,-1,2,240000,30000,270000
18,12,19,-1,2,168000,45000,213000
7,5,18,-1,1,198000,0,198000
13,18,20,13,2,249000,215000,464000
6,17,9,-1,2,228000,15000,243000
16,12,14,-1,2,231000,75000,306000
19,13,16,-1,2,231000,45000,276000
10,19,16,-1,2,240000,30000,270000
9,18,8,-1,2,258000,30000,288000
16,14,19,-1,2,222000,45000,267000
20,11,5,11,2,231000,125000,356000
8,15,19,-1,2,246000,30000,276000
19,19,18,-1,2,150000,30000,180000
15,7,12,-1,2,291000,45000,336000
9,8,16,-1,2,240000,45000,285000
5,16,11,-1,2,228000,30000,258000
5,7,14,-1,2,246000,30000,276000
8,13,18,13,2,207000,155000,362000
11,6,10,-1,2,273000,75000,348000
11,9,13,-1,2,231000,75000,306000
9,8,19,-1,2,213000,30000,243000
18,10,7,-1,2,237000,15000,252000
8,13,14,-1,2,264000,75000,339000
14,15,17,-1,2,207000,105000,312000
18,17,14,12,2,228000,90000,318000
12,10,19,-1,2,198000,15000,213000
17,12,5,-1,2,234000,15000,249000
6,10,9,-1,2,267000,90000,357000
13,11,13,-1,2,156000,15000,171000
6,10,12,-1,2,237000,45000,282000
12,18,5,-1,2,207000,15000,222000
12,13,16,11,2,234000,90000,324000
11,10,18,-1,2,258000,45000,303000
7,16,9,-1,2,264000,30000,294000
10,12,5,-1,2,237000,45000,282000
10,11,15,-1,2,234000,60000,294000
19,11,5,-1,1,189000,0,189000
15,8,14,-1,2,261000,45000,306000
9,19,6,12,2,306000,295000,601000
18,6,20,-1,2,228000,15000,243000
16,10,9,-1,2,297000,60000,357000
6,20,9,-1,2,210000,15000,225000
14,11,19,-1,2,249000,45000,294000
20,13,19,-1,2,183000,45000,228000
18,19,11,-1,2,195000,45000,240000
14,20,16,11,2,165000,30000,195000
19,8,6,-1,2,255000,15000,270000
8,11,17,-1,2,255000,30000,285000
12,5,10,-1,2,255000,45000,300000
8,5,17,-1,2,219000,15000,234000
8,15,19,-1,2,210000,30000,240000
19,10,9,-1,2,231000,30000,261000
13,19,9,11,2,318000,190000,508000
17,16,11,-1,2,255000,75000,330000
6,16,17,-1,2,240000,30000,270000
7,14,20,-1,2,225000,15000,240000
13,20,11,-1,2,237000,30000,267000
19,16,13,-1,2,231000,45000,276000
11,9,14,-1,2,285000,45000,330000
20,10,14,12,2,261000,190000,451000
10,7,20,-1,1,180000,0,180000
10,18,6,-1,2,234000,15000,249000
20,11,18,-1,2,192000,30000,222000
17,8,8,-1,1,126000,0,126000
9,15,12,-1,2,240000,45000,285000
16,14,17,-1,2,204000,90000,294000
19,11,18,12,2,294000,245000,539000
11,16,5,-1,2,228000,30000,258000
8,15,16,-1,2,225000,45000,270000
10,16,13,-1,2,249000,45000,294000
8,14,19,-1,2,219000,30000,249000
7,15,17,-1,2,237000,15000,252000
9,8,10,-1,2,279000,90000,369000
8,9,6,12,2,300000,300000,600000
15,15,19,-1,2,153000,15000,168000
8,16,11,-1,2,276000,45000,321000
19,9,8,-1,2,213000,30000,243000
18,10,7,-1,2,237000,15000,252000
6,9,17,-1,2,246000,15000,261000
8,12,18,-1,2,243000,30000,273000
8,18,16,11,2,291000,215000,506000
5,18,15,-1,2,255000,15000,270000
18,5,18,-1,1,162000,0,162000
9,16,5,-1,2,225000,15000,240000
15,5,12,-1,2,249000,30000,279000
18,19,6,-1,2,195000,30000,225000
19,17,19,-1,2,165000,15000,180000
18,20,17,12,2,180000,90000,270000
12,18,14,-1,2,240000,45000,285000
9,6,18,-1,2,246000,15000,261000
20,10,7,-1,2,228000,15000,243000
16,6,16,-1,1,180000,0,180000
6,9,7,-1,2,252000,105000,357000
10,14,15,-1,2,210000,75000,285000
11,14,10,13,2,276000,345000,621000
12,19,20,-1,2,165000,30000,195000
16,6,13,-1,2,219000,15000,234000
8,10,12,-1,2,258000,75000,333000
18,5,9,-1,2,207000,15000,222000
14,15,8,-1,2,234000,45000,279000
15,10,16,-1,2,237000,75000,312000
6,17,18,11,2,288000,245000,533000
7,8,14,-1,2,234000,15000,249000
8,12,11,-1,2,240000,90000,330000
14,18,15,-1,2,207000,90000,297000
10,12,11,-1,2,288000,90000,378000
16,14,15,-1,2,216000,90000,306000
15,18,19,-1,2,207000,90000,297000
6,5,14,13,2,300000,240000,540000
8,10,18,-1,2,228000,15000,243000
9,17,11,-1,2,255000,30000,285000
6,7,11,-1,2,270000,60000,330000
14,5,9,-1,2,234000,30000,264000
12,9,6,-1,2,249000,45000,294000
20,19,14,-1,2,150000,75000,225000
5,12,9,13,2,288000,295000,583000
5,18,8,-1,2,276000,30000,306000
20,17,6,-1,2,201000,15000,216000
16,15,18,-1,2,231000,105000,336000
19,12,8,-1,1,180000,0,180000
15,11,9,-1,2,267000,45000,312000
11,17,10,-1,2,243000,60000,303000
15,11,19,13,2,249000,250000,499000
12,11,19,-1,2,231000,45000,276000
5,17,14,-1,2,246000,15000,261000
10,17,19,-1,2,213000,30000,243000
5,6,14,-1,2,294000,45000,339000
20,13,10,-1,2,210000,30000,240000
16,11,15,-1,2,237000,75000,312000
16,8,12,13,2,276000,345000,621000
15,17,16,-1,2,195000,90000,285000
17,12,20,-1,2,183000,15000,198000
18,20,10,-1,2,228000,15000,243000
15,12,20,-1,2,258000,45000,303000
18,17,10,-1,2,243000,45000,288000
19,20,7,-1,2,210000,30000,240000
5,15,8,12,2,288000,145000,433000
13,14,6,-1,2,261000,45000,306000
18,8,6,-1,2,219000,15000,234000
18,14,7,-1,2,219000,30000,249000
20,14,15,-1,2,225000,60000,285000
6,19,9,-1,2,264000,15000,279000
13,15,19,-1,2,222000,45000,267000
18,19,5,12,2,285000,245000,530000
17,8,9,-1,2,249000,45000,294000
11,12,20,-1,2,222000,45000,267000
16,20,17,-1,2,192000,90000,282000
14,11,15,-1,2,231000,90000,321000
17,11,10,-1,2,270000,60000,330000
19,5,13,-1,1,189000,0,189000
14,9,19,12,2,297000,220000,517000
15,14,18,-1,2,210000,30000,240000
18,17,5,-1,2,231000,30000,261000
11,13,15,-1,2,258000,75000,333000
11,13,10,-1,2,261000,105000,366000
11,15,18,-1,2,219000,45000,264000
5,18,6,-1,2,258000,30000,288000
15,13,18,11,2,213000,45000,258000
13,16,17,-1,2,240000,90000,330000
5,20,14,-1,1,216000,0,216000
8,16,15,-1,2,270000,45000,315000
18,12,14,-1,2,231000,45000,276000
6,7,12,-1,2,288000,60000,348000
14,6,12,-1,2,222000,30000,252000
8,6,17,11,2,297000,310000,607000
13,11,15,-1,2,258000,75000,333000
13,11,8,-1,2,267000,75000,342000
17,16,5,-1,2,213000,30000,243000
14,9,5,-1,2,270000,30000,300000
17,9,12,-1,2,231000,45000,276000
16,20,10,-1,2,192000,30000,222000
19,16,5,11,2,327000,185000,512000
15,19,12,-1,2,258000,45000,303000
19,6,9,-1,2,255000,15000,270000
18,8,9,-1,2,231000,30000,261000
18,12,13,-1,2,252000,60000,312000
9,16,5,-1,2,243000,15000,258000
10,15,20,-1,2,216000,30000,246000
7,13,16,12,2,288000,265000,553000
9,8,7,-1,2,246000,45000,291000
20,19,16,-1,2,132000,75000,207000
19,8,16,-1,2,228000,15000,243000
13,11,16,-1,2,258000,45000,303000
17,5,9,-1,2,234000,15000,249000
9,18,16,-1,2,213000,30000,243000
18,19,8,11,2,285000,200000,485000
17,19,7,-1,2,183000,15000,198000
14,17,8,-1,2,249000,30000,279000
14,6,19,-1,2,234000,15000,249000
18,13,17,-1,2,210000,75000,285000
14,6,5,-1,2,306000,60000,366000
12,19,18,-1,2,168000,45000,213000
13,7,17,12,2,276000,220000,496000
14,15,13,-1,2,252000,90000,342000
13,17,18,-1,2,228000,75000,303000
13,8,12,-1,2,282000,75000,357000
17,20,16,-1,2,165000,90000,255000
13,20,15,-1,2,213000,45000,258000
18,8,17,-1,2,240000,30000,270000
14,6,18,13,2,276000,265000,541000
6,7,16,-1,2,240000,30000,270000
17,12,9,-1,2,249000,45000,294000
18,14,12,-1,2,222000,45000,267000
7,8,13,-1,2,288000,60000,348000
14,16,10,-1,2,210000,45000,255000
5,13,14,-1,2,258000,30000,288000
20,16,19,11,2,141000,75000,216000
7,17,20,-1,2,219000,15000,234000
14,11,5,-1,2,291000,45000,336000
14,9,16,-1,2,219000,45000,264000
11,9,16,-1,2,249000,45000,294000
14,8,13,-1,2,237000,75000,312000
8,20,19,-1,2,174000,30000,204000
16,17,13,11,2,207000,45000,252000
9,8,10,-1,2,288000,90000,378000
15,9,14,-1,2,219000,75000,294000
20,5,6,-1,2,222000,30000,252000
10,12,17,-1,2,258000,45000,303000
17,7,11,-1,2,243000,30000,273000
7,13,9,-1,2,249000,45000,294000
11,20,12,13,2,240000,300000,540000
12,13,11,-1,2,243000,90000,333000
9,7,13,-1,2,267000,45000,312000
19,10,15,-1,2,198000,30000,228000
5,17,15,-1,2,237000,15000,252000
7,20,13,-1,2,216000,15000,231000
20,8,7,-1,2,240000,30000,270000
11,20,16,12,2,288000,160000,448000
10,16,8,-1,2,216000,15000,231000
17,5,12,-1,2,216000,15000,231000
18,8,13,-1,2,234000,30000,264000
15,17,6,-1,2,219000,15000,234000
17,10,16,-1,2,225000,45000,270000
16,9,13,-1,2,264000,45000,309000
5,14,9,11,2,297000,330000,627000
18,7,9,-1,2,246000,15000,261000
6,12,18,-1,2,225000,15000,240000
13,11,8,-1,2,267000,75000,342000
14,16,11,-1,2,222000,75000,297000
6,18,14,-1,2,234000,15000,249000
16,15,17,-1,2,204000,90000,294000
5,19,7,12,2,276000,140000,416000
20,13,7,-1,2,225000,15000,240000
5,20,11,-1,1,207000,0,207000
12,18,5,-1,2,252000,15000,267000
5,20,15,-1,2,207000,15000,222000
14,12,20,-1,2,228000,30000,258000
9,14,15,-1,2,264000,75000,339000
10,5,8,12,2,306000,285000,591000
9,13,19,-1,2,243000,30000,273000
20,19,18,-1,2,141000,60000,201000
17,14,8,-1,2,258000,30000,288000
5,9,18,-1,2,243000,15000,258000
12,10,19,-1,2,228000,30000,258000
18,14,15,-1,2,225000,90000,315000
13,18,19,13,2,285000,245000,530000
19,19,17,-1,2,129000,15000,144000
7,12,18,-1,2,234000,15000,249000
18,15,6,-1,2,237000,15000,252000
13,17,7,-1,2,237000,30000,267000
17,13,11,-1,2,240000,45000,285000
5,20,19,-1,2,192000,30000,222000
14,15,9,12,2,276000,180000,456000
9,6,11,-1,2,294000,75000,369000
18,9,8,-1,2,204000,30000,234000
12,14,16,-1,2,240000,75000,315000
12,16,15,-1,2,240000,90000,330000
16,18,5,-1,2,237000,15000,252000
7,5,15,-1,2,255000,15000,270000
11,18,20,13,2,240000,215000,455000
5,12,18,-1,2,225000,15000,240000
17,10,8,-1,2,246000,30000,276000
14,15,11,-1,2,222000,90000,312000
8,14,11,-1,2,276000,45000,321000
18,20,9,-1,2,183000,15000,198000
17,10,19,-1,2,240000,30000,270000
17,6,11,13,2,294000,315000,609000
18,10,13,-1,2,198000,15000,213000
18,19,12,-1,2,195000,45000,240000
15,13,14,-1,2,219000,45000,264000
18,11,16,-1,2,228000,45000,273000
16,14,17,-1,2,222000,90000,312000
13,14,16,-1,2,261000,105000,366000
9,12,6,13,2,324000,295000,619000
6,16,18,-1,2,246000,15000,261000
6,17,16,-1,2,240000,30000,270000
5,12,19,-1,1,207000,0,207000
12,10,18,-1,2,255000,30000,285000
12,6,9,-1,2,276000,45000,321000
20,15,17,-1,2,165000,45000,210000
7,5,13,12,2,288000,175000,463000
16,17,13,-1,2,222000,90000,312000
15,11,9,-1,2,285000,45000,330000
18,6,10,-1,2,207000,15000,222000
10,20,11,-1,2,213000,30000,243000
19,8,6,-1,2,255000,15000,270000
10,16,15,-1,2,237000,75000,312000
7,13,8,11,2,315000,370000,685000
10,15,5,-1,2,279000,30000,309000
19,16,14,-1,2,186000,45000,231000
8,11,6,-1,2,294000,45000,339000
9,15,16,-1,2,207000,45000,252000
13,17,12,-1,2,252000,60000,312000
13,19,15,-1,2,231000,45000,276000
8,16,9,13,2,312000,225000,537000
12,7,14,-1,2,291000,45000,336000
16,9,12,-1,2,231000,45000,276000
16,10,18,-1,2,204000,30000,234000
13,12,6,-1,2,279000,45000,324000
17,5,19,-1,2,192000,15000,207000
11,18,19,-1,2,222000,45000,267000
11,15,12,13,2,267000,315000,582000
7,6,9,-1,2,306000,105000,411000
20,8,9,-1,2,204000,30000,234000
16,10,15,-1,2,246000,75000,321000
15,17,13,-1,2,222000,75000,297000
13,15,17,-1,2,240000,75000,315000
17,9,14,-1,2,264000,45000,309000
9,13,8,12,2,297000,370000,667000
13,18,12,-1,2,270000,60000,330000
20,12,11,-1,2,249000,45000,294000
9,6,12,-1,2,285000,45000,330000
10,5,13,-1,2,237000,45000,282000
11,10,18,-1,2,222000,45000,267000
20,14,8,-1,2,207000,15000,222000
6,18,5,12,2,327000,180000,507000
12,13,17,-1,2,252000,60000,312000
6,16,10,-1,2,270000,30000,300000
12,9,7,-1,2,240000,45000,285000
6,13,20,-1,1,162000,0,162000
9,7,5,-1,2,297000,120000,417000
7,15,14,-1,2,225000,45000,270000
12,16,13,13,2,225000,145000,370000
15,9,10,-1,2,279000,60000,339000
17,15,7,-1,2,210000,15000,225000
19,8,14,-1,2,219000,30000,249000
17,9,13,-1,2,255000,45000,300000
16,13,20,-1,2,213000,45000,258000
13,9,9,-1,2,207000,15000,222000
18,7,9,13,2,267000,195000,462000
19,11,8,-1,2,246000,15000,261000
11,7,16,-1,2,270000,30000,300000
16,17,10,-1,2,207000,45000,252000
5,6,14,-1,2,294000,45000,339000
20,7,13,-1,2,189000,15000,204000
10,16,12,-1,2,258000,45000,303000
11,7,19,12,2,279000,300000,579000
16,14,5,-1,2,210000,15000,225000
13,16,7,-1,2,231000,30000,261000
17,20,13,-1,2,210000,45000,255000
18,16,13,-1,2,249000,75000,324000
15,20,5,-1,2,243000,15000,258000
12,15,20,-1,2,240000,45000,285000
9,17,8,13,2,312000,210000,522000
18,13,12,-1,2,270000,60000,330000
18,10,12,-1,2,246000,30000,276000
10,11,5,-1,2,264000,75000,339000
6,12,11,-1,2,237000,75000,312000
14,19,17,-1,2,174000,75000,249000
18,10,20,-1,2,174000,15000,189000
12,20,15,12,2,306000,175000,481000
14,17,11,-1,2,213000,30000,243000
9,11,8,-1,2,279000,105000,384000
13,10,7,-1,2,249000,45000,294000
12,10,15,-1,2,222000,45000,267000
19,14,8,-1,2,210000,30000,240000
9,5,11,-1,2,273000,45000,318000
9,6,12,11,2,279000,345000,624000
16,19,8,-1,2,237000,15000,252000
11,7,17,-1,2,270000,30000,300000
16,14,18,-1,2,195000,75000,270000
12,18,5,-1,2,252000,15000,267000
8,5,9,-1,2,276000,90000,366000
17,13,20,-1,2,183000,45000,228000
17,6,10,13,2,312000,340000,652000
18,16,11,-1,2,192000,15000,207000
11,14,20,-1,2,237000,30000,267000
15,16,7,-1,2,258000,30000,288000
18,17,11,-1,2,216000,45000,261000
5,7,20,-1,2,249000,30000,279000
12,15,8,-1,2,264000,45000,309000
19,10,16,12,2,261000,190000,451000
16,5,10,-1,1,198000,0,198000
11,16,13,-1,2,231000,45000,276000
11,5,16,-1,2,246000,30000,276000
12,9,18,-1,2,228000,30000,258000
6,13,15,-1,2,249000,30000,279000
12,10,20,-1,2,183000,15000,198000
8,5,12,13,2,330000,285000,615000
13,6,16,-1,2,267000,30000,297000
8,5,10,-1,2,267000,75000,342000
15,9,18,-1,2,195000,30000,225000
12,18,11,-1,2,270000,60000,330000
14,15,17,-1,2,225000,105000,330000
13,7,10,-1,2,303000,45000,348000
13,13,18,11,2,135000,15000,150000
19,11,7,-1,2,207000,15000,222000
10,5,15,-1,2,270000,30000,300000
20,8,18,-1,2,174000,15000,189000
8,14,16,-1,2,258000,30000,288000
6,11,19,-1,2,225000,15000,240000
18,7,16,-1,2,219000,15000,234000
12,6,7,11,2,321000,280000,601000
11,14,5,-1,2,267000,30000,297000
11,17,19,-1,2,186000,30000,216000
13,15,9,-1,2,273000,45000,318000
8,7,15,-1,2,267000,45000,312000
9,19,16,-1,2,195000,30000,225000
18,7,18,-1,1,171000,0,171000
13,14,11,12,2,270000,255000,525000
11,5,6,-1,2,243000,15000,258000
6,15,9,-1,2,246000,30000,276000
17,8,10,-1,2,228000,30000,258000
12,15,9,-1,2,240000,45000,285000
11,15,14,-1,2,231000,90000,321000
18,20,15,-1,2,189000,75000,264000
19,5,9,11,2,297000,270000,567000
6,10,15,-1,2,279000,30000,309000
15,19,20,-1,2,141000,75000,216000
18,19,7,-1,2,204000,30000,234000
9,19,10,-1,2,249000,30000,279000
18,10,11,-1,2,267000,45000,312000
18,16,17,-1,2,183000,90000,273000
12,16,17,11,2,210000,75000,285000
16,9,18,-1,2,240000,30000,270000
15,6,7,-1,2,285000,45000,330000
18,12,9,-1,2,219000,30000,249000
15,9,6,-1,2,273000,30000,303000
6,12,5,-1,2,252000,60000,312000
19,20,5,-1,2,165000,30000,195000
20,15,5,11,2,273000,130000,403000
5,11,12,-1,2,288000,45000,333000
7,19,20,-1,2,165000,30000,195000
6,17,10,-1,1,198000,0,198000
16,12,8,-1,2,246000,45000,291000
20,8,15,-1,2,189000,15000,204000
5,19,11,-1,1,216000,0,216000
19,16,18,11,2,189000,90000,279000
17,14,15,-1,2,216000,105000,321000
14,11,8,-1,2,294000,45000,339000
7,14,11,-1,2,246000,45000,291000
13,12,7,-1,2,237000,75000,312000
19,7,8,-1,2,213000,30000,243000
5,20,19,-1,2,192000,30000,222000
8,11,18,13,2,273000,155000,428000
9,16,13,-1,2,264000,45000,309000
19,11,17,-1,2,195000,30000,225000
18,12,20,-1,2,210000,30000,240000
6,13,20,-1,1,171000,0,171000
16,14,6,-1,2,255000,15000,270000
8,9,12,-1,2,270000,90000,360000
15,12,14,11,2,204000,90000,294000
20,11,15,-1,2,225000,30000,255000
11,16,17,-1,2,246000,75000,321000
18,20,12,-1,2,192000,30000,222000
14,5,13,-1,2,231000,30000,261000
7,9,13,-1,2,249000,45000,294000
14,17,9,-1,2,219000,45000,264000
11,19,5,13,2,267000,300000,567000
10,7,18,-1,1,189000,0,189000
11,17,16,-1,2,228000,75000,303000
18,5,15,-1,2,237000,15000,252000
14,13,6,-1,2,270000,45000,315000
12,13,14,-1,2,225000,90000,315000
12,15,16,-1,2,240000,90000,330000
17,9,11,12,2,306000,315000,621000
11,9,10,-1,2,246000,45000,291000
20,17,13,-1,2,183000,45000,228000
9,16,9,-1,1,189000,0,189000
15,14,7,-1,2,234000,45000,279000
17,15,19,-1,2,183000,75000,258000
16,8,17,-1,2,204000,30000,234000
10,8,15,12,2,306000,330000,636000
11,7,17,-1,2,279000,30000,309000
9,15,13,-1,2,228000,45000,273000
8,16,5,-1,2,237000,15000,252000
5,10,16,-1,2,225000,15000,240000
20,17,18,-1,2,153000,90000,243000
12,19,17,-1,2,228000,45000,273000
11,14,15,13,2,276000,255000,531000
18,8,6,-1,2,228000,15000,243000
11,18,20,-1,2,183000,30000,213000
13,17,18,-1,2,186000,30000,216000
10,5,13,-1,2,282000,45000,327000
11,16,14,-1,2,213000,75000,288000
15,6,9,-1,2,282000,30000,312000
13,17,15,12,2,195000,75000,270000
20,12,8,-1,2,225000,15000,240000
18,8,7,-1,2,258000,30000,288000
17,16,7,-1,2,231000,30000,261000
16,19,8,-1,2,228000,15000,243000
8,17,11,-1,2,273000,30000,303000
6,7,15,-1,2,267000,45000,312000
10,5,20,12,2,270000,270000,540000
8,14,20,-1,2,234000,15000,249000
16,14,6,-1,2,255000,15000,270000
20,7,19,-1,2,183000,30000,213000
18,6,12,-1,1,180000,0,180000
8,13,12,-1,2,264000,75000,339000
12,9,5,-1,2,246000,45000,291000
6,18,20,13,2,231000,215000,446000
10,8,19,-1,2,210000,15000,225000
10,10,11,-1,2,204000,30000,234000
15,18,9,-1,2,195000,30000,225000
7,13,11,-1,2,282000,45000,327000
7,18,6,-1,2,222000,30000,252000
20,16,19,-1,2,150000,75000,225000
7,17,6,11,2,321000,180000,501000
17,8,19,-1,2,219000,15000,234000
9,13,8,-1,2,297000,60000,357000
16,18,8,-1,2,192000,15000,207000
8,18,10,-1,2,228000,15000,243000
16,7,6,-1,2,258000,30000,288000
15,13,6,-1,2,240000,30000,270000
6,15,16,12,2,261000,195000,456000
19,10,12,-1,2,198000,15000,213000
6,11,8,-1,2,267000,45000,312000
18,7,16,-1,2,192000,15000,207000
9,11,16,-1,2,267000,45000,312000
9,17,11,-1,2,228000,30000,258000
18,6,20,-1,2,192000,15000,207000
12,10,18,11,2,327000,235000,562000
17,10,14,-1,2,264000,45000,309000
12,17,14,-1,2,231000,45000,276000
6,18,7,-1,2,258000,30000,288000
16,10,11,-1,2,252000,60000,312000
6,8,5,-1,2,270000,105000,375000
19,17,16,-1,2,156000,105000,261000
14,17,12,11,2,222000,45000,267000
18,19,11,-1,2,213000,45000,258000
7,17,8,-1,2,216000,0,216000
7,11,12,-1,2,246000,75000,321000
20,10,5,-1,2,189000,15000,204000
13,18,19,-1,2,207000,75000,282000
10,6,5,-1,2,237000,30000,267000
6,13,14,11,2,273000,225000,498000
19,18,10,-1,2,240000,30000,270000
13,12,16,-1,2,270000,90000,360000
18,6,11,-1,2,234000,15000,249000
11,7,20,-1,2,216000,15000,231000
18,17,11,-1,2,225000,45000,270000
13,10,11,-1,2,288000,105000,393000
20,12,8,13,2,258000,300000,558000
13,6,8,-1,2,258000,45000,303000
19,7,5,-1,2,201000,15000,216000
19,7,17,-1,2,210000,15000,225000
7,5,19,-1,2,246000,15000,261000
12,11,19,-1,2,240000,45000,285000
5,11,17,-1,2,243000,15000,258000
8,5,12,11,2,306000,370000,676000
20,12,13,-1,2,249000,45000,294000
10,9,17,-1,2,276000,45000,321000
5,12,16,-1,2,237000,30000,267000
7,10,6,-1,2,261000,90000,351000
18,5,19,-1,2,186000,30000,216000
13,7,15,-1,2,267000,30000,297000
5,12,9,13,2,297000,295000,592000
14,13,5,-1,2,288000,45000,333000
9,8,9,-1,2,177000,30000,207000
9,10,19,-1,2,195000,30000,225000
6,11,14,-1,2,282000,45000,327000
15,19,10,-1,2,198000,30000,228000
14,17,20,-1,2,210000,45000,255000
6,5,14,13,2,279000,175000,454000
20,11,18,-1,2,201000,30000,231000
10,15,17,-1,2,192000,15000,207000
6,5,19,-1,2,240000,30000,270000
7,9,13,-1,2,267000,45000,312000
10,18,20,-1,2,174000,15000,189000
15,16,6,-1,2,267000,30000,297000
11,9,16,11,2,252000,155000,407000
6,19,14,-1,2,216000,15000,231000
16,6,5,-1,2,258000,30000,288000
14,7,9,-1,2,249000,45000,294000
17,6,9,-1,2,210000,15000,225000
19,15,9,-1,2,210000,30000,240000
9,7,17,-1,2,246000,15000,261000
7,8,12,11,2,315000,370000,685000
17,18,8,-1,2,240000,30000,270000
5,12,10,-1,2,282000,45000,327000
7,8,18,-1,2,213000,30000,243000
17,15,14,-1,2,225000,105000,330000
16,5,19,-1,2,246000,15000,261000
11,16,10,-1,2,279000,60000,339000
15,7,16,13,2,249000,225000,474000
8,17,6,-1,2,228000,15000,243000
19,10,20,-1,2,183000,30000,213000
15,14,5,-1,2,222000,30000,252000
16,20,9,-1,2,201000,30000,231000
14,12,16,-1,2,249000,75000,324000
12,14,11,-1,2,261000,105000,366000
18,6,19,12,2,267000,245000,512000
9,16,12,-1,2,240000,45000,285000
14,7,18,-1,2,219000,30000,249000
8,11,10,-1,2,267000,90000,357000
10,12,6,-1,2,237000,45000,282000
12,9,13,-1,2,231000,90000,321000
13,14,20,-1,2,225000,60000,285000
5,14,18,12,2,297000,250000,547000
5,8,15,-1,1,207000,0,207000
13,8,7,-1,2,261000,60000,321000
8,14,20,-1,2,180000,15000,195000
5,14,8,-1,2,291000,30000,321000
13,11,20,-1,2,201000,30000,231000
5,10,15,-1,2,270000,30000,300000
7,16,20,12,2,252000,160000,412000
8,20,12,-1,1,180000,0,180000
11,5,9,-1,2,273000,45000,318000
11,15,8,-1,2,240000,45000,285000
20,13,5,-1,1,180000,0,180000
16,19,10,-1,2,231000,30000,261000
11,16,17,-1,2,255000,75000,330000
12,15,7,11,2,309000,265000,574000
15,10,11,-1,2,288000,60000,348000
17,13,14,-1,2,225000,90000,315000
15,10,8,-1,2,285000,45000,330000
20,7,5,-1,2,192000,15000,207000
17,18,8,-1,2,231000,30000,261000
12,19,7,-1,2,234000,15000,249000
8,5,11,12,2,324000,295000,619000
16,14,7,-1,2,258000,30000,288000
13,9,17,-1,2,237000,45000,282000
9,16,20,-1,2,201000,30000,231000
8,10,7,-1,2,297000,105000,402000
16,20,11,-1,2,189000,30000,219000
10,8,15,-1,2,285000,45000,330000
8,7,6,12,2,309000,310000,619000
18,8,12,-1,2,243000,30000,273000
15,14,11,-1,2,231000,90000,321000
12,15,8,-1,2,264000,45000,309000
7,13,20,-1,2,198000,15000,213000
17,5,12,-1,2,243000,15000,258000
11,8,20,-1,2,210000,15000,225000
16,12,18,11,2,237000,45000,282000
10,5,13,-1,2,282000,45000,327000
19,16,10,-1,2,186000,30000,216000
17,13,9,-1,2,273000,45000,318000
11,17,13,-1,2,231000,45000,276000
7,15,11,-1,2,264000,45000,309000
8,16,13,-1,2,228000,45000,273000
18,19,16,11,2,153000,90000,243000
11,7,15,-1,2,255000,45000,300000
20,14,9,-1,2,171000,15000,186000
14,11,18,-1,2,267000,45000,312000
6,13,20,-1,1,198000,0,198000
6,15,13,-1,2,276000,30000,306000
12,6,15,-1,2,231000,30000,261000
8,12,14,11,2,291000,280000,571000
15,19,17,-1,2,219000,75000,294000
10,18,6,-1,1,198000,0,198000
20,9,15,-1,2,201000,30000,231000
16,15,8,-1,2,261000,45000,306000
5,13,17,-1,2,234000,15000,249000
13,14,5,-1,2,249000,30000,279000
6,12,9,13,2,288000,295000,583000
6,13,15,-1,2,276000,30000,306000
12,20,10,-1,2,183000,15000,198000
10,11,6,-1,2,291000,75000,366000
17,10,15,-1,2,210000,45000,255000
19,13,6,-1,2,225000,15000,240000
6,7,19,-1,2,240000,30000,270000
6,19,9,12,2,306000,295000,601000
5,17,19,-1,2,237000,15000,252000
9,20,13,-1,2,216000,15000,231000
18,13,16,-1,2,249000,75000,324000
12,8,13,-1,2,282000,75000,357000
5,9,19,-1,2,207000,15000,222000
19,12,14,-1,2,231000,45000,276000
20,6,11,13,2,285000,285000,570000
6,18,20,-1,2,174000,15000,189000
15,20,9,-1,2,237000,30000,267000
13,6,16,-1,2,267000,30000,297000
7,15,9,-1,2,255000,30000,285000
16,18,8,-1,2,192000,15000,207000
17,5,9,-1,2,243000,15000,258000
12,8,19,11,2,291000,205000,496000
16,13,7,-1,2,267000,30000,297000
16,19,14,-1,2,213000,45000,258000
15,11,6,-1,2,288000,30000,318000
15,14,9,-1,2,219000,75000,294000
16,15,12,-1,2,222000,90000,312000
15,10,19,-1,2,243000,30000,273000
19,18,19,12,2,150000,30000,180000
15,17,8,-1,2,258000,30000,288000
9,7,19,-1,2,228000,15000,243000
13,10,19,-1,2,237000,30000,267000
13,18,9,-1,2,243000,30000,273000
13,8,11,-1,2,267000,75000,342000
16,12,7,-1,2,234000,30000,264000
14,12,10,11,2,282000,280000,562000
13,9,20,-1,2,225000,15000,240000
12,17,11,-1,2,279000,60000,339000
11,20,16,-1,2,216000,30000,246000
18,13,5,-1,2,252000,15000,267000
5,15,18,-1,2,219000,15000,234000
10,13,17,-1,2,258000,45000,303000
12,18,5,11,2,300000,235000,535000
17,14,11,-1,2,267000,45000,312000
11,8,5,-1,2,285000,45000,330000
17,18,7,-1,2,195000,30000,225000
6,7,8,-1,2,297000,90000,387000
9,19,7,-1,2,201000,15000,216000
17,15,17,-1,2,156000,15000,171000
5,17,13,11,2,300000,250000,550000
7,19,11,-1,2,243000,15000,258000
6,7,16,-1,2,258000,30000,288000
16,12,11,-1,2,243000,60000,303000
10,5,16,-1,2,234000,15000,249000
10,15,6,-1,2,252000,30000,282000
15,7,14,-1,2,225000,45000,270000
11,6,10,13,2,300000,310000,610000
19,18,17,-1,2,189000,75000,264000
16,9,7,-1,2,273000,30000,303000
7,10,8,-1,2,252000,105000,357000
12,10,19,-1,2,210000,30000,240000
11,7,20,-1,2,216000,15000,231000
9,14,16,-1,2,255000,45000,300000
14,7,16,11,2,291000,235000,526000
6,14,19,-1,2,252000,15000,267000
8,12,13,-1,2,255000,75000,330000
8,14,12,-1,2,237000,45000,282000
19,16,20,-1,2,141000,75000,216000
8,6,15,-1,2,273000,30000,303000
14,5,9,-1,2,234000,30000,264000
6,19,14,11,2,273000,175000,448000
12,15,17,-1,2,258000,75000,333000
11,14,17,-1,2,258000,45000,303000
7,16,12,-1,2,261000,30000,291000
9,7,16,-1,2,246000,30000,276000
14,5,18,-1,2,198000,15000,213000
12,16,20,-1,2,219000,45000,264000
19,11,15,12,2,297000,205000,502000
19,12,13,-1,2,216000,15000,231000
6,16,19,-1,2,219000,15000,234000
19,16,19,-1,2,165000,15000,180000
5,8,11,-1,2,294000,45000,339000
5,15,13,-1,2,219000,15000,234000
17,15,7,-1,2,210000,15000,225000
8,7,5,12,2,336000,310000,646000
17,20,19,-1,2,150000,75000,225000
11,12,14,-1,2,261000,105000,366000
16,10,12,-1,2,249000,45000,294000
15,5,18,-1,2,219000,15000,234000
14,6,18,-1,2,234000,15000,249000
19,5,14,-1,2,225000,15000,240000
5,17,7,13,2,300000,170000,470000
7,14,10,-1,2,294000,45000,339000
6,20,19,-1,2,165000,30000,195000
7,8,10,-1,2,246000,30000,276000
20,12,14,-1,2,192000,30000,222000
18,16,11,-1,2,246000,45000,291000
12,14,19,-1,2,240000,45000,285000
11,19,6,13,2,285000,300000,585000
14,10,8,-1,2,228000,30000,258000
10,14,13,-1,2,222000,90000,312000
6,19,13,-1,2,225000,15000,240000
10,16,20,-1,2,201000,30000,231000
15,16,11,-1,2,255000,75000,330000
6,19,11,-1,2,234000,15000,249000
12,11,13,11,2,300000,255000,555000
20,12,13,-1,2,258000,45000,303000
8,11,12,-1,2,285000,90000,375000
14,16,6,-1,2,219000,15000,234000
5,19,13,-1,1,189000,0,189000
9,11,6,-1,2,294000,75000,369000
15,10,6,-1,2,234000,30000,264000
14,10,9,13,2,258000,370000,628000
9,17,5,-1,1,207000,0,207000
10,14,7,-1,2,258000,45000,303000
12,6,8,-1,2,240000,45000,285000
11,8,15,-1,2,240000,45000,285000
12,6,5,-1,2,261000,60000,321000
10,5,12,-1,2,237000,45000,282000
6,13,12,11,2,273000,255000,528000
19,14,12,-1,2,258000,45000,303000
18,17,12,-1,2,228000,75000,303000
15,7,11,-1,2,282000,45000,327000
16,5,12,-1,2,219000,30000,249000
13,9,19,-1,2,216000,30000,246000
6,5,17,-1,2,258000,30000,288000
12,18,14,13,2,240000,265000,505000
10,18,17,-1,2,216000,45000,261000
6,16,12,-1,2,255000,30000,285000
10,16,7,-1,2,255000,30000,285000
11,20,15,-1,2,198000,30000,228000
5,7,15,-1,2,264000,15000,279000
7,10,12,-1,2,258000,75000,333000
9,15,19,13,2,231000,250000,481000
18,6,19,-1,2,204000,30000,234000
20,18,8,-1,2,228000,15000,243000
10,13,12,-1,2,276000,90000,366000
16,5,19,-1,2,210000,15000,225000
10,20,5,-1,2,234000,15000,249000
5,19,18,-1,2,222000,30000,252000
10,5,8,12,2,342000,285000,627000
5,9,11,-1,2,273000,45000,318000
9,7,18,-1,2,201000,15000,216000
8,16,20,-1,2,207000,15000,222000
7,11,6,-1,2,297000,60000,357000
13,12,17,-1,2,216000,60000,276000
16,13,18,-1,2,231000,75000,306000
12,18,19,11,2,222000,45000,267000
13,5,12,-1,2,240000,30000,270000
18,10,12,-1,2,210000,30000,240000
19,7,9,-1,2,228000,15000,243000
8,16,17,-1,2,231000,30000,261000
7,17,14,-1,2,249000,30000,279000
19,8,5,-1,2,237000,15000,252000
5,16,9,12,2,306000,340000,646000
19,7,16,-1,2,246000,15000,261000
7,11,8,-1,2,297000,90000,387000
8,20,9,-1,2,204000,30000,234000
17,10,9,-1,2,267000,45000,312000
12,8,9,-1,2,270000,90000,360000
17,7,16,-1,2,204000,30000,234000
15,13,19,12,2,231000,45000,276000
19,11,13,-1,2,246000,30000,276000
20,16,10,-1,2,210000,30000,240000
10,19,20,-1,2,219000,30000,249000
18,5,10,-1,1,198000,0,198000
5,18,13,-1,2,225000,15000,240000
13,5,10,-1,2,255000,45000,300000
13,17,8,11,2,273000,250000,523000
17,12,11,-1,2,279000,60000,339000
11,18,13,-1,2,240000,45000,285000
13,5,8,-1,2,276000,45000,321000
18,6,5,-1,2,222000,30000,252000
12,13,10,-1,2,240000,90000,330000
13,19,20,-1,2,165000,45000,210000
14,13,18,11,2,225000,60000,285000
15,11,6,-1,2,279000,30000,309000
12,11,13,-1,2,225000,90000,315000
5,15,13,-1,2,246000,15000,261000
5,17,15,-1,2,210000,15000,225000
15,12,8,-1,2,255000,45000,300000
14,5,8,-1,2,255000,30000,285000
13,18,20,12,2,171000,45000,216000
8,15,13,-1,2,210000,15000,225000
19,11,5,-1,1,180000,0,180000
13,14,17,-1,2,252000,90000,342000
16,14,11,-1,2,258000,75000,333000
18,16,14,-1,2,222000,75000,297000
16,14,19,-1,2,240000,45000,285000
8,14,12,13,2,294000,360000,654000
20,12,17,-1,2,210000,45000,255000
17,18,16,-1,2,201000,90000,291000
17,11,15,-1,2,219000,45000,264000
19,6,5,-1,2,249000,30000,279000
12,19,13,-1,2,243000,60000,303000
10,15,5,-1,2,270000,30000,300000
14,5,12,12,2,216000,160000,376000
18,17,10,-1,2,225000,45000,270000
6,16,8,-1,2,255000,15000,270000
15,12,19,-1,2,222000,45000,267000
5,17,15,-1,2,246000,15000,261000
13,5,17,-1,2,234000,15000,249000
15,16,10,-1,2,228000,75000,303000
17,14,7,13,2,258000,265000,523000
9,15,14,-1,2,237000,75000,312000
13,6,11,-1,2,255000,45000,300000
19,18,11,-1,2,177000,45000,222000
8,17,14,-1,2,201000,15000,216000
18,5,7,-1,2,237000,15000,252000
6,18,11,-1,2,216000,15000,231000
8,16,6,11,2,315000,325000,640000
20,6,18,-1,2,219000,15000,234000
10,11,8,-1,2,294000,90000,384000
14,18,9,-1,2,207000,30000,237000
16,17,19,-1,2,183000,105000,288000
12,11,20,-1,2,231000,45000,276000
8,12,14,-1,2,264000,45000,309000
17,12,20,13,2,240000,190000,430000
19,10,12,-1,2,228000,30000,258000
9,5,17,-1,2,234000,15000,249000
18,8,7,-1,2,231000,30000,261000
5,14,10,-1,2,261000,30000,291000
18,5,13,-1,2,207000,15000,222000
15,18,9,-1,2,213000,30000,243000
20,10,17,12,2,297000,185000,482000
10,7,20,-1,1,180000,0,180000
9,15,7,-1,2,273000,30000,303000
6,15,19,-1,2,189000,15000,204000
13,10,15,-1,2,258000,75000,333000
16,12,13,-1,2,243000,90000,333000
6,16,10,-1,2,270000,30000,300000
20,11,18,12,2,240000,215000,455000
8,5,18,-1,2,228000,15000,243000
10,16,14,-1,2,228000,45000,273000
7,20,15,-1,2,216000,15000,231000
11,15,9,-1,2,267000,45000,312000
7,19,18,-1,2,195000,30000,225000
16,20,15,-1,2,231000,60000,291000
12,16,9,13,2,276000,300000,576000
11,12,14,-1,2,279000,105000,384000
17,10,12,-1,2,249000,45000,294000
11,12,8,-1,2,258000,90000,348000
12,9,5,-1,2,246000,45000,291000
8,16,13,-1,2,228000,45000,273000
16,10,9,-1,2,252000,60000,312000
8,14,6,13,2,285000,280000,565000
16,12,18,-1,2,237000,45000,282000
8,5,7,-1,2,285000,90000,375000
9,15,6,-1,2,246000,30000,276000
8,14,9,-1,2,252000,60000,312000
12,8,17,-1,2,216000,30000,246000
6,14,12,-1,2,240000,30000,270000
5,11,8,13,2,297000,285000,582000
11,5,9,-1,2,282000,45000,327000
15,9,19,-1,2,183000,30000,213000
13,15,18,-1,2,240000,45000,285000
10,18,6,-1,2,243000,15000,258000
11,13,16,-1,2,240000,45000,285000
7,19,16,-1,2,219000,15000,234000
11,16,19,13,2,276000,235000,511000
19,18,16,-1,2,162000,90000,252000
14,8,17,-1,2,222000,30000,252000
9,12,17,-1,2,267000,45000,312000
11,6,14,-1,2,255000,45000,300000
7,5,14,-1,2,237000,30000,267000
17,15,20,-1,2,165000,45000,210000
12,15,17,13,2,267000,205000,472000
11,18,9,-1,2,273000,30000,303000
15,7,19,-1,2,207000,15000,222000
20,15,18,-1,2,189000,75000,264000
8,19,20,-1,2,183000,30000,213000
7,18,10,-1,1,189000,0,189000
19,13,19,-1,1,126000,0,126000
13,17,12,13,2,252000,130000,382000
12,15,19,-1,2,240000,45000,285000
13,5,7,-1,2,282000,30000,312000
9,7,12,-1,2,240000,45000,285000
16,7,10,-1,2,237000,30000,267000
5,10,17,-1,2,216000,15000,231000
15,14,16,-1,2,216000,90000,306000
14,10,9,12,2,324000,345000,669000
15,17,14,-1,2,252000,105000,357000
9,10,14,-1,2,297000,60000,357000
8,19,7,-1,2,222000,30000,252000
9,5,16,-1,2,234000,15000,249000
17,11,18,-1,2,207000,45000,252000
15,12,10,-1,2,276000,45000,321000
16,10,17,13,2,249000,195000,444000
11,19,6,-1,2,216000,15000,231000
9,10,14,-1,2,270000,60000,330000
5,17,6,-1,2,240000,30000,270000
11,14,16,-1,2,222000,75000,297000
6,9,16,-1,2,282000,30000,312000
15,5,13,-1,2,219000,15000,234000
5,10,15,12,2,279000,330000,609000
9,10,5,-1,2,294000,120000,414000
13,11,20,-1,2,201000,30000,231000
6,19,12,-1,2,234000,15000,249000
20,7,15,-1,2,216000,15000,231000
13,17,12,-1,2,252000,60000,312000
7,14,18,-1,2,237000,30000,267000
10,15,13,11,2,300000,250000,550000
8,7,19,-1,2,267000,30000,297000
8,9,15,-1,2,279000,60000,339000
11,9,14,-1,2,231000,45000,276000
12,19,14,-1,2,213000,45000,258000
11,20,10,-1,2,222000,30000,252000
16,10,18,-1,2,240000,30000,270000
16,5,6,12,2,327000,170000,497000
5,13,19,-1,1,207000,0,207000
8,11,7,-1,2,297000,90000,387000
17,7,16,-1,2,204000,30000,234000
12,16,11,-1,2,261000,60000,321000
16,5,7,-1,2,246000,15000,261000
15,6,20,-1,2,198000,15000,213000
8,20,11,13,2,285000,285000,570000
17,18,15,-1,2,189000,45000,234000
15,8,9,-1,2,306000,60000,366000
10,14,13,-1,2,222000,90000,312000
16,6,14,-1,2,237000,15000,252000
11,12,8,-1,2,258000,90000,348000
15,8,12,-1,2,237000,45000,282000
11,12,7,11,2,234000,175000,409000
5,16,17,-1,2,222000,30000,252000
20,19,7,-1,2,201000,30000,231000
11,8,12,-1,2,243000,45000,288000
10,8,14,-1,2,240000,45000,285000
15,20,19,-1,2,141000,75000,216000
7,12,14,-1,2,255000,45000,300000
14,14,7,12,2,216000,160000,376000
13,16,20,-1,2,222000,45000,267000
15,11,8,-1,2,294000,45000,339000
10,7,15,-1,2,258000,45000,303000
7,19,7,-1,1,117000,0,117000
12,8,18,-1,2,243000,30000,273000
9,13,10,-1,2,261000,90000,351000
17,5,9,11,2,288000,300000,588000
19,6,13,-1,2,243000,15000,258000
13,8,15,-1,2,255000,45000,300000
8,10,12,-1,2,249000,75000,324000
5,13,12,-1,2,243000,45000,288000
14,11,12,-1,2,225000,105000,330000
5,13,15,-1,2,246000,15000,261000
8,19,5,13,2,285000,180000,465000
19,13,11,-1,2,246000,30000,276000
13,18,10,-1,2,258000,45000,303000
20,18,13,-1,2,198000,45000,243000
13,9,17,-1,2,198000,15000,213000
14,9,20,-1,2,189000,15000,204000
7,20,8,-1,2,258000,30000,288000
15,18,7,11,2,309000,190000,499000
16,7,6,-1,2,276000,30000,306000
14,10,7,-1,2,267000,45000,312000
17,20,15,-1,2,165000,45000,210000
13,5,14,-1,2,231000,30000,261000
20,12,11,-1,2,222000,45000,267000
20,12,18,-1,2,192000,30000,222000
12,18,16,13,2,267000,190000,457000
8,18,5,-1,2,276000,30000,306000
9,7,17,-1,2,219000,15000,234000
14,8,20,-1,2,207000,15000,222000
17,8,11,-1,2,273000,30000,303000
7,15,13,-1,2,231000,30000,261000
5,16,9,-1,2,225000,15000,240000
12,14,16,11,2,222000,75000,297000
16,15,8,-1,2,252000,45000,297000
8,16,12,-1,2,255000,45000,300000
11,19,10,-1,2,231000,45000,276000
15,10,16,-1,2,237000,75000,312000
20,8,6,-1,2,219000,15000,234000
6,20,5,-1,2,240000,30000,270000
5,14,7,13,2,309000,240000,549000
16,8,20,-1,2,225000,15000,240000
11,20,19,-1,2,210000,30000,240000
17,12,9,-1,2,207000,15000,222000
12,6,13,-1,2,252000,45000,297000
20,9,6,-1,2,210000,15000,225000
15,16,13,-1,2,231000,90000,321000
17,19,7,12,2,297000,215000,512000
19,13,12,-1,2,216000,15000,231000
6,9,15,-1,2,273000,30000,303000
8,15,11,-1,2,240000,45000,285000
20,13,6,-1,1,171000,0,171000
18,13,6,-1,2,252000,15000,267000
11,14,9,-1,2,258000,45000,303000
14,8,9,12,2,288000,370000,658000
9,5,17,-1,2,264000,30000,294000
13,18,16,-1,2,213000,75000,288000
8,17,20,-1,2,237000,15000,252000
5,9,17,-1,2,264000,30000,294000
6,9,18,-1,2,228000,15000,243000
15,16,17,-1,2,204000,90000,294000
11,8,9,12,2,291000,280000,571000
13,6,8,-1,2,276000,45000,321000
18,17,14,-1,2,174000,90000,264000
6,19,16,-1,2,192000,15000,207000
6,20,5,-1,2,249000,30000,279000
12,18,6,-1,2,234000,15000,249000
14,15,18,-1,2,225000,90000,315000
8,13,11,12,2,315000,360000,675000
8,13,20,-1,1,171000,0,171000
9,18,15,-1,2,240000,30000,270000
13,16,17,-1,2,240000,90000,330000
10,8,7,-1,2,306000,105000,411000
9,10,14,-1,2,243000,60000,303000
6,13,12,-1,2,243000,45000,288000
17,15,12,11,2,213000,75000,288000
15,8,20,-1,2,225000,15000,240000
19,18,16,-1,2,189000,90000,279000
11,6,12,-1,2,255000,75000,330000
11,7,5,-1,2,240000,45000,285000
14,5,20,-1,1,162000,0,162000
8,19,20,-1,2,219000,30000,249000
9,5,11,12,2,291000,280000,571000
9,13,7,-1,2,276000,45000,321000
20,9,8,-1,2,204000,30000,234000
19,8,11,-1,2,228000,15000,243000
17,16,14,-1,2,231000,90000,321000
11,20,10,-1,2,240000,30000,270000
12,20,19,-1,2,210000,45000,255000
5,20,8,11,2,297000,295000,592000
20,18,17,-1,2,180000,90000,270000
7,20,6,-1,2,240000,30000,270000
16,14,7,-1,2,249000,30000,279000
11,13,17,-1,2,231000,45000,276000
8,5,20,-1,2,228000,15000,243000
13,15,8,-1,2,264000,45000,309000
12,17,18,13,2,240000,220000,460000
15,17,16,-1,2,195000,90000,285000
18,16,15,-1,2,201000,30000,231000
18,17,13,-1,2,228000,75000,303000
20,11,7,-1,2,243000,15000,258000
12,8,11,-1,2,276000,90000,366000
11,14,6,-1,2,246000,45000,291000
5,18,19,11,2,249000,200000,449000
15,9,11,-1,2,219000,30000,249000
12,8,14,-1,2,237000,45000,282000
13,7,14,-1,2,234000,45000,279000
6,11,10,-1,2,255000,75000,330000
15,5,12,-1,2,231000,30000,261000
17,20,7,-1,2,192000,15000,207000
15,10,18,12,2,306000,235000,541000
17,11,14,-1,2,213000,30000,243000
10,6,13,-1,2,264000,45000,309000
5,20,10,-1,2,189000,15000,204000
12,18,9,-1,2,255000,30000,285000
9,6,11,-1,2,276000,75000,351000
19,5,16,-1,2,192000,15000,207000
16,19,9,12,2,297000,190000,487000
20,18,12,-1,2,174000,15000,189000
8,7,19,-1,2,267000,30000,297000
13,19,8,-1,2,207000,15000,222000
9,13,19,-1,2,252000,30000,282000
10,19,9,-1,2,222000,30000,252000
14,19,7,-1,2,234000,15000,249000
17,9,5,13,2,303000,210000,513000
12,18,5,-1,2,252000,15000,267000
5,11,14,-1,2,258000,30000,288000
7,11,12,-1,2,246000,75000,321000
17,11,13,-1,2,213000,45000,258000
7,12,19,-1,2,216000,15000,231000
5,9,7,-1,2,276000,75000,351000
5,17,8,11,2,288000,310000,598000
7,19,5,-1,2,246000,15000,261000
17,9,14,-1,2,246000,45000,291000
6,10,9,-1,2,267000,90000,357000
12,17,14,-1,2,204000,45000,249000
9,18,17,-1,2,231000,30000,261000
11,9,16,-1,2,276000,45000,321000
12,5,13,12,2,225000,175000,400000
18,20,7,-1,2,201000,15000,216000
11,16,6,-1,2,288000,30000,318000
11,19,9,-1,2,183000,15000,198000
12,9,6,-1,2,294000,45000,339000
5,17,7,-1,2,219000,15000,234000
6,12,18,-1,2,207000,15000,222000
19,9,20,11,2,264000,200000,464000
15,16,20,-1,2,186000,60000,246000
11,8,6,-1,2,240000,30000,270000
8,11,9,-1,2,252000,105000,357000
19,18,17,-1,2,135000,75000,210000
20,12,10,-1,2,210000,15000,225000
19,14,7,-1,2,243000,15000,258000
7,19,17,11,2,297000,215000,512000
18,9,5,-1,1,189000,0,189000
10,8,19,-1,2,210000,15000,225000
13,9,19,-1,2,243000,30000,273000
13,20,16,-1,2,222000,45000,267000
7,20,18,-1,2,228000,15000,243000
14,20,17,-1,2,228000,45000,273000
6,9,11,12,2,291000,280000,571000
13,11,15,-1,2,249000,75000,324000
13,14,17,-1,2,234000,90000,324000
12,14,15,-1,2,249000,90000,339000
5,18,16,-1,2,228000,15000,243000
10,17,9,-1,2,267000,45000,312000
12,10,5,-1,2,255000,45000,300000
19,6,7,11,2,285000,205000,490000
19,8,9,-1,2,240000,30000,270000
9,17,12,-1,2,267000,45000,312000
6,5,18,-1,2,240000,30000,270000
15,11,7,-1,2,255000,45000,300000
11,14,6,-1,2,237000,45000,282000
9,14,7,-1,2,240000,45000,285000
20,5,6,13,2,270000,165000,435000
12,17,20,-1,2,237000,45000,282000
13,13,18,-1,2,180000,15000,195000
13,14,19,-1,2,225000,60000,285000
7,15,14,-1,2,270000,45000,315000
15,13,20,-1,2,213000,45000,258000
8,18,11,-1,2,273000,30000,303000
14,13,19,12,2,225000,60000,285000
5,19,17,-1,2,228000,15000,243000
6,19,9,-1,2,255000,15000,270000
16,17,8,-1,2,231000,30000,261000
19,15,14,-1,2,234000,60000,294000
10,9,8,-1,2,306000,90000,396000
14,17,19,-1,2,174000,75000,249000
20,12,6,13,2,276000,255000,531000
7,10,18,-1,2,255000,15000,270000
10,7,18,-1,2,237000,15000,252000
6,9,15,-1,2,282000,30000,312000
14,17,5,-1,2,210000,15000,225000
13,19,11,-1,2,228000,30000,258000
19,15,14,-1,2,234000,60000,294000
13,8,16,11,2,327000,250000,577000
17,20,20,-1,2,165000,15000,180000
11,17,12,-1,2,279000,60000,339000
8,6,12,-1,2,267000,45000,312000
13,15,10,-1,2,222000,75000,297000
19,10,16,-1,2,213000,30000,243000
20,5,9,-1,2,246000,30000,276000
5,19,16,12,2,288000,190000,478000
20,5,16,-1,2,180000,15000,195000
18,5,19,-1,2,231000,30000,261000
14,10,7,-1,2,303000,45000,348000
20,8,9,-1,2,204000,30000,234000
14,20,9,-1,2,207000,15000,222000
11,5,10,-1,2,291000,75000,366000
11,19,9,13,2,249000,300000,549000
17,20,14,-1,2,174000,30000,204000
15,6,11,-1,2,216000,15000,231000
9,15,11,-1,2,231000,45000,276000
9,12,8,-1,2,261000,90000,351000
12,19,14,-1,2,204000,45000,249000
16,6,11,-1,2,270000,30000,300000
13,9,19,12,2,252000,235000,487000
5,19,6,-1,2,207000,0,207000
5,19,8,-1,2,237000,15000,252000
10,6,17,-1,2,225000,15000,240000
9,8,20,-1,2,231000,30000,261000
12,6,15,-1,2,258000,30000,288000
6,8,12,-1,2,258000,45000,303000
6,16,19,13,2,231000,235000,466000
17,19,13,-1,2,201000,45000,246000
6,15,13,-1,2,276000,30000,306000
14,9,6,-1,2,258000,45000,303000
16,17,10,-1,2,198000,45000,243000
9,12,16,-1,2,276000,45000,321000
9,10,8,-1,2,270000,90000,360000
9,17,20,12,2,252000,185000,437000
7,15,10,-1,2,225000,15000,240000
19,13,14,-1,2,207000,60000,267000
5,7,10,-1,2,285000,45000,330000
7,5,16,-1,2,219000,15000,234000
20,9,19,-1,2,174000,30000,204000
10,17,19,-1,2,183000,15000,198000
8,9,13,11,2,324000,345000,669000
8,16,7,-1,2,294000,45000,339000
14,20,13,-1,2,207000,60000,267000
16,10,14,-1,2,255000,45000,300000
18,15,19,-1,2,180000,90000,270000
14,19,20,-1,2,168000,75000,243000
16,7,18,-1,2,201000,15000,216000
16,17,7,11,2,309000,245000,554000
10,13,14,-1,2,276000,90000,366000
17,12,6,-1,2,237000,30000,267000
13,12,16,-1,2,234000,90000,324000
20,8,12,-1,2,216000,15000,231000
8,12,18,-1,2,261000,30000,291000
10,13,14,-1,2,240000,90000,330000
14,12,7,11,2,300000,280000,580000
13,17,20,-1,2,237000,45000,282000
8,18,7,-1,2,267000,30000,297000
20,20,19,-1,2,120000,30000,150000
13,20,17,-1,2,183000,15000,198000
12,7,6,-1,2,306000,60000,366000
15,11,12,-1,2,225000,90000,315000
17,19,8,12,2,279000,215000,494000
18,14,12,-1,2,192000,30000,222000
17,8,5,-1,2,255000,15000,270000
11,12,17,-1,2,243000,60000,303000
6,9,15,-1,2,273000,30000,303000
11,5,19,-1,1,171000,0,171000
14,6,13,-1,2,279000,45000,324000
20,6,17,12,2,261000,185000,446000
5,14,17,-1,2,210000,15000,225000
20,9,14,-1,2,198000,15000,213000
8,6,13,-1,2,294000,45000,339000
14,19,13,-1,2,207000,60000,267000
12,9,14,-1,2,276000,75000,351000
13,16,15,-1,2,213000,90000,303000
20,6,15,11,2,318000,160000,478000
17,12,20,-1,2,246000,45000,291000
12,20,11,-1,2,258000,45000,303000
20,19,8,-1,2,201000,30000,231000
17,15,18,-1,2,189000,45000,234000
9,11,17,-1,2,273000,30000,303000
19,18,17,-1,2,153000,75000,228000
14,8,18,13,2,267000,265000,532000
8,15,16,-1,2,234000,45000,279000
15,8,10,-1,2,267000,45000,312000
5,12,16,-1,2,219000,30000,249000
11,9,17,-1,2,228000,30000,258000
10,7,14,-1,2,267000,45000,312000
12,11,8,-1,2,240000,90000,330000
17,13,14,12,2,216000,90000,306000
12,15,10,-1,2,267000,45000,312000
8,14,6,-1,2,255000,30000,285000
7,12,17,-1,2,225000,30000,255000
8,13,8,-1,2,162000,15000,177000
7,18,8,-1,2,213000,30000,243000
16,19,9,-1,2,222000,30000,252000
13,15,9,12,2,297000,280000,577000
15,20,16,-1,2,201000,30000,231000
13,11,19,-1,2,246000,30000,276000
13,5,19,-1,1,207000,0,207000
14,20,10,-1,2,243000,30000,273000
8,10,17,-1,2,264000,30000,294000
17,13,10,-1,2,231000,45000,276000
7,9,14,11,2,306000,330000,636000
13,10,17,-1,2,267000,45000,312000
9,18,7,-1,2,228000,15000,243000
8,6,16,-1,2,237000,15000,252000
16,11,18,-1,2,219000,45000,264000
6,7,13,-1,2,288000,60000,348000
6,9,18,-1,2,210000,15000,225000
13,5,9,12,2,306000,370000,676000
19,9,8,-1,2,258000,30000,288000
13,10,11,-1,2,270000,105000,375000
16,7,18,-1,2,210000,15000,225000
13,19,9,-1,2,243000,30000,273000
18,8,11,-1,2,255000,30000,285000
11,19,9,-1,2,201000,15000,216000
14,13,7,11,2,318000,225000,543000
16,5,7,-1,2,276000,30000,306000
11,10,19,-1,2,231000,45000,276000
11,8,20,-1,2,219000,15000,234000
16,8,6,-1,2,255000,15000,270000
16,19,12,-1,2,210000,45000,255000
16,12,7,-1,2,270000,30000,300000
6,14,8,11,2,297000,355000,652000
16,6,8,-1,2,255000,15000,270000
19,17,13,-1,2,201000,45000,246000
7,17,5,-1,2,276000,30000,306000
9,6,11,-1,2,258000,75000,333000
10,8,12,-1,2,240000,75000,315000
16,13,9,-1,2,219000,45000,264000
5,13,16,11,2,291000,250000,541000
10,7,15,-1,2,303000,45000,348000
16,11,18,-1,2,201000,45000,246000
8,18,14,-1,2,228000,30000,258000
7,13,9,-1,2,276000,45000,321000
17,18,20,-1,2,135000,90000,225000
6,10,9,-1,2,285000,90000,375000
6,12,8,13,2,276000,285000,561000
7,17,10,-1,2,282000,30000,312000
13,12,9,-1,2,240000,90000,330000
20,7,9,-1,2,210000,15000,225000
11,7,8,-1,2,288000,90000,378000
12,6,20,-1,1,162000,0,162000
5,6,13,-1,2,306000,60000,366000
7,15,16,11,2,273000,220000,493000
15,6,18,-1,2,255000,15000,270000
6,14,13,-1,2,270000,45000,315000
15,20,10,-1,2,207000,30000,237000
15,19,9,-1,2,219000,30000,249000
10,16,9,-1,2,288000,60000,348000
14,11,5,-1,2,240000,30000,270000
18,7,12,11,2,282000,235000,517000
20,8,13,-1,2,234000,15000,249000
7,9,8,-1,2,297000,90000,387000
5,6,7,-1,2,252000,90000,342000
14,19,8,-1,2,192000,30000,222000
16,12,17,-1,2,228000,75000,303000
17,16,7,-1,2,249000,30000,279000
20,12,9,11,2,309000,205000,514000
12,20,17,-1,2,246000,45000,291000
16,8,12,-1,2,273000,45000,318000
6,14,15,-1,2,231000,30000,261000
16,11,17,-1,2,219000,75000,294000
17,8,19,-1,2,219000,15000,234000
6,15,19,-1,2,234000,15000,249000
8,17,10,11,2,318000,315000,633000
7,19,16,-1,2,246000,15000,261000
14,10,5,-1,2,279000,30000,309000
11,7,18,-1,2,189000,15000,204000
8,17,12,-1,2,252000,30000,282000
6,8,16,-1,2,228000,15000,243000
17,5,19,-1,2,201000,15000,216000
6,5,18,11,2,339000,205000,544000
20,16,18,-1,2,171000,75000,246000
10,14,11,-1,2,252000,90000,342000
5,9,7,-1,2,258000,75000,333000
17,20,9,-1,2,183000,15000,198000
12,10,11,-1,2,288000,90000,378000
20,9,5,-1,2,207000,15000,222000
9,14,7,12,2,315000,370000,685000
16,13,20,-1,2,249000,45000,294000
12,17,6,-1,2,264000,30000,294000
6,12,17,-1,2,228000,30000,258000
7,17,8,-1,2,231000,30000,261000
16,10,9,-1,2,270000,60000,330000
17,12,19,-1,2,201000,45000,246000
8,12,15,11,2,318000,265000,583000
15,19,13,-1,2,249000,45000,294000
13,18,16,-1,2,240000,75000,315000
13,17,7,-1,2,255000,30000,285000
8,20,11,-1,2,219000,15000,234000
8,13,9,-1,2,297000,60000,357000
8,16,7,-1,2,249000,45000,294000
13,8,5,12,2,276000,280000,556000
13,9,14,-1,2,264000,75000,339000
16,17,19,-1,2,174000,105000,279000
17,11,19,-1,2,195000,30000,225000
19,8,10,-1,2,246000,15000,261000
5,16,12,-1,2,255000,30000,285000
16,12,15,-1,2,213000,90000,303000
9,20,5,12,2,324000,295000,619000
10,12,14,-1,2,276000,75000,351000
8,14,13,-1,2,246000,75000,321000
15,7,11,-1,2,246000,45000,291000
14,10,15,-1,2,210000,75000,285000
20,9,6,-1,2,228000,15000,243000
18,19,20,-1,2,150000,60000,210000
9,12,5,13,2,333000,295000,628000
11,6,20,-1,2,243000,15000,258000
15,19,10,-1,2,234000,30000,264000
18,11,16,-1,2,237000,45000,282000
16,11,20,-1,2,225000,30000,255000
18,10,12,-1,2,255000,30000,285000
15,5,11,-1,2,246000,30000,276000
6,17,16,11,2,282000,245000,527000
13,5,19,-1,2,252000,15000,267000
12,15,5,-1,2,258000,30000,288000
7,12,8,-1,2,261000,60000,321000
9,15,14,-1,2,219000,75000,294000
6,5,17,-1,2,249000,30000,279000
19,14,11,-1,2,222000,45000,267000
7,5,17,11,2,321000,180000,501000
10,7,5,-1,2,276000,45000,321000
8,9,6,-1,2,240000,90000,330000
8,18,16,-1,2,192000,15000,207000
12,10,20,-1,2,210000,15000,225000
20,19,9,-1,2,219000,30000,249000
20,8,16,-1,2,180000,15000,195000
13,8,6,12,2,321000,280000,601000
8,6,17,-1,2,255000,15000,270000
8,5,10,-1,2,267000,75000,342000
5,7,14,-1,2,237000,30000,267000
9,12,13,-1,2,231000,90000,321000
6,18,8,-1,2,228000,15000,243000
6,11,12,-1,2,255000,75000,330000
10,17,7,13,2,258000,340000,598000
17,19,12,-1,2,183000,15000,198000
16,9,19,-1,2,240000,30000,270000
6,17,9,-1,2,255000,15000,270000
17,19,8,-1,2,210000,15000,225000
11,14,9,-1,2,276000,45000,321000
13,14,17,-1,2,216000,90000,306000
5,6,8,12,2,351000,215000,566000
6,15,17,-1,2,219000,15000,234000
6,18,5,-1,2,249000,30000,279000
11,18,14,-1,2,231000,45000,276000
15,6,16,-1,2,249000,30000,279000
7,9,11,-1,2,267000,75000,342000
19,12,13,-1,2,216000,60000,276000
13,9,14,12,2,288000,255000,543000
20,6,16,-1,2,180000,15000,195000
6,14,7,-1,2,294000,45000,339000
6,20,11,-1,2,189000,15000,204000
15,13,11,-1,2,249000,75000,324000
10,13,7,-1,2,276000,45000,321000
8,17,13,-1,2,216000,30000,246000
9,7,14,12,2,297000,370000,667000
13,17,20,-1,2,237000,45000,282000
13,5,10,-1,2,291000,45000,336000
13,8,16,-1,2,228000,45000,273000
19,17,13,-1,2,192000,45000,237000
5,17,13,-1,2,264000,30000,294000
20,16,14,-1,2,204000,45000,249000
17,13,9,13,2,261000,130000,391000
20,13,19,-1,2,183000,45000,228000
19,12,16,-1,2,210000,45000,255000
13,18,11,-1,2,258000,45000,303000
5,11,6,-1,2,279000,60000,339000
18,5,10,-1,2,207000,15000,222000
13,9,6,-1,2,267000,45000,312000
17,5,11,11,2,225000,155000,380000
18,9,8,-1,2,222000,30000,252000
9,11,15,-1,2,267000,45000,312000
20,10,5,-1,2,198000,15000,213000
10,20,19,-1,2,201000,30000,231000
19,20,7,-1,2,165000,30000,195000
16,12,5,-1,2,216000,15000,231000
14,5,9,12,2,288000,370000,658000
19,10,18,-1,2,240000,30000,270000
20,5,16,-1,2,234000,15000,249000
7,18,8,-1,2,258000,30000,288000
7,16,16,-1,1,171000,0,171000
18,9,13,-1,2,207000,30000,237000
7,16,5,-1,2,246000,15000,261000
10,18,12,11,2,282000,235000,517000
10,14,13,-1,2,276000,90000,366000
9,17,6,-1,2,237000,15000,252000
10,5,13,-1,2,264000,45000,309000
5,16,7,-1,2,219000,15000,234000
16,6,7,-1,2,231000,30000,261000
14,10,5,-1,2,252000,30000,282000
15,6,9,11,2,279000,315000,594000
15,17,8,-1,2,249000,30000,279000
14,16,6,-1,2,237000,15000,252000
13,17,5,-1,2,225000,15000,240000
12,11,9,-1,2,249000,90000,339000
12,9,15,-1,2,240000,45000,285000
14,10,12,-1,2,240000,75000,315000
15,12,10,13,2,258000,360000,618000
11,5,6,-1,2,270000,60000,330000
16,15,18,-1,2,177000,105000,282000
8,5,16,-1,1,207000,0,207000
7,8,15,-1,2,258000,45000,303000
10,20,14,-1,2,198000,30000,228000
9,11,7,-1,2,276000,75000,351000
12,20,7,13,2,240000,300000,540000
5,6,11,-1,2,270000,60000,330000
11,15,20,-1,2,189000,30000,219000
9,8,19,-1,2,249000,30000,279000
17,16,9,-1,2,243000,45000,288000
11,5,19,-1,1,207000,0,207000
7,8,12,-1,2,297000,60000,357000
14,8,7,12,2,276000,265000,541000
8,17,12,-1,2,261000,30000,291000
9,18,9,-1,1,144000,0,144000
11,15,7,-1,2,255000,45000,300000
13,20,9,-1,2,171000,15000,186000
13,18,17,-1,2,237000,75000,312000
16,11,17,-1,2,255000,75000,330000
12,10,13,11,2,309000,255000,564000
8,11,7,-1,2,306000,90000,396000
18,13,19,-1,2,171000,75000,246000
11,10,14,-1,2,237000,30000,267000
10,20,6,-1,2,189000,15000,204000
18,5,10,-1,2,243000,15000,258000
7,5,8,-1,2,258000,90000,348000
13,9,6,12,2,279000,370000,649000
14,9,6,-1,2,303000,45000,348000
6,20,7,-1,2,204000,30000,234000
20,7,18,-1,2,210000,15000,225000
14,9,11,-1,2,285000,45000,330000
9,8,10,-1,2,261000,90000,351000
11,6,12,-1,2,237000,75000,312000
9,7,11,12,2,279000,295000,574000
20,19,14,-1,2,195000,75000,270000
16,9,8,-1,2,249000,45000,294000
15,19,14,-1,2,207000,60000,267000
9,16,7,-1,2,291000,30000,321000
14,15,18,-1,2,198000,90000,288000
9,5,14,-1,2,291000,45000,336000
9,7,10,11,2,291000,400000,691000
16,15,7,-1,2,258000,30000,288000
15,6,16,-1,2,240000,30000,270000
20,18,7,-1,2,201000,15000,216000
17,13,9,-1,2,273000,45000,318000
8,6,20,-1,2,210000,15000,225000
5,18,20,-1,2,210000,15000,225000
9,17,14,11,2,327000,235000,562000
14,10,6,-1,2,291000,45000,336000
13,10,15,-1,2,222000,75000,297000
12,6,8,-1,2,267000,45000,312000
10,12,9,-1,2,243000,105000,348000
20,14,18,-1,2,171000,45000,216000
14,12,17,-1,2,204000,30000,234000
11,20,16,12,2,288000,160000,448000
12,5,16,-1,2,216000,15000,231000
18,6,19,-1,2,195000,30000,225000
10,7,17,-1,2,291000,30000,321000
17,7,5,-1,2,228000,15000,243000
8,14,16,-1,2,213000,30000,243000
11,6,8,-1,2,267000,45000,312000
7,5,13,11,2,285000,265000,550000
6,8,18,-1,2,246000,15000,261000
19,11,8,-1,2,210000,15000,225000
19,10,18,-1,2,231000,30000,261000
15,5,14,-1,2,276000,30000,306000
12,11,8,-1,2,258000,90000,348000
13,5,19,-1,1,180000,0,180000
14,10,19,11,2,318000,175000,493000
12,10,7,-1,2,303000,75000,378000
20,15,16,-1,2,177000,60000,237000
12,20,6,-1,1,180000,0,180000
13,10,5,-1,2,273000,45000,318000
15,6,9,-1,2,246000,30000,276000
5,17,6,-1,2,231000,30000,261000
7,15,16,11,2,282000,220000,502000
10,18,13,-1,2,276000,45000,321000
11,13,5,-1,2,258000,30000,288000
19,20,15,-1,2,141000,75000,216000
5,6,7,-1,2,270000,90000,360000
15,11,18,-1,2,201000,45000,246000
8,5,12,-1,2,285000,45000,330000
13,20,19,11,2,147000,45000,192000
20,19,9,-1,2,183000,30000,213000
13,20,5,-1,1,171000,0,171000
17,9,8,-1,2,285000,45000,330000
9,8,14,-1,2,261000,60000,321000
19,5,12,-1,1,171000,0,171000
18,15,8,-1,2,249000,30000,279000
15,14,11,12,2,288000,225000,513000
19,17,13,-1,2,183000,15000,198000
7,13,12,-1,2,282000,75000,357000
7,16,17,-1,2,204000,30000,234000
17,6,13,-1,2,246000,30000,276000
11,13,8,-1,2,258000,75000,333000
9,8,18,-1,2,213000,30000,243000
15,17,13,11,2,231000,75000,306000
20,5,14,-1,1,207000,0,207000
7,11,5,-1,2,297000,60000,357000
5,15,9,-1,2,234000,30000,264000
15,20,18,-1,2,153000,75000,228000
8,14,5,-1,2,264000,30000,294000
19,9,16,-1,2,195000,30000,225000
20,5,17,11,2,306000,185000,491000
7,13,9,-1,2,219000,30000,249000
10,13,5,-1,2,237000,45000,282000
14,9,10,-1,2,243000,60000,303000
5,7,18,-1,2,219000,15000,234000
19,16,7,-1,2,210000,15000,225000
13,16,18,-1,2,240000,75000,315000
7,10,15,13,2,312000,370000,682000
12,17,19,-1,2,183000,15000,198000
16,7,5,-1,2,264000,15000,279000
13,18,8,-1,2,225000,30000,255000
6,16,17,-1,2,222000,30000,252000
9,19,13,-1,2,243000,30000,273000
9,10,12,-1,2,270000,105000,375000
14,11,12,13,2,249000,360000,609000
5,19,10,-1,2,216000,15000,231000
12,8,16,-1,2,255000,45000,300000
12,10,17,-1,2,231000,45000,276000
7,5,12,-1,2,258000,45000,303000
6,15,12,-1,2,222000,30000,252000
19,9,10,-1,2,213000,30000,243000
12,8,20,13,2,285000,300000,585000
12,17,20,-1,2,210000,45000,255000
5,20,8,-1,2,246000,15000,261000
13,5,6,-1,2,285000,45000,330000
9,12,19,-1,2,219000,30000,249000
15,5,12,-1,2,258000,30000,288000
19,8,14,-1,2,201000,30000,231000
16,15,14,12,2,234000,90000,324000
20,8,17,-1,2,237000,15000,252000
15,18,11,-1,2,255000,45000,300000
15,14,19,-1,2,234000,60000,294000
6,20,6,-1,1,162000,0,162000
19,9,15,-1,2,219000,30000,249000
20,7,11,-1,2,234000,15000,249000
6,18,16,12,2,288000,220000,508000
8,17,10,-1,2,216000,15000,231000
7,11,10,-1,2,258000,90000,348000
5,19,14,-1,2,198000,15000,213000
16,18,12,-1,2,219000,45000,264000
8,5,16,-1,2,264000,15000,279000
18,9,19,-1,2,204000,30000,234000
17,13,11,13,2,261000,130000,391000
9,6,10,-1,2,285000,90000,375000
8,12,17,-1,2,216000,30000,246000
6,16,5,-1,2,249000,30000,279000
16,10,12,-1,2,231000,45000,276000
15,12,17,-1,2,222000,75000,297000
13,15,14,-1,2,252000,90000,342000
13,19,6,11,2,318000,190000,508000
17,11,20,-1,2,219000,30000,249000
8,20,9,-1,2,198000,0,198000
8,16,10,-1,2,264000,30000,294000
8,12,19,-1,2,189000,15000,204000
13,6,14,-1,2,279000,45000,324000
7,5,18,-1,2,219000,15000,234000
12,20,7,11,2,291000,205000,496000
5,10,20,-1,2,243000,15000,258000
15,18,12,-1,2,240000,45000,285000
16,11,20,-1,2,234000,30000,264000
7,20,13,-1,2,234000,15000,249000
20,8,5,-1,2,237000,15000,252000
8,16,6,-1,2,246000,15000,261000
18,14,16,13,2,204000,75000,279000
10,11,13,-1,2,288000,105000,393000
15,5,20,-1,2,207000,15000,222000
6,9,19,-1,2,246000,15000,261000
16,20,14,-1,2,213000,45000,258000
7,16,8,-1,2,303000,45000,348000
15,11,20,-1,2,189000,30000,219000
