,TrainA,TrainB,TrainC,TrainHC,Crews,Crew Wages,Demurrage Fees,Total Cost
0,14,12,20,-1,2,252000,0,252000
1,12,13,9,-1,2,288000,30000,318000
2,7,18,6,-1,2,255000,15000,270000
3,16,18,6,-1,2,207000,0,207000
4,14,19,10,13,2,348000,105000,453000
5,16,7,8,-1,2,264000,15000,279000
6,15,20,5,-1,1,216000,0,216000
7,18,20,10,-1,2,234000,0,234000
8,9,5,13,-1,2,252000,15000,267000
9,16,15,9,-1,2,219000,15000,234000
10,9,20,15,-1,1,189000,0,189000
11,13,5,15,13,2,312000,45000,357000
12,12,18,13,-1,2,237000,15000,252000
13,17,15,10,-1,2,243000,0,243000
14,7,13,19,-1,1,216000,0,216000
15,15,5,20,-1,1,216000,0,216000
16,20,6,5,-1,2,264000,15000,279000
17,12,5,11,-1,2,255000,15000,270000
18,15,6,17,11,2,324000,30000,354000
19,7,17,11,-1,1,216000,0,216000
20,12,17,7,-1,1,216000,0,216000
21,9,18,13,-1,1,216000,0,216000
22,6,7,19,-1,2,264000,15000,279000
23,7,17,5,-1,2,252000,0,252000
24,19,15,12,-1,2,171000,0,171000
25,20,10,6,12,2,360000,325000,685000
26,12,7,18,-1,1,216000,0,216000
27,9,8,19,-1,2,246000,15000,261000
28,16,19,15,-1,2,198000,15000,213000
29,16,18,10,-1,2,252000,0,252000
30,7,17,10,-1,2,252000,0,252000
31,17,11,10,-1,2,219000,15000,234000
32,18,7,14,11,2,360000,60000,420000
33,5,8,20,-1,2,264000,15000,279000
34,18,16,7,-1,2,252000,0,252000
35,14,16,11,-1,2,222000,0,222000
36,7,14,6,-1,2,264000,15000,279000
37,6,16,12,-1,1,198000,0,198000
38,19,11,18,-1,2,219000,15000,234000
39,7,9,8,13,2,396000,315000,711000
40,7,13,16,-1,2,264000,15000,279000
41,14,13,10,-1,2,249000,15000,264000
42,7,5,6,-1,2,300000,45000,345000
43,14,20,6,-1,1,162000,0,162000
44,7,18,5,-1,2,252000,0,252000
45,14,6,15,-1,2,237000,15000,252000
46,7,17,18,11,2,324000,30000,354000
47,14,11,9,-1,2,288000,15000,303000
48,17,15,6,-1,2,234000,0,234000
49,19,11,12,-1,2,201000,15000,216000
50,18,8,16,-1,2,252000,0,252000
51,20,15,8,-1,1,189000,0,189000
52,11,10,7,-1,2,288000,30000,318000
53,19,7,20,13,2,312000,15000,327000
54,16,13,6,-1,2,276000,30000,306000
55,9,16,20,-1,1,207000,0,207000
56,17,16,19,-1,2,225000,30000,255000
57,12,20,8,-1,1,216000,0,216000
58,13,16,12,-1,2,279000,15000,294000
59,8,13,7,-1,2,264000,15000,279000
60,11,13,14,13,2,300000,75000,375000
61,17,18,7,-1,2,228000,15000,243000
62,5,8,7,-1,2,288000,30000,318000
63,18,15,10,-1,2,162000,0,162000
64,5,20,10,-1,1,216000,0,216000
65,17,18,9,-1,2,255000,15000,270000
66,5,9,6,-1,2,300000,30000,330000
67,17,7,19,12,2,300000,0,300000
68,14,9,10,-1,2,264000,15000,279000
69,10,16,11,-1,2,228000,15000,243000
70,12,19,7,-1,1,216000,0,216000
71,10,7,19,-1,2,252000,0,252000
72,5,13,9,-1,1,216000,0,216000
73,11,9,15,-1,2,216000,0,216000
74,16,12,8,11,2,360000,165000,525000
75,8,12,7,-1,2,312000,45000,357000
76,17,5,7,-1,2,243000,0,243000
77,13,8,5,-1,2,225000,0,225000
78,13,17,11,-1,2,180000,0,180000
79,11,14,9,-1,2,243000,0,243000
80,17,19,6,-1,2,225000,0,225000
81,13,17,19,11,2,348000,45000,393000
82,15,7,6,-1,2,276000,30000,306000
83,6,13,19,-1,1,216000,0,216000
84,20,15,8,-1,1,207000,0,207000
85,17,5,20,-1,2,243000,0,243000
86,8,17,19,-1,2,234000,0,234000
87,20,7,15,-1,1,207000,0,207000
88,16,19,20,11,2,324000,45000,369000
89,7,10,16,-1,2,252000,0,252000
90,18,12,7,-1,1,198000,0,198000
91,6,17,13,-1,1,216000,0,216000
92,13,12,20,-1,2,219000,15000,234000
93,11,14,12,-1,2,270000,30000,300000
94,18,17,19,-1,2,189000,30000,219000
95,13,10,5,13,2,348000,215000,563000
96,13,18,6,-1,1,216000,0,216000
97,19,17,14,-1,2,231000,0,231000
98,6,5,15,-1,2,276000,30000,306000
99,19,15,5,-1,1,207000,0,207000
100,7,14,15,-1,2,264000,15000,279000
101,6,12,13,-1,2,246000,15000,261000
102,16,5,11,13,2,324000,90000,414000
103,13,12,16,-1,2,270000,15000,285000
104,20,7,11,-1,1,216000,0,216000
105,15,14,6,-1,2,264000,15000,279000
106,7,9,14,-1,2,225000,0,225000
107,13,14,18,-1,2,183000,15000,198000
108,15,12,10,-1,2,252000,0,252000
109,13,5,7,12,2,372000,240000,612000
110,11,14,8,-1,2,288000,15000,303000
111,16,9,8,-1,2,237000,15000,252000
112,9,13,20,-1,1,180000,0,180000
113,18,19,8,-1,2,255000,15000,270000
114,7,18,12,-1,1,216000,0,216000
115,14,12,9,-1,2,258000,0,258000
116,15,5,9,13,2,336000,200000,536000
117,5,19,8,-1,2,264000,15000,279000
118,16,8,15,-1,2,264000,15000,279000
119,13,16,19,-1,2,180000,0,180000
120,14,8,9,-1,2,300000,30000,330000
121,18,13,13,-1,1,144000,0,144000
122,6,9,19,-1,2,243000,0,243000
123,10,15,17,11,2,348000,90000,438000
124,11,15,6,-1,2,264000,30000,294000
125,15,19,8,-1,1,198000,0,198000
126,9,11,10,-1,2,279000,30000,309000
127,20,17,15,-1,2,153000,0,153000
128,6,11,14,-1,2,300000,45000,345000
129,11,19,8,-1,2,225000,0,225000
130,20,15,10,13,2,348000,105000,453000
131,18,20,11,-1,2,252000,0,252000
132,7,12,7,-1,1,216000,0,216000
133,7,15,17,-1,2,198000,0,198000
134,7,10,14,-1,2,225000,0,225000
135,16,20,11,-1,1,162000,0,162000
136,20,15,13,-1,2,234000,0,234000
137,7,13,17,11,2,372000,290000,662000
138,14,11,8,-1,2,252000,0,252000
139,8,12,9,-1,2,243000,15000,258000
140,12,8,13,-1,2,219000,15000,234000
141,20,11,17,-1,2,198000,0,198000
142,13,17,8,-1,1,216000,0,216000
143,9,12,5,-1,2,276000,30000,306000
144,5,19,9,11,2,348000,230000,578000
145,11,6,5,-1,2,324000,60000,384000
146,14,17,13,-1,2,189000,15000,204000
147,11,17,20,-1,2,225000,0,225000
148,20,5,16,-1,1,216000,0,216000
149,20,11,7,-1,1,216000,0,216000
150,19,9,18,-1,2,255000,15000,270000
151,18,10,20,12,2,324000,75000,399000
152,17,15,12,-1,2,234000,0,234000
153,16,9,8,-1,2,237000,15000,252000
154,14,6,8,-1,2,243000,0,243000
155,10,5,15,-1,1,198000,0,198000
156,9,16,5,-1,1,216000,0,216000
157,10,8,15,-1,2,225000,0,225000
158,18,12,16,13,2,348000,120000,468000
159,15,20,5,-1,1,216000,0,216000
160,18,6,17,-1,2,264000,15000,279000
161,12,20,18,-1,2,216000,0,216000
162,8,12,9,-1,2,300000,30000,330000
163,10,14,9,-1,2,210000,15000,225000
164,18,7,17,-1,2,237000,15000,252000
165,6,13,14,13,2,300000,45000,345000
166,15,14,11,-1,2,240000,15000,255000
167,16,8,10,-1,2,243000,0,243000
168,9,20,17,-1,2,216000,0,216000
169,6,12,19,-1,1,216000,0,216000
170,18,17,13,-1,2,210000,15000,225000
171,6,7,11,-1,2,312000,45000,357000
172,18,14,9,11,2,336000,75000,411000
173,19,7,5,-1,2,252000,0,252000
174,18,13,12,-1,2,210000,15000,225000
175,7,19,9,-1,2,252000,0,252000
176,10,6,13,-1,2,252000,0,252000
177,6,8,12,-1,2,234000,0,234000
178,9,19,13,-1,1,162000,0,162000
179,13,19,7,12,2,360000,235000,595000
180,6,17,16,-1,2,237000,15000,252000
181,17,11,8,-1,2,225000,0,225000
182,6,9,11,-1,2,276000,0,276000
183,17,9,8,-1,2,210000,15000,225000
184,14,15,9,-1,2,228000,15000,243000
185,7,9,8,-1,2,279000,30000,309000
186,8,16,10,13,2,336000,15000,351000
187,10,9,17,-1,2,255000,15000,270000
188,13,18,10,-1,2,216000,0,216000
189,11,13,7,-1,2,264000,15000,279000
190,5,19,18,-1,2,210000,15000,225000
191,11,19,16,-1,2,216000,0,216000
192,13,10,12,-1,2,267000,15000,282000
193,19,8,14,11,2,360000,105000,465000
194,10,16,14,-1,2,252000,0,252000
195,13,19,17,-1,2,198000,0,198000
196,20,19,5,-1,2,255000,15000,270000
197,9,16,14,-1,2,243000,0,243000
198,12,10,17,-1,2,216000,0,216000
199,7,13,20,-1,1,216000,0,216000
200,19,7,8,11,2,384000,245000,629000
201,12,8,12,-1,1,216000,0,216000
202,12,6,19,-1,1,180000,0,180000
203,7,20,11,-1,1,207000,0,207000
204,6,8,17,-1,2,252000,0,252000
205,15,18,13,-1,2,171000,0,171000
206,19,14,20,-1,2,228000,15000,243000
207,7,16,6,11,2,420000,385000,805000
208,14,17,15,-1,2,261000,30000,291000
209,15,18,11,-1,2,234000,0,234000
210,11,20,7,-1,1,216000,0,216000
211,11,14,5,-1,2,264000,15000,279000
212,11,13,5,-1,2,252000,0,252000
213,5,11,20,-1,1,198000,0,198000
214,17,9,19,12,2,336000,75000,411000
215,6,11,9,-1,2,312000,75000,387000
216,6,14,16,-1,2,243000,0,243000
217,19,6,17,-1,2,198000,0,198000
218,5,13,12,-1,2,264000,15000,279000
219,16,11,13,-1,2,180000,0,180000
220,8,15,19,-1,1,216000,0,216000
221,14,10,17,11,2,372000,165000,537000
222,5,9,17,-1,2,264000,30000,294000
223,20,7,14,-1,1,216000,0,216000
224,19,12,8,-1,1,216000,0,216000
225,10,15,17,-1,2,234000,0,234000
226,8,17,19,-1,2,234000,0,234000
227,6,8,9,-1,2,276000,15000,291000
228,18,15,14,11,2,318000,15000,333000
229,13,11,6,-1,2,264000,15000,279000
230,18,6,10,-1,1,207000,0,207000
231,8,13,17,-1,1,198000,0,198000
232,8,9,18,-1,2,264000,15000,279000
233,5,6,18,-1,2,264000,15000,279000
234,6,11,9,-1,2,240000,0,240000
235,5,12,12,13,2,288000,45000,333000
236,10,15,7,-1,2,234000,0,234000
237,7,13,8,-1,2,246000,15000,261000
238,12,16,9,-1,2,207000,0,207000
239,9,17,19,-1,2,234000,0,234000
240,15,5,12,-1,2,252000,0,252000
241,12,7,6,-1,2,246000,15000,261000
242,14,16,6,11,2,336000,30000,366000
243,14,17,9,-1,2,252000,0,252000
244,7,19,13,-1,1,216000,0,216000
245,10,11,16,-1,2,237000,15000,252000
246,10,7,13,-1,2,252000,0,252000
247,15,6,10,-1,1,207000,0,207000
248,5,12,6,-1,2,264000,15000,279000
249,7,10,14,12,2,348000,105000,453000
250,9,5,17,-1,1,216000,0,216000
251,12,11,20,-1,2,246000,15000,261000
252,5,11,11,-1,1,216000,0,216000
253,7,17,18,-1,2,183000,15000,198000
254,11,5,6,-1,2,264000,15000,279000
255,8,20,19,-1,2,192000,15000,207000
256,5,20,14,12,2,360000,75000,435000
257,7,14,20,-1,1,216000,0,216000
258,13,5,20,-1,1,216000,0,216000
259,9,19,11,-1,2,252000,0,252000
260,9,10,20,-1,2,264000,15000,279000
261,11,7,5,-1,2,252000,0,252000
262,19,5,18,-1,2,201000,15000,216000
263,16,15,5,12,2,360000,120000,480000
264,19,13,17,-1,2,234000,0,234000
265,13,9,20,-1,1,216000,0,216000
266,14,17,16,-1,2,240000,15000,255000
267,13,9,8,-1,2,300000,30000,330000
268,19,5,20,-1,2,192000,15000,207000
269,16,7,5,-1,2,252000,0,252000
270,6,5,20,12,2,360000,155000,515000
271,14,6,19,-1,1,216000,0,216000
272,9,14,5,-1,2,288000,30000,318000
273,15,6,14,-1,2,246000,15000,261000
274,8,16,7,-1,2,228000,15000,243000
275,12,10,18,-1,2,198000,0,198000
276,6,12,18,-1,1,216000,0,216000
277,16,8,14,13,2,348000,120000,468000
278,6,14,11,-1,2,300000,45000,345000
279,14,20,17,-1,2,171000,0,171000
280,9,11,8,-1,2,312000,60000,372000
281,7,19,15,-1,1,198000,0,198000
282,10,16,8,-1,2,243000,0,243000
283,20,19,11,-1,2,210000,15000,225000
284,5,14,12,11,2,372000,280000,652000
285,9,17,11,-1,2,252000,0,252000
286,7,15,18,-1,2,252000,0,252000
287,15,9,20,-1,1,189000,0,189000
288,6,14,17,-1,2,252000,0,252000
289,16,13,10,-1,2,225000,0,225000
290,19,12,15,-1,2,216000,0,216000
291,9,10,11,12,2,384000,365000,749000
292,14,18,6,-1,1,207000,0,207000
293,14,15,18,-1,2,216000,15000,231000
294,9,13,12,-1,2,276000,15000,291000
295,17,20,19,-1,2,168000,15000,183000
296,18,13,11,-1,2,252000,0,252000
297,17,19,11,-1,2,234000,0,234000
298,6,18,5,13,2,384000,170000,554000
299,5,16,10,-1,2,252000,15000,267000
300,5,11,18,-1,1,216000,0,216000
301,18,8,20,-1,2,234000,0,234000
302,19,14,18,-1,2,201000,15000,216000
303,6,19,11,-1,1,216000,0,216000
304,12,17,11,-1,2,264000,15000,279000
305,11,6,13,12,2,360000,310000,670000
306,19,13,10,-1,1,207000,0,207000
307,15,17,8,-1,2,234000,0,234000
308,19,8,6,-1,2,243000,0,243000
309,16,20,6,-1,1,171000,0,171000
310,5,14,16,-1,2,252000,0,252000
311,19,5,15,-1,1,198000,0,198000
312,9,12,10,13,2,372000,180000,552000
313,20,11,17,-1,2,252000,0,252000
314,10,19,7,-1,2,252000,0,252000
315,18,5,9,-1,1,216000,0,216000
316,20,18,8,-1,2,225000,0,225000
317,10,19,16,-1,2,225000,0,225000
318,10,16,9,-1,2,255000,15000,270000
319,16,11,13,13,2,300000,60000,360000
320,6,14,20,-1,1,216000,0,216000
321,17,5,13,-1,1,216000,0,216000
322,15,5,20,-1,1,216000,0,216000
323,13,12,18,-1,2,219000,15000,234000
324,11,12,19,-1,2,246000,15000,261000
325,16,14,6,-1,2,252000,0,252000
326,14,18,17,12,2,348000,45000,393000
327,13,15,18,-1,2,225000,0,225000
328,20,12,10,-1,2,252000,0,252000
329,19,12,8,-1,1,207000,0,207000
330,19,13,8,-1,1,216000,0,216000
331,16,17,6,-1,2,264000,15000,279000
332,20,15,12,-1,2,189000,0,189000
333,11,17,18,13,2,348000,165000,513000
334,6,10,16,-1,1,216000,0,216000
335,5,12,16,-1,1,216000,0,216000
336,7,19,8,-1,2,264000,15000,279000
337,5,12,20,-1,1,207000,0,207000
338,7,18,16,-1,2,225000,0,225000
339,11,9,16,-1,2,216000,0,216000
340,5,13,9,11,2,360000,345000,705000
341,19,9,7,-1,2,252000,0,252000
342,15,20,11,-1,1,180000,0,180000
343,19,17,12,-1,2,243000,0,243000
344,14,5,7,-1,2,252000,0,252000
345,7,18,5,-1,2,252000,0,252000
346,9,12,8,-1,2,243000,15000,258000
347,17,18,9,12,2,336000,75000,411000
348,19,18,14,-1,2,237000,15000,252000
349,5,16,6,-1,2,276000,30000,306000
350,14,19,5,-1,1,216000,0,216000
351,18,11,7,-1,1,216000,0,216000
352,11,10,8,-1,2,267000,15000,282000
353,9,17,19,-1,2,198000,0,198000
354,16,9,5,13,2,348000,225000,573000
355,7,9,5,-1,2,312000,75000,387000
356,15,8,11,-1,2,207000,0,207000
357,12,11,12,-1,2,219000,15000,234000
358,20,18,7,-1,2,162000,0,162000
359,10,11,14,-1,2,261000,15000,276000
360,7,17,13,-1,1,198000,0,198000
361,5,17,16,11,2,360000,120000,480000
362,14,12,5,-1,2,276000,30000,306000
363,19,8,7,-1,2,255000,15000,270000
364,6,11,19,-1,1,198000,0,198000
365,13,9,7,-1,2,243000,0,243000
366,15,19,18,-1,2,177000,15000,192000
367,5,12,18,-1,2,252000,15000,267000
368,18,8,19,12,2,336000,75000,411000
369,18,13,19,-1,2,228000,15000,243000
370,18,17,8,-1,2,246000,15000,261000
371,14,16,19,-1,2,180000,0,180000
372,13,15,18,-1,2,234000,0,234000
373,8,9,14,-1,2,300000,30000,330000
374,8,17,15,-1,2,216000,0,216000
375,15,7,5,13,2,360000,160000,520000
376,18,6,11,-1,1,216000,0,216000
377,6,17,14,-1,2,252000,0,252000
378,20,7,6,-1,2,264000,15000,279000
379,17,16,18,-1,2,180000,30000,210000
380,9,20,8,-1,2,264000,15000,279000
381,7,16,18,-1,2,252000,0,252000
382,15,18,20,13,2,336000,15000,351000
383,16,11,17,-1,2,264000,15000,279000
384,13,17,16,-1,2,231000,15000,246000
385,12,5,15,-1,2,264000,15000,279000
386,9,12,10,-1,2,261000,30000,291000
387,8,16,19,-1,2,216000,0,216000
388,10,8,18,-1,2,234000,0,234000
389,9,13,16,12,2,348000,135000,483000
390,5,15,9,-1,2,288000,30000,318000
391,19,6,11,-1,1,207000,0,207000
392,16,15,12,-1,2,222000,15000,237000
393,7,16,12,-1,1,216000,0,216000
394,17,13,11,-1,2,225000,0,225000
395,10,18,19,-1,2,246000,15000,261000
396,20,11,10,13,2,372000,105000,477000
397,14,16,11,-1,2,276000,0,276000
398,9,12,18,-1,2,234000,0,234000
399,8,15,16,-1,2,255000,15000,270000
400,10,15,7,-1,2,234000,0,234000
401,13,20,10,-1,2,207000,0,207000
402,9,18,19,-1,2,246000,15000,261000
403,11,6,7,11,2,348000,190000,538000
404,11,20,19,-1,2,210000,15000,225000
405,11,14,18,-1,2,225000,0,225000
406,8,5,19,-1,2,252000,0,252000
407,12,11,16,-1,2,228000,15000,243000
408,14,6,5,-1,2,264000,15000,279000
409,20,19,19,-1,2,138000,15000,153000
410,5,14,10,11,2,372000,345000,717000
411,9,6,16,-1,2,300000,30000,330000
412,14,8,5,-1,2,252000,0,252000
413,11,18,7,-1,1,189000,0,189000
414,5,14,12,-1,2,252000,0,252000
415,14,8,7,-1,2,237000,15000,252000
416,17,9,8,-1,2,228000,15000,243000
417,7,10,6,13,2,384000,215000,599000
418,7,17,19,-1,2,243000,0,243000
419,15,5,10,-1,1,216000,0,216000
420,10,9,11,-1,2,261000,30000,291000
421,8,12,20,-1,1,180000,0,180000
422,19,8,15,-1,1,216000,0,216000
423,12,5,16,-1,1,216000,0,216000
424,15,20,8,12,2,360000,60000,420000
425,12,11,10,-1,2,300000,45000,345000
426,6,17,13,-1,1,216000,0,216000
427,7,16,11,-1,1,207000,0,207000
428,13,7,11,-1,2,252000,0,252000
429,11,5,15,-1,1,207000,0,207000
430,5,15,13,-1,2,252000,0,252000
431,12,11,5,12,2,288000,45000,333000
432,5,13,7,-1,2,252000,0,252000
433,20,11,16,-1,1,135000,0,135000
434,11,20,6,-1,1,216000,0,216000
435,20,5,19,-1,2,264000,15000,279000
436,7,5,14,-1,2,252000,0,252000
437,9,18,14,-1,1,180000,0,180000
438,10,9,5,12,2,384000,350000,734000
439,19,7,9,-1,2,264000,15000,279000
440,9,12,16,-1,2,243000,0,243000
441,18,14,11,-1,2,216000,0,216000
442,8,13,13,-1,1,216000,0,216000
443,15,14,8,-1,2,201000,15000,216000
444,17,10,11,-1,2,219000,15000,234000
445,20,16,10,11,2,372000,90000,462000
446,10,14,15,-1,2,276000,30000,306000
447,17,10,9,-1,2,246000,15000,261000
448,9,18,13,-1,1,189000,0,189000
449,5,20,13,-1,1,216000,0,216000
450,20,15,9,-1,1,216000,0,216000
451,14,17,8,-1,2,252000,0,252000
452,14,9,12,11,2,360000,180000,540000
453,13,6,11,-1,2,276000,30000,306000
454,5,9,17,-1,1,216000,0,216000
455,20,10,5,-1,1,216000,0,216000
456,9,11,8,-1,2,270000,30000,300000
457,5,13,11,-1,2,234000,0,234000
458,19,15,8,-1,1,162000,0,162000
459,20,14,12,11,2,372000,105000,477000
460,20,7,14,-1,1,216000,0,216000
461,15,5,16,-1,2,264000,15000,279000
462,7,20,9,-1,2,252000,0,252000
463,15,12,7,-1,2,234000,0,234000
464,14,15,19,-1,2,183000,15000,198000
465,15,19,17,-1,2,240000,0,240000
466,20,13,16,12,2,360000,90000,450000
467,14,17,8,-1,2,252000,0,252000
468,5,19,9,-1,1,207000,0,207000
469,6,17,15,-1,2,234000,0,234000
470,19,10,5,-1,1,207000,0,207000
471,19,9,15,-1,1,180000,0,180000
472,6,14,12,-1,2,264000,15000,279000
473,18,6,8,11,2,360000,165000,525000
474,20,15,17,-1,2,198000,0,198000
475,15,20,16,-1,2,237000,15000,252000
476,13,6,15,-1,2,276000,30000,306000
477,17,8,16,-1,2,255000,15000,270000
478,12,11,9,-1,2,240000,15000,255000
479,20,14,7,-1,1,189000,0,189000
480,13,7,15,11,2,360000,135000,495000
481,14,20,13,-1,2,246000,15000,261000
482,7,11,14,-1,2,276000,30000,306000
483,15,13,16,-1,2,213000,15000,228000
484,18,8,13,-1,1,216000,0,216000
485,18,10,9,-1,2,255000,15000,270000
486,12,10,16,-1,2,216000,0,216000
487,20,17,19,11,2,324000,30000,354000
488,20,16,5,-1,1,198000,0,198000
489,20,16,8,-1,1,216000,0,216000
490,19,12,18,-1,2,228000,15000,243000
491,13,12,19,-1,2,237000,15000,252000
492,18,8,5,-1,2,252000,0,252000
493,15,11,8,-1,2,243000,0,243000
494,11,19,5,11,2,264000,0,264000
495,9,14,18,-1,1,216000,0,216000
496,19,10,20,-1,2,255000,15000,270000
497,5,17,7,-1,2,252000,0,252000
498,10,13,14,-1,2,231000,15000,246000
499,13,15,9,-1,2,225000,0,225000
500,6,18,10,-1,1,216000,0,216000
501,12,13,14,11,2,360000,120000,480000
502,16,15,14,-1,2,252000,30000,282000
503,11,20,6,-1,1,216000,0,216000
504,11,20,5,-1,1,216000,0,216000
505,15,19,18,-1,2,222000,15000,237000
506,10,8,17,-1,2,252000,0,252000
507,18,19,13,-1,2,219000,15000,234000
508,20,7,8,12,2,408000,245000,653000
509,18,12,8,-1,2,252000,15000,267000
510,14,13,6,-1,2,264000,15000,279000
511,12,8,7,-1,2,246000,15000,261000
512,17,14,8,-1,2,216000,0,216000
513,12,8,15,-1,2,234000,0,234000
514,20,7,10,-1,2,243000,0,243000
515,10,8,17,11,2,360000,90000,450000
516,5,8,16,-1,2,252000,0,252000
517,19,20,11,-1,2,228000,15000,243000
518,8,7,15,-1,2,264000,15000,279000
519,12,9,19,-1,2,216000,0,216000
520,10,11,8,-1,2,267000,15000,282000
521,8,13,17,-1,1,171000,0,171000
522,7,18,6,13,2,384000,170000,554000
523,10,12,6,-1,2,300000,45000,345000
524,17,20,12,-1,2,180000,0,180000
525,9,10,18,-1,2,264000,15000,279000
526,10,11,5,-1,2,276000,30000,306000
527,14,10,13,-1,2,213000,15000,228000
528,19,16,15,-1,2,207000,15000,222000
529,19,12,7,13,2,348000,315000,663000
530,20,14,8,-1,1,216000,0,216000
531,12,19,18,-1,2,228000,15000,243000
532,17,16,15,-1,2,234000,30000,264000
533,5,13,16,-1,2,264000,15000,279000
534,17,19,20,-1,2,186000,15000,201000
535,8,19,16,-1,2,252000,0,252000
536,5,9,13,12,2,396000,335000,731000
537,18,17,8,-1,2,264000,15000,279000
538,15,19,16,-1,2,225000,15000,240000
539,13,8,17,-1,2,252000,15000,267000
540,7,6,13,-1,2,264000,15000,279000
541,9,6,10,-1,2,258000,15000,273000
542,12,8,15,-1,2,198000,0,198000
543,5,11,7,12,2,372000,280000,652000
544,18,10,20,-1,2,252000,0,252000
545,12,8,19,-1,1,207000,0,207000
546,5,11,19,-1,1,216000,0,216000
547,6,12,19,-1,1,216000,0,216000
548,6,5,18,-1,2,264000,15000,279000
549,14,19,6,-1,1,207000,0,207000
550,14,9,6,11,2,372000,275000,647000
551,18,10,12,-1,2,252000,0,252000
552,15,11,8,-1,2,243000,0,243000
553,9,11,13,-1,2,249000,0,249000
554,14,10,6,-1,1,198000,0,198000
555,13,8,7,-1,2,255000,15000,270000
556,7,17,8,-1,2,237000,15000,252000
557,7,17,20,13,2,312000,30000,342000
558,8,19,12,-1,1,216000,0,216000
559,16,10,5,-1,1,216000,0,216000
560,15,11,6,-1,1,207000,0,207000
561,7,8,11,-1,2,279000,15000,294000
562,19,13,8,-1,1,162000,0,162000
563,13,5,17,-1,1,216000,0,216000
564,20,19,14,13,2,336000,75000,411000
565,20,18,9,-1,2,225000,0,225000
566,16,18,16,-1,2,171000,0,171000
567,19,10,7,-1,2,234000,0,234000
568,12,6,15,-1,2,243000,0,243000
569,6,8,16,-1,2,234000,0,234000
570,11,17,20,-1,2,180000,0,180000
571,12,11,14,12,2,324000,105000,429000
572,18,6,9,-1,2,252000,0,252000
573,11,19,8,-1,2,243000,0,243000
574,12,20,7,-1,1,207000,0,207000
575,17,11,19,-1,2,216000,0,216000
576,13,13,10,-1,2,234000,0,234000
577,8,20,15,-1,1,144000,0,144000
578,6,10,11,13,2,372000,310000,682000
579,12,9,6,-1,2,312000,45000,357000
580,6,14,11,-1,2,243000,0,243000
581,7,13,6,-1,2,246000,15000,261000
582,15,20,16,-1,2,156000,15000,171000
583,20,8,16,-1,1,216000,0,216000
584,11,17,15,-1,2,264000,15000,279000
585,8,14,5,12,2,384000,265000,649000
586,7,12,13,-1,2,288000,45000,333000
587,13,19,16,-1,2,189000,0,189000
588,11,13,12,-1,2,288000,30000,318000
589,8,9,16,-1,2,246000,15000,261000
590,17,13,5,-1,1,216000,0,216000
591,10,15,8,-1,2,225000,0,225000
592,19,5,6,12,2,360000,155000,515000
593,15,14,5,-1,2,264000,15000,279000
594,8,19,20,-1,2,228000,15000,243000
595,6,17,11,-1,1,216000,0,216000
596,10,9,12,-1,2,279000,30000,309000
597,14,12,5,-1,2,243000,0,243000
598,14,7,12,-1,2,207000,0,207000
599,15,7,8,12,2,372000,160000,532000
600,5,18,10,-1,1,216000,0,216000
601,18,7,5,-1,2,252000,0,252000
602,19,18,15,-1,2,186000,15000,201000
603,12,11,7,-1,2,288000,45000,333000
604,18,8,7,-1,2,255000,15000,270000
605,12,18,17,-1,2,192000,15000,207000
606,17,7,8,12,2,396000,210000,606000
607,9,15,13,-1,2,264000,15000,279000
608,18,13,16,-1,2,222000,0,222000
609,14,13,7,-1,2,264000,15000,279000
610,20,12,6,-1,1,216000,0,216000
611,17,7,6,-1,2,264000,15000,279000
612,13,18,9,-1,1,162000,0,162000
613,8,12,19,13,2,348000,305000,653000
614,8,6,10,-1,2,288000,15000,303000
615,9,20,6,-1,2,207000,0,207000
616,8,11,19,-1,2,216000,0,216000
617,18,10,9,-1,2,237000,15000,252000
618,13,12,6,-1,2,264000,15000,279000
619,13,20,17,-1,2,162000,0,162000
620,15,16,7,13,2,348000,225000,573000
621,5,20,18,-1,2,234000,0,234000
622,15,6,16,-1,2,264000,15000,279000
623,5,10,18,-1,1,207000,0,207000
624,13,5,14,-1,2,264000,15000,279000
625,17,19,16,-1,2,162000,30000,192000
626,18,7,9,-1,2,252000,0,252000
627,8,6,18,11,2,384000,205000,589000
628,20,14,8,-1,1,216000,0,216000
629,11,15,16,-1,2,255000,15000,270000
630,16,14,8,-1,2,252000,0,252000
631,10,11,12,-1,2,243000,30000,273000
632,15,17,18,-1,2,186000,15000,201000
633,12,13,11,-1,2,279000,30000,309000
634,15,18,17,11,2,348000,45000,393000
635,15,17,8,-1,2,252000,0,252000
636,10,15,19,-1,1,198000,0,198000
637,19,14,5,-1,1,216000,0,216000
638,19,17,12,-1,2,234000,0,234000
639,6,11,17,-1,1,216000,0,216000
640,13,9,11,-1,2,276000,0,276000
641,11,6,14,13,2,336000,135000,471000
642,6,12,13,-1,2,276000,30000,306000
643,14,5,20,-1,1,216000,0,216000
644,18,5,12,-1,1,216000,0,216000
645,20,19,16,-1,2,186000,15000,201000
646,9,12,15,-1,2,300000,30000,330000
647,17,5,9,-1,1,216000,0,216000
648,12,8,6,13,2,372000,255000,627000
649,8,19,18,-1,2,264000,15000,279000
650,14,10,15,-1,2,237000,15000,252000
651,6,11,10,-1,2,276000,30000,306000
652,8,17,6,-1,2,225000,0,225000
653,11,17,19,-1,2,180000,0,180000
654,7,18,19,-1,2,246000,15000,261000
655,13,12,15,11,2,360000,135000,495000
656,8,5,18,-1,2,264000,15000,279000
657,15,19,13,-1,2,207000,0,207000
658,6,15,11,-1,2,264000,30000,294000
659,16,20,17,-1,2,198000,15000,213000
660,5,16,14,-1,2,264000,15000,279000
661,19,18,13,-1,2,210000,15000,225000
662,12,8,5,12,2,360000,215000,575000
663,11,13,17,-1,2,216000,0,216000
664,17,19,11,-1,2,225000,0,225000
665,6,17,19,-1,2,243000,0,243000
666,7,8,6,-1,2,288000,30000,318000
667,9,17,15,-1,2,180000,0,180000
668,14,13,11,-1,2,231000,15000,246000
669,20,19,7,13,2,312000,45000,357000
670,14,13,6,-1,2,264000,15000,279000
671,11,20,5,-1,1,207000,0,207000
672,19,14,12,-1,2,189000,0,189000
673,16,12,17,-1,2,237000,15000,252000
674,17,5,11,-1,1,216000,0,216000
675,8,18,12,-1,1,216000,0,216000
676,8,10,5,13,2,396000,300000,696000
677,5,11,20,-1,1,216000,0,216000
678,12,16,6,-1,2,264000,30000,294000
679,18,17,10,-1,2,237000,15000,252000
680,17,10,5,-1,1,216000,0,216000
681,20,12,15,-1,2,207000,0,207000
682,13,6,5,-1,2,312000,45000,357000
683,12,13,15,11,2,336000,105000,441000
684,17,19,13,-1,2,216000,0,216000
685,11,20,16,-1,1,207000,0,207000
686,13,15,8,-1,2,264000,15000,279000
687,6,19,16,-1,2,243000,0,243000
688,16,7,5,-1,2,252000,0,252000
689,13,16,9,-1,2,198000,0,198000
690,19,20,12,11,2,336000,60000,396000
691,18,13,19,-1,2,228000,15000,243000
692,8,7,14,-1,2,264000,15000,279000
693,10,6,7,-1,2,270000,15000,285000
694,6,17,13,-1,1,171000,0,171000
695,13,17,14,-1,2,225000,15000,240000
696,14,17,5,-1,2,252000,0,252000
697,12,19,11,13,2,360000,135000,495000
698,15,11,14,-1,2,276000,15000,291000
699,10,7,15,-1,2,252000,0,252000
700,9,11,19,-1,2,216000,0,216000
701,17,12,16,-1,2,210000,15000,225000
702,5,10,17,-1,1,216000,0,216000
703,9,5,19,-1,1,216000,0,216000
704,18,6,10,12,2,360000,340000,700000
705,11,8,12,-1,2,264000,15000,279000
706,17,18,20,-1,2,153000,30000,183000
707,12,8,20,-1,1,216000,0,216000
708,8,15,14,-1,2,276000,30000,306000
709,15,5,18,-1,2,252000,0,252000
710,11,12,7,-1,2,255000,15000,270000
711,20,8,13,12,2,324000,45000,369000
712,6,15,19,-1,1,216000,0,216000
713,18,6,8,-1,2,264000,15000,279000
714,7,9,10,-1,2,276000,15000,291000
715,12,18,8,-1,1,162000,0,162000
716,20,19,15,-1,2,201000,15000,216000
717,19,9,14,-1,2,252000,15000,267000
718,16,12,14,11,2,372000,150000,522000
719,15,19,17,-1,2,249000,0,249000
720,16,13,20,-1,2,225000,0,225000
721,19,13,11,-1,2,252000,0,252000
722,17,12,6,-1,1,216000,0,216000
723,17,15,19,-1,2,213000,0,213000
724,19,8,5,-1,2,264000,15000,279000
725,8,15,11,12,2,372000,165000,537000
726,9,13,20,-1,1,216000,0,216000
727,11,16,7,-1,2,264000,30000,294000
728,8,8,20,-1,1,171000,0,171000
729,6,10,12,-1,2,234000,0,234000
730,11,10,8,-1,2,231000,15000,246000
731,16,18,15,-1,2,180000,30000,210000
732,16,13,8,12,2,360000,265000,625000
733,14,11,20,-1,1,207000,0,207000
734,19,20,10,-1,2,228000,15000,243000
735,10,14,8,-1,2,252000,0,252000
736,8,10,14,-1,2,225000,0,225000
737,15,17,7,-1,2,234000,0,234000
738,14,11,18,-1,2,189000,0,189000
739,6,10,18,11,2,372000,345000,717000
740,13,6,11,-1,2,252000,0,252000
741,14,17,7,-1,2,207000,0,207000
742,10,14,8,-1,2,225000,0,225000
743,14,16,8,-1,2,225000,0,225000
744,17,8,10,-1,2,225000,0,225000
745,18,7,18,-1,1,171000,0,171000
746,14,6,16,11,2,336000,30000,366000
747,8,16,20,-1,1,216000,0,216000
748,11,12,7,-1,2,276000,30000,306000
749,5,15,9,-1,1,207000,0,207000
750,19,5,16,-1,2,225000,0,225000
751,18,12,10,-1,2,216000,0,216000
752,16,14,18,-1,2,213000,0,213000
753,7,6,16,13,2,396000,240000,636000
754,9,12,7,-1,2,300000,30000,330000
755,6,12,9,-1,2,234000,0,234000
756,12,8,15,-1,2,216000,0,216000
757,9,20,19,-1,2,219000,15000,234000
758,6,20,8,-1,2,252000,0,252000
759,9,16,20,-1,1,180000,0,180000
760,14,8,15,12,2,360000,225000,585000
761,5,8,15,-1,1,216000,0,216000
762,13,14,15,-1,2,216000,30000,246000
763,13,16,18,-1,2,231000,0,231000
764,14,7,5,-1,2,252000,0,252000
765,13,19,6,-1,1,216000,0,216000
766,11,12,5,-1,2,264000,15000,279000
767,17,13,11,12,2,336000,120000,456000
768,13,7,19,-1,1,216000,0,216000
769,18,11,20,-1,2,243000,0,243000
770,11,13,17,-1,2,225000,0,225000
771,9,17,8,-1,2,264000,15000,279000
772,15,19,17,-1,2,186000,0,186000
773,6,7,14,-1,2,300000,30000,330000
774,16,9,18,13,2,336000,30000,366000
775,7,15,19,-1,1,216000,0,216000
776,18,15,8,-1,2,252000,0,252000
777,15,8,19,-1,1,216000,0,216000
778,20,10,14,-1,1,198000,0,198000
779,5,6,12,-1,2,312000,45000,357000
780,11,15,9,-1,2,198000,0,198000
781,9,6,17,13,2,372000,170000,542000
782,12,20,19,-1,2,246000,15000,261000
783,20,5,14,-1,1,216000,0,216000
784,17,6,19,-1,2,252000,0,252000
785,7,15,10,-1,2,243000,0,243000
786,18,9,14,-1,1,180000,0,180000
787,16,10,5,-1,2,252000,15000,267000
788,18,9,16,12,2,360000,120000,480000
789,17,10,13,-1,2,252000,0,252000
790,19,16,14,-1,2,207000,0,207000
791,6,18,5,-1,2,276000,30000,306000
792,9,14,15,-1,2,246000,15000,261000
793,18,20,12,-1,2,198000,0,198000
794,14,9,18,-1,1,216000,0,216000
795,14,17,8,12,2,360000,250000,610000
796,18,10,14,-1,1,207000,0,207000
797,8,19,12,-1,1,198000,0,198000
798,9,7,5,-1,2,300000,30000,330000
799,9,19,20,-1,2,174000,15000,189000
800,8,6,15,-1,2,252000,0,252000
801,5,12,14,-1,2,252000,0,252000
802,6,18,10,11,2,336000,75000,411000
803,9,10,13,-1,2,288000,15000,303000
804,13,16,17,-1,2,195000,15000,210000
805,20,9,12,-1,2,252000,0,252000
806,19,10,9,-1,2,246000,15000,261000
807,10,9,6,-1,2,276000,15000,291000
808,10,8,19,-1,2,198000,0,198000
809,6,9,20,13,2,348000,140000,488000
810,15,12,9,-1,2,288000,15000,303000
811,12,18,9,-1,2,225000,0,225000
812,16,15,19,-1,2,216000,15000,231000
813,13,18,17,-1,2,237000,15000,252000
814,17,10,9,-1,2,264000,15000,279000
815,14,20,6,-1,1,216000,0,216000
816,20,17,14,13,2,348000,60000,408000
817,10,19,6,-1,2,252000,15000,267000
818,17,14,16,-1,2,231000,15000,246000
819,13,16,19,-1,2,216000,0,216000
820,5,13,10,-1,2,300000,45000,345000
821,13,8,10,-1,2,216000,0,216000
822,12,14,17,-1,2,189000,0,189000
823,17,5,13,11,2,372000,250000,622000
824,20,5,15,-1,1,216000,0,216000
825,8,17,13,-1,2,264000,30000,294000
826,9,12,15,-1,2,243000,0,243000
827,15,20,15,-1,1,144000,0,144000
828,7,10,17,-1,2,252000,0,252000
829,19,9,11,-1,2,216000,0,216000
830,6,13,9,11,2,372000,290000,662000
831,19,8,9,-1,2,264000,15000,279000
832,7,10,20,-1,2,252000,0,252000
833,19,20,10,-1,2,210000,15000,225000
834,19,9,5,-1,1,216000,0,216000
835,17,20,12,-1,2,216000,0,216000
836,10,19,8,-1,2,252000,0,252000
837,16,5,20,11,2,360000,60000,420000
838,6,10,7,-1,2,324000,90000,414000
839,6,13,5,-1,2,246000,15000,261000
840,13,20,14,-1,2,165000,15000,180000
841,18,8,5,-1,2,264000,15000,279000
842,17,6,12,-1,1,216000,0,216000
843,14,9,17,-1,2,234000,0,234000
844,20,18,8,13,2,336000,45000,381000
845,7,10,20,-1,1,216000,0,216000
846,8,13,19,-1,1,189000,0,189000
847,10,7,12,-1,2,288000,15000,303000
848,8,15,19,-1,1,171000,0,171000
849,19,18,14,-1,2,210000,15000,225000
850,14,10,9,-1,2,300000,30000,330000
851,14,10,17,13,2,348000,135000,483000
852,17,12,9,-1,2,252000,0,252000
853,13,5,19,-1,1,216000,0,216000
854,12,9,7,-1,2,288000,15000,303000
855,8,5,16,-1,2,234000,0,234000
856,15,8,14,-1,2,219000,15000,234000
857,8,14,19,-1,1,189000,0,189000
858,5,12,15,11,2,372000,265000,637000
859,20,10,6,-1,2,252000,15000,267000
860,8,11,17,-1,2,252000,0,252000
861,14,19,7,-1,1,207000,0,207000
862,9,5,6,-1,2,300000,30000,330000
863,19,16,10,-1,2,171000,0,171000
864,6,17,9,-1,2,252000,0,252000
865,17,13,14,12,2,348000,105000,453000
866,7,14,5,-1,2,300000,30000,330000
867,11,12,10,-1,2,234000,30000,264000
868,12,17,18,-1,2,201000,15000,216000
869,8,20,11,-1,2,252000,0,252000
870,8,13,11,-1,2,267000,0,267000
871,16,17,20,-1,2,180000,15000,195000
872,8,18,12,13,2,348000,330000,678000
873,16,13,19,-1,2,216000,0,216000
874,5,8,16,-1,2,264000,15000,279000
875,8,19,15,-1,1,216000,0,216000
876,12,18,11,-1,2,237000,15000,252000
877,10,13,7,-1,2,288000,15000,303000
878,19,15,10,-1,1,153000,0,153000
879,10,6,9,13,2,396000,340000,736000
880,6,7,10,-1,2,324000,90000,414000
881,17,15,16,-1,2,189000,30000,219000
882,13,11,14,-1,2,267000,15000,282000
883,16,15,13,-1,2,213000,15000,228000
884,12,8,17,-1,1,216000,0,216000
885,13,11,15,-1,2,249000,0,249000
886,14,19,6,13,2,348000,75000,423000
887,16,6,7,-1,2,276000,30000,306000
888,10,18,17,-1,2,237000,15000,252000
889,13,20,12,-1,2,219000,15000,234000
890,19,20,16,-1,2,213000,15000,228000
891,20,14,17,-1,2,234000,0,234000
892,8,16,7,-1,2,276000,30000,306000
893,11,6,9,13,2,384000,285000,669000
894,12,20,8,-1,1,216000,0,216000
895,5,17,15,-1,2,252000,0,252000
896,18,10,19,-1,2,246000,15000,261000
897,9,11,13,-1,2,258000,0,258000
898,10,20,18,-1,2,198000,0,198000
899,17,12,19,-1,2,207000,0,207000
900,15,17,5,12,2,360000,235000,595000
901,18,5,20,-1,2,207000,0,207000
902,10,14,8,-1,2,243000,0,243000
903,10,11,15,-1,2,219000,15000,234000
904,20,7,13,-1,1,216000,0,216000
905,9,17,8,-1,2,255000,15000,270000
906,11,20,17,-1,2,198000,0,198000
907,7,15,17,13,2,348000,135000,483000
908,15,9,8,-1,2,252000,0,252000
909,17,20,8,-1,2,207000,0,207000
910,15,18,10,-1,2,225000,0,225000
911,7,17,14,-1,2,252000,0,252000
912,13,18,5,-1,1,216000,0,216000
913,12,16,20,-1,1,162000,0,162000
914,16,20,7,12,2,360000,230000,590000
915,12,8,16,-1,1,216000,0,216000
916,9,10,11,-1,2,279000,30000,309000
917,16,14,19,-1,2,162000,0,162000
918,18,8,16,-1,2,252000,0,252000
919,12,16,8,-1,1,216000,0,216000
920,7,15,18,-1,2,252000,0,252000
921,10,17,20,12,2,324000,75000,399000
922,9,16,19,-1,2,234000,0,234000
923,5,10,7,-1,2,288000,15000,303000
924,12,11,5,-1,2,219000,15000,234000
925,6,9,18,-1,2,216000,0,216000
926,13,17,5,-1,1,207000,0,207000
927,13,20,6,-1,1,207000,0,207000
928,17,9,12,11,2,360000,150000,510000
929,20,14,15,-1,2,228000,15000,243000
930,20,12,10,-1,2,252000,0,252000
931,19,17,13,-1,2,207000,0,207000
932,8,19,10,-1,2,252000,0,252000
933,18,17,10,-1,2,237000,15000,252000
934,13,11,18,-1,2,216000,0,216000
935,8,13,6,11,2,384000,265000,649000
936,20,18,19,-1,2,204000,30000,234000
937,20,10,12,-1,1,216000,0,216000
938,5,16,20,-1,1,198000,0,198000
939,6,14,5,-1,2,264000,15000,279000
940,16,13,18,-1,2,204000,0,204000
941,6,13,16,-1,2,252000,0,252000
942,16,13,17,13,2,312000,15000,327000
943,17,9,5,-1,1,216000,0,216000
944,18,5,10,-1,1,216000,0,216000
945,9,7,11,-1,2,276000,0,276000
946,16,6,7,-1,2,228000,15000,243000
947,9,11,6,-1,2,249000,0,249000
948,10,6,5,-1,2,237000,15000,252000
949,16,13,12,13,2,294000,75000,369000
950,5,11,17,-1,1,216000,0,216000
951,16,17,13,-1,2,204000,15000,219000
952,17,16,7,-1,2,264000,15000,279000
953,13,9,12,-1,2,249000,15000,264000
954,16,19,10,-1,2,207000,0,207000
955,16,15,19,-1,2,225000,15000,240000
956,18,7,19,13,2,348000,245000,593000
957,10,11,8,-1,2,267000,15000,282000
958,17,10,6,-1,1,189000,0,189000
959,19,9,20,-1,2,219000,15000,234000
960,9,16,13,-1,2,243000,0,243000
961,15,11,19,-1,1,180000,0,180000
962,18,10,5,-1,2,252000,15000,267000
963,12,14,16,13,2,348000,180000,528000
964,18,14,6,-1,1,216000,0,216000
965,19,7,11,-1,1,207000,0,207000
966,5,18,12,-1,1,216000,0,216000
967,12,17,20,-1,2,207000,0,207000
968,18,15,6,-1,2,252000,0,252000
969,16,7,17,-1,2,264000,15000,279000
970,9,15,16,11,2,348000,90000,438000
971,18,7,8,-1,2,264000,15000,279000
972,12,10,18,-1,2,225000,0,225000
973,15,13,18,-1,2,198000,0,198000
974,12,19,15,-1,2,234000,0,234000
975,18,6,9,-1,2,252000,0,252000
976,8,13,15,-1,2,252000,0,252000
977,7,13,19,11,2,348000,60000,408000
978,8,14,15,-1,2,264000,15000,279000
979,5,13,11,-1,2,252000,0,252000
980,20,12,11,-1,2,201000,15000,216000
981,15,13,20,-1,2,207000,0,207000
982,7,18,5,-1,2,264000,15000,279000
983,13,12,8,-1,2,246000,15000,261000
984,15,13,8,12,2,348000,120000,468000
985,6,13,5,-1,2,312000,45000,357000
986,6,7,18,-1,2,237000,15000,252000
987,10,11,9,-1,2,234000,30000,264000
988,13,14,12,-1,2,216000,30000,246000
989,19,12,13,-1,2,219000,15000,234000
990,19,14,11,-1,2,234000,0,234000
991,10,19,6,13,2,348000,340000,688000
992,12,17,14,-1,2,207000,0,207000
993,17,18,5,-1,2,264000,15000,279000
994,20,14,7,-1,1,207000,0,207000
995,8,11,15,-1,2,243000,0,243000
996,13,19,10,-1,2,216000,0,216000
997,13,9,12,-1,2,267000,15000,282000
998,5,9,18,13,2,336000,155000,491000
999,19,11,14,-1,2,252000,0,252000
1000,5,9,7,-1,2,300000,30000,330000
1001,5,18,11,-1,1,189000,0,189000
1002,18,13,20,-1,2,180000,0,180000
1003,7,9,15,-1,2,252000,0,252000
1004,6,12,14,-1,2,252000,0,252000
1005,18,15,5,12,2,336000,30000,366000
1006,5,9,18,-1,2,252000,15000,267000
1007,17,13,16,-1,2,222000,15000,237000
1008,14,11,10,-1,2,279000,15000,294000
1009,10,13,5,-1,2,252000,0,252000
1010,7,9,13,-1,2,216000,0,216000
1011,6,5,15,-1,2,255000,15000,270000
1012,10,5,15,11,2,336000,90000,426000
1013,6,16,19,-1,2,252000,0,252000
1014,17,10,13,-1,2,225000,0,225000
1015,15,12,17,-1,2,240000,0,240000
1016,20,16,8,-1,1,216000,0,216000
1017,9,18,5,-1,1,216000,0,216000
1018,19,17,18,-1,2,207000,30000,237000
1019,14,20,11,13,2,348000,210000,558000
1020,12,11,5,-1,2,276000,30000,306000
1021,15,5,16,-1,2,246000,15000,261000
1022,11,12,19,-1,2,201000,15000,216000
1023,8,11,16,-1,2,252000,0,252000
1024,10,7,16,-1,2,243000,0,243000
1025,5,9,5,-1,1,189000,0,189000
1026,18,7,10,13,2,300000,0,300000
1027,13,6,20,-1,1,216000,0,216000
1028,15,16,6,-1,2,264000,15000,279000
1029,13,17,8,-1,1,207000,0,207000
1030,10,12,13,-1,2,258000,15000,273000
1031,8,13,9,-1,2,237000,15000,252000
1032,19,13,11,-1,2,198000,0,198000
1033,20,16,18,11,2,336000,30000,366000
1034,14,17,9,-1,2,252000,0,252000
1035,17,18,12,-1,2,192000,15000,207000
1036,19,15,8,-1,1,216000,0,216000
1037,15,20,10,-1,1,207000,0,207000
1038,7,15,19,-1,1,216000,0,216000
1039,7,13,17,-1,2,252000,15000,267000
1040,7,14,13,12,2,360000,150000,510000
1041,7,11,17,-1,2,252000,15000,267000
1042,19,14,12,-1,2,216000,0,216000
1043,14,9,16,-1,2,252000,0,252000
1044,10,15,19,-1,1,180000,0,180000
1045,9,19,8,-1,2,264000,15000,279000
1046,10,17,5,-1,1,216000,0,216000
1047,5,16,17,12,2,360000,120000,480000
1048,5,10,16,-1,2,252000,15000,267000
1049,19,15,12,-1,2,216000,0,216000
1050,16,17,20,-1,2,234000,15000,249000
1051,14,12,10,-1,2,288000,15000,303000
1052,8,16,13,-1,2,225000,0,225000
1053,7,6,9,-1,2,288000,30000,318000
1054,20,6,13,12,2,288000,30000,318000
1055,9,12,10,-1,2,300000,45000,345000
1056,9,16,11,-1,2,216000,0,216000
1057,12,18,13,-1,2,210000,15000,225000
1058,8,6,18,-1,2,252000,0,252000
1059,14,11,18,-1,2,207000,0,207000
1060,10,15,12,-1,2,243000,0,243000
1061,11,15,10,12,2,372000,210000,582000
1062,5,16,10,-1,2,252000,15000,267000
1063,12,16,11,-1,2,237000,15000,252000
1064,5,9,19,-1,1,216000,0,216000
1065,15,9,6,-1,2,252000,0,252000
1066,11,5,20,-1,1,216000,0,216000
1067,7,6,9,-1,2,288000,30000,318000
1068,19,8,5,12,2,300000,0,300000
1069,12,15,7,-1,2,276000,30000,306000
1070,17,10,18,-1,2,237000,15000,252000
1071,18,13,14,-1,2,210000,15000,225000
1072,7,5,9,-1,2,312000,75000,387000
1073,5,9,8,-1,2,249000,15000,264000
1074,16,10,18,-1,2,171000,0,171000
1075,18,12,6,13,2,348000,165000,513000
1076,20,17,16,-1,2,189000,0,189000
1077,16,15,8,-1,2,264000,15000,279000
1078,14,7,5,-1,2,252000,0,252000
1079,9,15,18,-1,2,207000,0,207000
1080,16,7,12,-1,1,216000,0,216000
1081,17,6,20,-1,2,234000,0,234000
1082,17,12,10,11,2,372000,180000,552000
1083,19,18,10,-1,2,264000,15000,279000
1084,9,7,6,-1,2,300000,45000,345000
1085,12,7,6,-1,2,228000,15000,243000
1086,15,11,19,-1,1,144000,0,144000
1087,19,9,13,-1,1,216000,0,216000
1088,12,16,18,-1,2,243000,0,243000
1089,8,14,15,13,2,348000,150000,498000
1090,17,8,13,-1,1,216000,0,216000
1091,15,6,11,-1,1,216000,0,216000
1092,11,12,7,-1,2,255000,15000,270000
1093,6,5,19,-1,2,246000,15000,261000
1094,10,15,16,-1,2,201000,15000,216000
1095,19,7,18,-1,2,237000,15000,252000
1096,20,8,13,11,2,372000,135000,507000
1097,19,5,15,-1,1,216000,0,216000
1098,8,6,16,-1,2,264000,15000,279000
1099,12,8,14,-1,2,243000,0,243000
1100,16,14,13,-1,2,216000,30000,246000
1101,12,18,8,-1,1,216000,0,216000
1102,17,13,9,-1,1,207000,0,207000
1103,8,20,19,13,2,324000,75000,399000
1104,12,18,8,-1,1,216000,0,216000
1105,6,10,14,-1,2,252000,15000,267000
1106,18,13,15,-1,2,180000,0,180000
1107,16,14,5,-1,2,252000,0,252000
1108,17,8,6,-1,2,252000,0,252000
1109,6,19,18,-1,2,210000,15000,225000
1110,14,12,20,13,2,348000,120000,468000
1111,13,10,15,-1,2,243000,0,243000
1112,9,16,5,-1,1,198000,0,198000
1113,8,20,5,-1,2,243000,0,243000
1114,20,5,8,-1,2,234000,0,234000
1115,20,18,13,-1,2,171000,0,171000
1116,13,15,20,-1,2,225000,0,225000
1117,5,17,9,11,2,396000,355000,751000
1118,10,7,8,-1,2,312000,60000,372000
1119,11,14,12,-1,2,225000,30000,255000
1120,12,18,17,-1,2,210000,15000,225000
1121,5,11,6,-1,2,312000,45000,357000
1122,5,20,18,-1,2,180000,0,180000
1123,12,9,19,-1,2,234000,0,234000
1124,8,5,17,12,2,384000,195000,579000
1125,20,9,12,-1,2,252000,0,252000
1126,7,13,6,-1,2,264000,15000,279000
1127,20,15,7,-1,1,198000,0,198000
1128,18,19,6,-1,2,237000,15000,252000
1129,5,13,12,-1,2,264000,15000,279000
1130,13,19,18,-1,2,183000,15000,198000
1131,10,8,13,11,2,384000,335000,719000
1132,5,12,6,-1,2,336000,75000,411000
1133,9,16,8,-1,2,219000,15000,234000
1134,6,11,7,-1,2,255000,15000,270000
1135,14,6,15,-1,2,237000,15000,252000
1136,16,12,18,-1,2,171000,0,171000
1137,13,5,13,-1,1,216000,0,216000
1138,17,16,15,11,2,318000,30000,348000
1139,12,14,5,-1,2,264000,15000,279000
1140,13,10,11,-1,2,252000,30000,282000
1141,17,20,18,-1,2,180000,30000,210000
1142,11,6,15,-1,2,288000,30000,318000
1143,14,15,5,-1,2,264000,15000,279000
1144,20,10,12,-1,2,189000,0,189000
1145,8,12,17,13,2,348000,165000,513000
1146,18,19,10,-1,2,219000,15000,234000
1147,16,15,19,-1,2,216000,15000,231000
1148,11,8,5,-1,2,312000,45000,357000
1149,18,16,13,-1,2,186000,0,186000
1150,7,16,11,-1,2,252000,15000,267000
1151,18,12,15,-1,2,198000,0,198000
1152,18,14,10,12,2,360000,195000,555000
1153,20,12,19,-1,2,219000,15000,234000
1154,15,20,11,-1,1,189000,0,189000
1155,8,14,17,-1,2,264000,15000,279000
1156,14,6,17,-1,2,252000,0,252000
1157,18,15,6,-1,2,243000,0,243000
1158,17,20,7,-1,2,216000,0,216000
1159,13,9,16,13,2,300000,15000,315000
1160,17,12,9,-1,2,243000,0,243000
1161,9,16,8,-1,2,255000,15000,270000
1162,17,10,20,-1,2,207000,0,207000
1163,11,6,9,-1,2,288000,15000,303000
1164,7,14,5,-1,2,234000,0,234000
1165,17,12,20,-1,2,162000,0,162000
1166,14,5,20,13,2,348000,235000,583000
1167,7,11,18,-1,1,216000,0,216000
1168,17,20,14,-1,2,189000,0,189000
1169,15,13,12,-1,2,288000,30000,318000
1170,9,7,11,-1,2,276000,0,276000
1171,19,10,18,-1,2,192000,15000,207000
1172,13,15,7,-1,2,252000,0,252000
1173,16,12,13,12,2,312000,45000,357000
1174,6,18,9,-1,2,234000,0,234000
1175,20,10,5,-1,1,207000,0,207000
1176,6,8,18,-1,2,243000,0,243000
1177,10,9,8,-1,2,243000,30000,273000
1178,20,12,19,-1,2,183000,15000,198000
1179,11,7,8,-1,2,300000,30000,330000
1180,17,5,15,13,2,324000,45000,369000
1181,12,16,14,-1,2,258000,0,258000
1182,15,8,5,-1,2,252000,0,252000
1183,11,7,15,-1,1,198000,0,198000
1184,18,8,12,-1,1,207000,0,207000
1185,6,15,17,-1,2,252000,0,252000
1186,14,6,13,-1,2,255000,15000,270000
1187,5,12,13,11,2,336000,90000,426000
1188,19,15,12,-1,2,225000,0,225000
1189,9,19,17,-1,2,252000,0,252000
1190,18,12,8,-1,1,207000,0,207000
1191,15,7,16,-1,2,264000,15000,279000
1192,20,7,10,-1,2,234000,0,234000
1193,8,9,19,-1,2,237000,15000,252000
1194,19,20,12,11,2,336000,45000,381000
1195,11,8,12,-1,2,300000,45000,345000
1196,7,13,14,-1,2,255000,15000,270000
1197,17,6,10,-1,1,198000,0,198000
1198,5,10,14,-1,1,216000,0,216000
1199,11,8,20,-1,2,234000,0,234000
1200,11,19,16,-1,2,207000,0,207000
1201,19,16,6,12,2,360000,190000,550000
1202,10,6,5,-1,2,288000,15000,303000
1203,15,8,18,-1,2,180000,0,180000
1204,16,11,17,-1,2,219000,15000,234000
1205,16,7,13,-1,2,252000,0,252000
1206,17,9,19,-1,2,225000,0,225000
1207,18,20,11,-1,2,207000,0,207000
1208,10,16,20,11,2,372000,90000,462000
1209,5,14,8,-1,2,312000,45000,357000
1210,5,11,12,-1,2,264000,15000,279000
1211,6,10,16,-1,1,180000,0,180000
1212,5,16,17,-1,2,246000,15000,261000
1213,7,15,6,-1,2,255000,15000,270000
1214,13,9,20,-1,1,162000,0,162000
1215,5,12,19,11,2,372000,205000,577000
1216,11,16,6,-1,2,288000,30000,318000
1217,5,13,14,-1,2,264000,15000,279000
1218,13,17,9,-1,1,162000,0,162000
1219,12,17,6,-1,1,216000,0,216000
1220,12,19,20,-1,2,237000,15000,252000
1221,11,19,12,-1,2,246000,15000,261000
1222,7,15,12,13,2,348000,305000,653000
1223,5,9,18,-1,1,216000,0,216000
1224,6,7,17,-1,2,264000,15000,279000
1225,10,6,11,-1,2,237000,15000,252000
1226,13,5,16,-1,2,234000,0,234000
1227,11,15,6,-1,1,189000,0,189000
1228,14,17,9,-1,2,225000,0,225000
1229,5,14,12,13,2,348000,180000,528000
1230,19,11,14,-1,1,198000,0,198000
1231,17,19,5,-1,2,234000,0,234000
1232,10,9,17,-1,2,237000,15000,252000
1233,11,8,5,-1,2,288000,15000,303000
1234,14,6,20,-1,1,171000,0,171000
1235,17,9,7,-1,2,243000,0,243000
1236,7,6,14,12,2,372000,175000,547000
1237,19,6,8,-1,2,252000,0,252000
1238,19,5,7,-1,2,243000,0,243000
1239,19,16,11,-1,2,180000,0,180000
1240,17,19,11,-1,2,234000,0,234000
1241,11,16,12,-1,2,237000,15000,252000
1242,12,11,16,-1,2,237000,15000,252000
1243,11,20,7,13,2,348000,285000,633000
1244,13,15,20,-1,1,180000,0,180000
1245,6,17,16,-1,2,264000,15000,279000
1246,14,11,12,-1,2,243000,30000,273000
1247,16,10,7,-1,2,243000,0,243000
1248,14,19,15,-1,2,183000,15000,198000
1249,14,13,5,-1,2,276000,30000,306000
1250,10,16,14,11,2,372000,165000,537000
1251,18,12,6,-1,2,252000,15000,267000
1252,13,8,5,-1,2,288000,15000,303000
1253,9,6,17,-1,2,225000,0,225000
1254,10,18,5,-1,1,207000,0,207000
1255,16,12,10,-1,2,207000,0,207000
1256,11,7,17,-1,1,216000,0,216000
1257,6,17,12,11,2,360000,120000,480000
1258,15,7,16,-1,2,264000,15000,279000
1259,6,12,11,-1,2,276000,30000,306000
1260,12,18,13,-1,2,192000,15000,207000
1261,6,14,7,-1,2,264000,15000,279000
1262,20,13,5,-1,1,216000,0,216000
1263,9,15,10,-1,2,237000,15000,252000
1264,19,20,14,12,2,336000,45000,381000
1265,15,11,9,-1,1,216000,0,216000
1266,7,13,8,-1,2,246000,15000,261000
1267,10,6,20,-1,1,198000,0,198000
1268,11,6,17,-1,1,216000,0,216000
1269,15,13,14,-1,2,225000,30000,255000
1270,9,18,7,-1,2,252000,0,252000
1271,20,9,13,12,2,348000,105000,453000
1272,17,15,19,-1,2,240000,0,240000
1273,16,13,6,-1,2,264000,15000,279000
1274,13,6,18,-1,1,216000,0,216000
1275,5,16,15,-1,2,264000,15000,279000
1276,13,14,19,-1,2,183000,15000,198000
1277,17,15,8,-1,2,252000,0,252000
1278,13,20,13,12,2,288000,30000,318000
1279,18,20,8,-1,2,243000,0,243000
1280,9,13,18,-1,1,198000,0,198000
1281,7,12,11,-1,2,276000,30000,306000
1282,16,7,8,-1,2,246000,15000,261000
1283,9,13,17,-1,1,171000,0,171000
1284,6,12,9,-1,2,300000,30000,330000
1285,18,14,19,12,2,327000,30000,357000
1286,5,17,15,-1,2,252000,0,252000
1287,18,5,17,-1,2,255000,15000,270000
1288,19,16,17,-1,2,198000,30000,228000
1289,19,17,9,-1,2,252000,0,252000
1290,19,18,13,-1,2,219000,15000,234000
1291,16,7,15,-1,2,264000,15000,279000
1292,20,15,17,13,2,348000,45000,393000
1293,11,18,12,-1,2,264000,15000,279000
1294,19,5,13,-1,1,216000,0,216000
1295,7,12,10,-1,2,288000,15000,303000
1296,11,6,13,-1,2,234000,0,234000
1297,11,7,13,-1,2,216000,0,216000
1298,16,13,20,-1,2,171000,0,171000
1299,16,17,18,12,2,348000,105000,453000
1300,9,10,13,-1,2,288000,15000,303000
1301,16,19,17,-1,2,180000,30000,210000
1302,18,9,19,-1,2,264000,15000,279000
1303,5,12,13,-1,2,264000,15000,279000
1304,7,13,12,-1,2,246000,15000,261000
1305,14,10,13,-1,2,222000,15000,237000
1306,19,17,20,12,2,324000,30000,354000
1307,9,8,9,-1,2,207000,0,207000
1308,7,9,16,-1,2,189000,0,189000
1309,17,9,19,-1,2,207000,0,207000
1310,8,17,5,-1,2,252000,0,252000
1311,5,10,16,-1,1,207000,0,207000
1312,10,8,19,-1,2,225000,0,225000
1313,9,17,14,11,2,348000,90000,438000
1314,13,17,12,-1,2,246000,15000,261000
1315,20,19,5,-1,2,246000,15000,261000
1316,10,16,18,-1,2,234000,0,234000
1317,7,10,17,-1,2,252000,0,252000
1318,8,17,10,-1,2,225000,0,225000
1319,8,14,13,-1,2,237000,15000,252000
1320,16,10,14,11,2,360000,135000,495000
1321,16,7,11,-1,2,252000,15000,267000
1322,6,11,16,-1,1,216000,0,216000
1323,11,10,12,-1,2,261000,30000,291000
1324,5,9,17,-1,1,216000,0,216000
1325,6,12,16,-1,1,207000,0,207000
1326,11,16,8,-1,2,234000,0,234000
1327,11,17,5,13,2,348000,260000,608000
1328,5,11,15,-1,2,264000,30000,294000
1329,6,19,17,-1,2,234000,0,234000
1330,13,5,12,-1,2,264000,15000,279000
1331,7,6,8,-1,2,261000,30000,291000
1332,10,15,6,-1,1,171000,0,171000
1333,13,7,18,-1,1,207000,0,207000
1334,10,13,9,12,2,372000,165000,537000
1335,20,9,19,-1,2,264000,15000,279000
1336,7,20,18,-1,2,234000,0,234000
1337,5,13,20,-1,1,216000,0,216000
1338,5,7,18,-1,2,252000,0,252000
1339,14,13,17,-1,2,207000,15000,222000
1340,17,19,20,-1,2,195000,15000,210000
1341,5,8,18,13,2,408000,265000,673000
1342,11,12,10,-1,2,267000,15000,282000
1343,10,6,10,-1,1,162000,0,162000
1344,19,15,20,-1,2,129000,15000,144000
1345,6,17,8,-1,2,264000,15000,279000
1346,20,19,18,-1,2,186000,30000,216000
1347,5,8,15,-1,1,216000,0,216000
1348,5,11,8,12,2,384000,285000,669000
1349,14,18,5,-1,1,216000,0,216000
1350,20,14,9,-1,1,216000,0,216000
1351,8,15,15,-1,1,216000,0,216000
1352,8,9,14,-1,2,201000,15000,216000
1353,19,17,18,-1,2,180000,30000,210000
1354,20,8,9,-1,2,264000,15000,279000
1355,13,6,20,12,2,360000,205000,565000
1356,13,14,8,-1,2,264000,15000,279000
1357,15,7,12,-1,2,207000,0,207000
1358,12,9,19,-1,2,216000,0,216000
1359,6,8,16,-1,2,252000,0,252000
1360,11,10,16,-1,2,210000,15000,225000
1361,18,16,9,-1,2,234000,0,234000
1362,16,18,20,13,2,348000,15000,363000
1363,13,13,19,-1,1,198000,0,198000
1364,16,17,6,-1,2,237000,15000,252000
1365,5,10,11,-1,2,264000,15000,279000
1366,8,14,6,-1,2,216000,0,216000
1367,14,16,5,-1,2,225000,0,225000
1368,13,9,20,-1,1,162000,0,162000
1369,17,15,8,13,2,348000,135000,483000
1370,10,8,15,-1,1,216000,0,216000
1371,15,6,13,-1,2,252000,0,252000
1372,6,5,8,-1,2,270000,30000,300000
1373,20,19,11,-1,2,165000,15000,180000
1374,17,10,11,-1,2,246000,15000,261000
1375,14,6,11,-1,2,252000,0,252000
1376,7,19,9,12,2,348000,140000,488000
1377,18,20,16,-1,2,222000,0,222000
1378,12,15,10,-1,2,288000,15000,303000
1379,5,16,6,-1,2,264000,15000,279000
1380,10,19,20,-1,2,183000,15000,198000
1381,19,15,12,-1,2,216000,0,216000
1382,14,12,16,-1,2,258000,0,258000
1383,16,5,7,13,2,372000,185000,557000
1384,7,12,11,-1,2,288000,45000,333000
1385,9,14,17,-1,2,216000,0,216000
1386,19,12,18,-1,2,219000,15000,234000
1387,11,7,8,-1,2,300000,30000,330000
1388,5,10,18,-1,1,198000,0,198000
1389,7,17,18,-1,2,228000,15000,243000
1390,16,10,15,12,2,348000,120000,468000
1391,5,20,17,-1,2,252000,0,252000
1392,18,20,15,-1,2,222000,0,222000
1393,17,14,10,-1,2,264000,15000,279000
1394,8,18,6,-1,2,252000,0,252000
1395,9,15,8,-1,2,237000,15000,252000
1396,8,10,17,-1,2,225000,0,225000
1397,6,17,5,11,2,384000,195000,579000
1398,15,6,19,-1,1,216000,0,216000
1399,20,7,12,-1,1,216000,0,216000
1400,7,12,9,-1,2,288000,15000,303000
1401,18,20,10,-1,2,180000,0,180000
1402,10,8,12,-1,2,267000,0,267000
1403,5,20,9,-1,1,198000,0,198000
1404,10,6,10,11,2,312000,75000,387000
1405,5,12,16,-1,1,216000,0,216000
1406,12,17,8,-1,1,198000,0,198000
1407,7,9,14,-1,2,252000,0,252000
1408,11,19,14,-1,2,198000,0,198000
1409,20,10,17,-1,2,243000,0,243000
1410,6,18,19,-1,2,246000,15000,261000
1411,12,17,8,11,2,372000,195000,567000
1412,7,5,8,-1,2,312000,90000,402000
1413,9,18,8,-1,2,219000,15000,234000
1414,8,19,12,-1,1,189000,0,189000
1415,7,13,5,-1,2,252000,0,252000
1416,9,14,15,-1,2,228000,15000,243000
1417,8,12,7,-1,2,255000,15000,270000
1418,7,12,8,13,2,372000,230000,602000
1419,8,17,12,-1,1,216000,0,216000
1420,6,18,19,-1,2,255000,15000,270000
1421,18,8,20,-1,2,225000,0,225000
1422,8,16,13,-1,2,243000,0,243000
1423,11,18,15,-1,2,207000,0,207000
1424,19,8,5,-1,2,252000,0,252000
1425,10,11,17,13,2,372000,150000,522000
1426,13,9,19,-1,1,216000,0,216000
1427,14,11,5,-1,2,276000,30000,306000
1428,10,15,5,-1,1,216000,0,216000
1429,13,15,14,-1,2,234000,30000,264000
1430,11,17,5,-1,1,216000,0,216000
1431,17,7,10,-1,2,252000,0,252000
1432,19,16,18,13,2,348000,30000,378000
1433,20,14,12,-1,2,243000,0,243000
1434,18,17,13,-1,2,228000,15000,243000
1435,5,10,18,-1,1,216000,0,216000
1436,19,14,5,-1,1,216000,0,216000
1437,13,15,17,-1,2,249000,0,249000
1438,5,12,13,-1,2,264000,15000,279000
1439,7,5,11,13,2,360000,280000,640000
1440,13,11,9,-1,2,276000,0,276000
1441,5,12,10,-1,2,243000,0,243000
1442,17,8,11,-1,2,198000,0,198000
1443,14,19,9,-1,1,189000,0,189000
1444,9,19,11,-1,2,252000,0,252000
1445,15,18,7,-1,2,243000,0,243000
1446,10,12,8,13,2,360000,215000,575000
1447,13,7,18,-1,1,216000,0,216000
1448,19,9,5,-1,1,216000,0,216000
1449,19,10,18,-1,2,255000,15000,270000
1450,12,9,5,-1,2,264000,15000,279000
1451,17,8,19,-1,2,207000,0,207000
1452,5,19,8,-1,2,252000,0,252000
1453,6,14,19,13,2,336000,60000,396000
1454,15,7,6,-1,2,264000,15000,279000
1455,14,19,18,-1,2,201000,15000,216000
1456,18,14,17,-1,2,249000,15000,264000
1457,17,6,15,-1,2,252000,0,252000
1458,16,11,5,-1,1,216000,0,216000
1459,10,7,14,-1,2,252000,0,252000
1460,7,12,9,11,2,360000,135000,495000
1461,17,11,8,-1,2,252000,0,252000
1462,15,13,9,-1,2,234000,0,234000
1463,17,15,16,-1,2,207000,30000,237000
1464,17,11,20,-1,2,243000,0,243000
1465,19,9,20,-1,2,246000,15000,261000
1466,9,17,10,-1,2,255000,15000,270000
1467,20,18,12,13,2,348000,60000,408000
1468,11,14,12,-1,2,300000,45000,345000
1469,20,12,17,-1,2,198000,0,198000
1470,5,17,9,-1,2,252000,15000,267000
1471,11,7,13,-1,2,252000,0,252000
1472,9,18,16,-1,2,207000,0,207000
1473,18,6,15,-1,2,243000,0,243000
1474,12,20,7,13,2,348000,90000,438000
1475,8,6,7,-1,2,324000,90000,414000
1476,9,20,5,-1,1,198000,0,198000
1477,16,11,17,-1,2,210000,15000,225000
1478,9,14,12,-1,2,267000,0,267000
1479,18,7,19,-1,2,219000,15000,234000
1480,16,10,14,-1,2,225000,0,225000
1481,17,9,20,13,2,348000,45000,393000
1482,12,18,13,-1,2,264000,15000,279000
1483,18,12,16,-1,2,225000,0,225000
1484,19,11,12,-1,2,246000,15000,261000
1485,14,18,16,-1,2,222000,0,222000
1486,19,6,16,-1,2,252000,0,252000
1487,14,10,15,-1,2,237000,15000,252000
1488,10,9,17,13,2,372000,135000,507000
1489,15,11,5,-1,2,264000,30000,294000
1490,14,7,14,-1,1,207000,0,207000
1491,15,8,11,-1,2,180000,0,180000
1492,10,9,8,-1,2,270000,30000,300000
1493,14,19,11,-1,2,180000,0,180000
1494,13,7,6,-1,2,300000,30000,330000
1495,11,17,5,13,2,324000,75000,399000
1496,10,14,16,-1,2,252000,0,252000
1497,20,14,19,-1,2,201000,15000,216000
1498,7,5,15,-1,2,264000,15000,279000
1499,14,9,7,-1,2,252000,0,252000
1500,14,16,5,-1,2,234000,0,234000
1501,9,13,20,-1,1,162000,0,162000
1502,18,20,17,12,2,336000,60000,396000
1503,10,7,15,-1,2,252000,0,252000
1504,19,18,19,-1,2,156000,15000,171000
1505,13,20,17,-1,2,198000,0,198000
1506,12,13,8,-1,2,288000,45000,333000
1507,11,13,6,-1,2,252000,0,252000
1508,10,8,18,-1,2,207000,0,207000
1509,7,20,18,12,2,312000,30000,342000
1510,6,5,12,-1,2,252000,0,252000
1511,18,5,11,-1,1,198000,0,198000
1512,18,20,15,-1,2,186000,0,186000
1513,14,5,13,-1,2,276000,30000,306000
1514,5,16,18,-1,2,243000,0,243000
1515,15,9,14,-1,2,228000,15000,243000
1516,11,5,16,12,2,360000,165000,525000
1517,10,15,20,-1,1,216000,0,216000
1518,13,6,18,-1,2,252000,15000,267000
1519,14,11,9,-1,2,243000,0,243000
1520,16,6,7,-1,2,264000,15000,279000
1521,15,10,9,-1,2,210000,15000,225000
1522,15,9,16,-1,2,237000,15000,252000
1523,7,8,19,13,2,372000,170000,542000
1524,14,7,15,-1,2,264000,15000,279000
1525,15,10,8,-1,2,243000,0,243000
1526,7,17,20,-1,2,216000,0,216000
1527,16,19,9,-1,2,234000,0,234000
1528,14,9,20,-1,1,198000,0,198000
1529,19,5,15,-1,1,216000,0,216000
1530,16,14,7,13,2,348000,150000,498000
1531,5,8,20,-1,1,216000,0,216000
1532,19,13,12,-1,2,210000,15000,225000
1533,7,5,11,-1,2,300000,30000,330000
1534,15,5,20,-1,1,171000,0,171000
1535,5,13,14,-1,2,264000,15000,279000
1536,15,18,16,-1,2,189000,30000,219000
1537,6,18,13,11,2,372000,290000,662000
1538,6,9,19,-1,1,216000,0,216000
1539,11,5,17,-1,1,216000,0,216000
1540,15,13,14,-1,2,216000,30000,246000
1541,10,17,19,-1,2,234000,0,234000
1542,20,11,19,-1,2,228000,15000,243000
1543,15,17,12,-1,2,240000,0,240000
1544,6,15,20,11,2,372000,160000,532000
1545,8,13,8,-1,1,216000,0,216000
1546,13,6,10,-1,2,225000,0,225000
1547,13,20,17,-1,2,171000,0,171000
1548,5,10,19,-1,2,252000,15000,267000
1549,20,6,13,-1,1,216000,0,216000
1550,7,15,9,-1,2,252000,0,252000
1551,16,9,7,11,2,360000,105000,465000
1552,7,14,20,-1,1,216000,0,216000
1553,18,19,14,-1,2,219000,15000,234000
1554,11,5,6,-1,2,324000,60000,384000
1555,5,19,17,-1,2,198000,0,198000
1556,5,17,6,-1,2,264000,15000,279000
1557,11,10,16,-1,2,201000,15000,216000
1558,14,13,6,11,2,360000,120000,480000
1559,14,18,15,-1,2,261000,15000,276000
1560,19,5,14,-1,1,216000,0,216000
1561,13,16,15,-1,2,240000,15000,255000
1562,7,15,11,-1,2,252000,15000,267000
1563,17,18,7,-1,2,228000,15000,243000
1564,11,19,9,-1,2,225000,0,225000
1565,13,14,20,11,2,348000,45000,393000
1566,20,7,17,-1,2,252000,0,252000
1567,16,14,20,-1,2,207000,0,207000
1568,20,19,18,-1,2,213000,30000,243000
1569,6,17,18,-1,2,237000,15000,252000
1570,16,8,6,-1,2,252000,0,252000
1571,15,5,11,-1,1,198000,0,198000
1572,18,13,16,12,2,348000,75000,423000
1573,13,17,15,-1,2,249000,0,249000
1574,10,7,16,-1,2,252000,0,252000
1575,12,15,14,-1,2,222000,15000,237000
1576,20,16,13,-1,2,198000,0,198000
1577,10,5,19,-1,2,252000,15000,267000
1578,11,15,17,-1,2,225000,0,225000
1579,18,6,16,11,2,372000,215000,587000
1580,6,11,8,-1,2,312000,45000,357000
1581,15,17,10,-1,2,189000,0,189000
1582,16,17,11,-1,2,228000,15000,243000
1583,14,20,15,-1,2,210000,15000,225000
1584,14,5,10,-1,2,288000,30000,318000
1585,17,11,7,-1,1,198000,0,198000
1586,6,18,5,12,2,384000,195000,579000
1587,15,17,12,-1,2,258000,0,258000
1588,5,6,9,-1,2,312000,45000,357000
1589,18,7,10,-1,2,198000,0,198000
1590,7,13,6,-1,2,255000,15000,270000
1591,20,18,19,-1,2,141000,30000,171000
1592,8,11,9,-1,2,276000,0,276000
1593,15,9,18,12,2,336000,75000,411000
1594,13,16,18,-1,2,240000,0,240000
1595,9,11,19,-1,2,252000,0,252000
1596,17,14,9,-1,2,225000,0,225000
1597,12,16,9,-1,2,234000,0,234000
1598,17,20,7,-1,2,234000,0,234000
1599,14,9,18,-1,1,198000,0,198000
1600,10,9,16,13,2,384000,290000,674000
1601,5,11,6,-1,2,336000,75000,411000
1602,9,12,18,-1,2,198000,0,198000
1603,9,17,8,-1,2,255000,15000,270000
1604,20,14,5,-1,1,207000,0,207000
1605,15,8,18,-1,2,234000,0,234000
1606,7,13,8,-1,2,255000,15000,270000
1607,19,18,6,13,2,324000,30000,354000
1608,14,17,13,-1,2,279000,15000,294000
1609,12,10,14,-1,2,258000,0,258000
1610,17,19,15,-1,2,186000,0,186000
1611,8,6,20,-1,2,252000,0,252000
1612,10,9,8,-1,2,279000,30000,309000
1613,7,8,20,-1,2,228000,15000,243000
1614,6,9,8,13,2,360000,190000,550000
1615,16,10,20,-1,1,198000,0,198000
1616,19,6,9,-1,2,252000,0,252000
1617,15,11,7,-1,2,252000,15000,267000
1618,20,17,9,-1,2,216000,0,216000
1619,15,9,17,-1,2,234000,0,234000
1620,11,18,19,-1,2,219000,15000,234000
1621,17,9,14,12,2,360000,195000,555000
1622,13,7,20,-1,1,216000,0,216000
1623,20,14,18,-1,2,171000,0,171000
1624,15,8,19,-1,1,216000,0,216000
1625,18,17,16,-1,2,243000,30000,273000
1626,18,12,17,-1,2,255000,15000,270000
1627,14,15,9,-1,2,264000,15000,279000
1628,11,8,9,12,2,372000,180000,552000
1629,10,5,8,-1,2,312000,75000,387000
1630,9,15,20,-1,1,162000,0,162000
1631,8,14,7,-1,2,264000,15000,279000
1632,19,7,5,-1,2,252000,0,252000
1633,20,18,6,-1,2,189000,0,189000
1634,13,5,12,-1,2,264000,15000,279000
1635,12,17,20,11,2,336000,45000,381000
1636,10,12,13,-1,2,288000,30000,318000
1637,9,19,17,-1,2,216000,0,216000
1638,19,20,6,-1,2,219000,15000,234000
1639,7,11,18,-1,1,216000,0,216000
1640,11,12,17,-1,2,237000,15000,252000
1641,8,9,5,-1,2,300000,45000,345000
1642,20,16,8,13,2,288000,0,288000
1643,10,6,5,-1,2,336000,105000,441000
1644,17,15,10,-1,2,189000,0,189000
1645,17,8,15,-1,2,243000,0,243000
1646,10,6,11,-1,2,255000,15000,270000
1647,19,20,8,-1,2,192000,15000,207000
1648,10,13,12,-1,2,258000,15000,273000
1649,6,16,13,11,2,348000,90000,438000
1650,17,20,6,-1,2,252000,0,252000
1651,12,8,5,-1,2,288000,15000,303000
1652,10,20,7,-1,2,216000,0,216000
1653,19,12,9,-1,2,216000,0,216000
1654,8,16,11,-1,2,243000,0,243000
1655,14,7,17,-1,2,243000,0,243000
1656,17,7,10,11,2,360000,90000,450000
1657,7,9,20,-1,2,252000,0,252000
1658,8,9,5,-1,2,288000,30000,318000
1659,12,16,7,-1,1,171000,0,171000
1660,11,9,5,-1,2,264000,15000,279000
1661,19,9,7,-1,2,216000,0,216000
1662,16,7,11,-1,1,189000,0,189000
1663,19,11,7,12,2,360000,230000,590000
1664,16,7,5,-1,2,276000,30000,306000
1665,19,12,5,-1,1,216000,0,216000
1666,19,14,17,-1,2,213000,0,213000
1667,14,12,5,-1,2,264000,15000,279000
1668,7,19,13,-1,1,207000,0,207000
1669,9,10,13,-1,2,270000,15000,285000
1670,15,14,9,11,2,348000,120000,468000
1671,19,16,13,-1,2,216000,0,216000
1672,11,18,19,-1,2,264000,15000,279000
1673,9,6,13,-1,2,288000,15000,303000
1674,8,16,10,-1,2,207000,0,207000
1675,7,16,12,-1,1,198000,0,198000
1676,8,16,11,-1,2,243000,0,243000
1677,18,5,11,12,2,360000,135000,495000
1678,13,9,19,-1,1,216000,0,216000
1679,16,20,6,-1,1,216000,0,216000
1680,7,12,20,-1,1,216000,0,216000
1681,12,19,15,-1,2,243000,0,243000
1682,12,5,6,-1,2,312000,45000,357000
1683,6,9,15,-1,2,225000,0,225000
1684,11,10,7,12,2,360000,165000,525000
1685,15,14,10,-1,2,255000,15000,270000
1686,20,8,19,-1,2,228000,15000,243000
1687,15,12,17,-1,2,240000,0,240000
1688,18,14,9,-1,1,207000,0,207000
1689,5,6,9,-1,2,312000,45000,357000
1690,13,6,14,-1,2,228000,15000,243000
1691,16,19,20,11,2,324000,15000,339000
1692,15,7,11,-1,2,264000,30000,294000
1693,6,20,18,-1,2,225000,0,225000
1694,9,12,17,-1,2,234000,0,234000
1695,10,18,15,-1,2,225000,0,225000
1696,17,15,7,-1,2,252000,0,252000
1697,5,19,16,-1,2,225000,0,225000
1698,12,18,8,13,2,348000,120000,468000
1699,14,19,7,-1,2,252000,15000,267000
1700,8,13,12,-1,2,276000,30000,306000
1701,10,6,7,-1,2,279000,15000,294000
1702,12,19,17,-1,2,153000,0,153000
1703,19,13,20,-1,2,228000,15000,243000
1704,8,9,6,-1,2,300000,45000,345000
1705,20,16,11,12,2,312000,60000,372000
1706,18,5,14,-1,2,252000,15000,267000
1707,5,11,9,-1,2,276000,30000,306000
1708,10,5,6,-1,2,255000,15000,270000
1709,13,7,9,-1,2,207000,0,207000
1710,17,7,11,-1,1,189000,0,189000
1711,19,7,6,-1,2,264000,15000,279000
1712,6,7,12,13,2,372000,230000,602000
1713,12,20,8,-1,1,216000,0,216000
1714,12,17,8,-1,1,216000,0,216000
1715,12,14,10,-1,2,267000,0,267000
1716,16,17,12,-1,2,201000,15000,216000
1717,16,13,14,-1,2,252000,30000,282000
1718,11,9,15,-1,2,243000,0,243000
1719,18,11,5,11,2,264000,0,264000
1720,9,18,13,-1,1,216000,0,216000
1721,12,8,6,-1,2,300000,30000,330000
1722,7,8,19,-1,2,228000,15000,243000
1723,10,12,17,-1,2,198000,0,198000
1724,15,8,16,-1,2,255000,15000,270000
1725,7,19,11,-1,1,198000,0,198000
1726,12,14,18,13,2,348000,150000,498000
1727,18,17,14,-1,2,219000,15000,234000
1728,18,14,9,-1,1,198000,0,198000
1729,6,5,19,-1,2,264000,15000,279000
1730,9,18,15,-1,2,225000,0,225000
1731,10,14,19,-1,1,189000,0,189000
1732,17,8,15,-1,2,252000,0,252000
1733,5,10,17,12,2,360000,300000,660000
1734,6,19,8,-1,2,264000,15000,279000
1735,7,10,8,-1,2,288000,30000,318000
1736,10,6,11,-1,2,228000,15000,243000
1737,17,19,13,-1,2,162000,0,162000
1738,19,6,13,-1,1,216000,0,216000
1739,11,5,14,-1,2,276000,30000,306000
1740,18,6,5,12,2,384000,195000,579000
1741,20,5,13,-1,1,216000,0,216000
1742,8,6,5,-1,2,312000,60000,372000
1743,16,18,7,-1,2,198000,0,198000
1744,14,7,15,-1,2,246000,15000,261000
1745,9,14,6,-1,2,234000,0,234000
1746,9,10,16,-1,2,219000,15000,234000
1747,17,15,16,13,2,348000,75000,423000
1748,11,18,7,-1,2,252000,15000,267000
1749,15,12,8,-1,2,252000,0,252000
1750,17,11,10,-1,2,228000,15000,243000
1751,13,20,19,-1,2,210000,15000,225000
1752,8,13,16,-1,2,264000,15000,279000
1753,16,17,10,-1,2,237000,15000,252000
1754,16,11,20,12,2,360000,90000,450000
1755,5,16,18,-1,2,252000,0,252000
1756,16,14,10,-1,2,243000,0,243000
1757,6,8,12,-1,2,252000,0,252000
1758,17,14,5,-1,2,234000,0,234000
1759,18,19,13,-1,2,183000,15000,198000
1760,16,11,17,-1,2,255000,15000,270000
1761,20,7,9,13,2,372000,180000,552000
1762,9,18,15,-1,2,252000,0,252000
1763,18,8,9,-1,2,264000,15000,279000
1764,20,16,17,-1,2,198000,15000,213000
1765,19,10,16,-1,2,252000,0,252000
1766,5,15,6,-1,2,264000,15000,279000
1767,9,18,5,-1,1,216000,0,216000
1768,12,9,17,11,2,360000,150000,510000
1769,14,20,17,-1,2,216000,0,216000
1770,6,8,10,-1,2,312000,75000,387000
1771,17,14,19,-1,2,186000,0,186000
1772,17,18,6,-1,2,264000,15000,279000
1773,16,20,11,-1,1,180000,0,180000
1774,16,5,19,-1,2,252000,0,252000
1775,19,11,7,13,2,348000,300000,648000
1776,13,18,12,-1,2,234000,0,234000
1777,5,17,16,-1,2,246000,15000,261000
1778,18,10,9,-1,2,228000,15000,243000
1779,5,11,6,-1,2,264000,15000,279000
1780,10,16,6,-1,1,189000,0,189000
1781,19,10,20,-1,2,219000,15000,234000
1782,17,13,11,12,2,360000,180000,540000
1783,15,11,6,-1,1,216000,0,216000
1784,13,12,16,-1,2,225000,15000,240000
1785,14,11,17,-1,2,216000,0,216000
1786,12,17,14,-1,2,225000,0,225000
1787,15,10,20,-1,1,207000,0,207000
1788,19,10,7,-1,2,252000,0,252000
1789,19,8,10,12,2,372000,230000,602000
1790,19,6,11,-1,1,216000,0,216000
1791,6,17,5,-1,2,276000,30000,306000
1792,10,13,20,-1,2,225000,0,225000
1793,7,13,10,-1,2,288000,15000,303000
1794,10,12,15,-1,2,189000,0,189000
1795,8,15,18,-1,2,243000,0,243000
1796,9,11,20,12,2,348000,75000,423000
1797,14,15,10,-1,2,276000,30000,306000
1798,15,16,20,-1,2,192000,15000,207000
1799,5,10,19,-1,2,252000,15000,267000
1800,18,8,9,-1,2,264000,15000,279000
1801,14,10,5,-1,1,216000,0,216000
1802,12,10,15,-1,2,216000,0,216000
1803,17,18,5,11,2,348000,75000,423000
1804,14,5,8,-1,2,312000,45000,357000
1805,11,5,16,-1,1,216000,0,216000
1806,15,5,11,-1,1,216000,0,216000
1807,8,19,6,-1,2,243000,0,243000
1808,14,12,7,-1,2,216000,0,216000
1809,14,15,10,-1,2,210000,15000,225000
1810,12,8,17,13,2,348000,165000,513000
1811,7,15,6,-1,2,252000,0,252000
1812,20,8,9,-1,2,219000,15000,234000
1813,13,12,6,-1,2,255000,15000,270000
1814,17,12,8,-1,1,171000,0,171000
1815,7,9,20,-1,2,252000,0,252000
1816,16,17,14,-1,2,195000,15000,210000
1817,16,18,19,12,2,336000,90000,426000
1818,14,12,6,-1,2,252000,0,252000
1819,8,12,19,-1,1,180000,0,180000
1820,5,11,14,-1,2,264000,15000,279000
1821,6,12,13,-1,2,255000,15000,270000
1822,6,7,10,-1,2,261000,15000,276000
1823,6,13,7,-1,2,219000,15000,234000
1824,12,8,5,13,2,360000,215000,575000
1825,9,14,9,-1,1,216000,0,216000
1826,19,7,15,-1,1,162000,0,162000
1827,19,9,11,-1,2,234000,0,234000
1828,12,9,8,-1,2,270000,15000,285000
1829,6,12,19,-1,1,189000,0,189000
1830,20,6,17,-1,2,225000,0,225000
1831,12,14,7,13,2,348000,180000,528000
1832,12,6,15,-1,2,252000,0,252000
1833,6,9,16,-1,2,225000,0,225000
1834,7,6,19,-1,2,246000,15000,261000
1835,13,17,7,-1,1,180000,0,180000
1836,7,18,11,-1,1,216000,0,216000
1837,20,16,5,-1,1,207000,0,207000
1838,11,17,19,13,2,348000,120000,468000
1839,18,11,16,-1,2,225000,0,225000
1840,19,17,18,-1,2,180000,30000,210000
1841,8,18,16,-1,2,252000,0,252000
1842,14,19,16,-1,2,207000,0,207000
1843,9,18,6,-1,2,264000,15000,279000
1844,20,6,15,-1,1,216000,0,216000
1845,19,16,6,12,2,360000,60000,420000
1846,7,11,9,-1,2,312000,75000,387000
1847,10,8,15,-1,2,216000,0,216000
1848,19,5,13,-1,1,216000,0,216000
1849,19,10,20,-1,2,210000,15000,225000
1850,17,11,7,-1,1,216000,0,216000
1851,14,18,6,-1,1,216000,0,216000
1852,19,9,17,11,2,360000,90000,450000
1853,15,18,7,-1,2,264000,15000,279000
1854,15,8,18,-1,2,252000,0,252000
1855,19,13,18,-1,2,210000,15000,225000
1856,13,14,17,-1,2,261000,15000,276000
1857,18,19,10,-1,2,246000,15000,261000
1858,7,14,10,-1,2,252000,0,252000
1859,10,16,15,13,2,348000,135000,483000
1860,14,13,9,-1,2,276000,30000,306000
1861,17,5,12,-1,1,216000,0,216000
1862,18,14,16,-1,2,213000,0,213000
1863,10,14,8,-1,2,252000,0,252000
1864,17,16,13,-1,2,213000,15000,228000
1865,9,17,13,-1,1,216000,0,216000
1866,10,20,14,12,2,360000,135000,495000
1867,7,10,5,-1,2,264000,15000,279000
1868,7,12,15,-1,2,207000,0,207000
1869,6,12,18,-1,1,207000,0,207000
1870,14,8,19,-1,1,198000,0,198000
1871,17,18,11,-1,2,237000,15000,252000
1872,20,16,9,-1,1,207000,0,207000
1873,12,13,9,13,2,324000,75000,399000
1874,10,11,15,-1,2,255000,15000,270000
1875,8,6,14,-1,2,252000,0,252000
1876,10,18,15,-1,2,198000,0,198000
1877,10,19,18,-1,2,246000,15000,261000
1878,9,8,6,-1,2,288000,30000,318000
1879,9,17,15,-1,2,180000,0,180000
1880,18,19,7,12,2,324000,45000,369000
1881,14,10,19,-1,1,216000,0,216000
1882,7,10,11,-1,2,267000,15000,282000
1883,20,12,19,-1,2,183000,15000,198000
1884,7,20,9,-1,2,252000,0,252000
1885,13,20,7,-1,1,207000,0,207000
1886,11,9,14,-1,2,234000,0,234000
1887,14,16,9,13,2,348000,120000,468000
1888,10,19,13,-1,2,252000,0,252000
1889,11,12,20,-1,2,246000,15000,261000
1890,14,5,8,-1,2,252000,0,252000
1891,16,7,20,-1,1,198000,0,198000
1892,16,6,18,-1,2,252000,0,252000
1893,10,15,19,-1,1,171000,0,171000
1894,8,10,7,13,2,408000,355000,763000
1895,10,7,14,-1,2,300000,30000,330000
1896,7,6,18,-1,2,255000,15000,270000
1897,7,9,15,-1,2,216000,0,216000
1898,16,19,12,-1,2,180000,0,180000
1899,16,10,12,-1,2,252000,0,252000
1900,16,12,8,-1,1,207000,0,207000
1901,8,20,9,13,2,384000,195000,579000
1902,7,6,19,-1,2,276000,30000,306000
1903,13,14,15,-1,2,234000,30000,264000
1904,6,15,8,-1,2,252000,0,252000
1905,19,6,10,-1,1,207000,0,207000
1906,9,14,10,-1,2,237000,15000,252000
1907,11,6,12,-1,2,264000,15000,279000
1908,17,20,6,11,2,312000,15000,327000
1909,5,13,15,-1,2,276000,30000,306000
1910,5,9,13,-1,2,252000,15000,267000
1911,8,20,5,-1,2,234000,0,234000
1912,11,9,8,-1,2,252000,30000,282000
1913,14,19,17,-1,2,177000,0,177000
1914,14,6,10,-1,2,264000,30000,294000
1915,10,20,11,13,2,360000,90000,450000
1916,7,17,8,-1,2,264000,15000,279000
1917,9,17,13,-1,1,207000,0,207000
1918,16,15,18,-1,2,234000,30000,264000
1919,20,17,13,-1,2,225000,0,225000
1920,11,15,15,-1,1,216000,0,216000
1921,18,20,6,-1,2,189000,0,189000
1922,11,20,7,12,2,360000,230000,590000
1923,7,14,8,-1,2,312000,45000,357000
1924,5,17,7,-1,2,252000,0,252000
1925,5,14,13,-1,2,237000,15000,252000
1926,13,11,16,-1,2,171000,0,171000
1927,14,6,11,-1,2,264000,15000,279000
1928,14,15,17,-1,2,207000,30000,237000
1929,6,16,7,11,2,408000,250000,658000
1930,12,7,8,-1,2,312000,45000,357000
1931,10,6,17,-1,1,189000,0,189000
1932,17,9,20,-1,2,225000,0,225000
1933,18,5,9,-1,1,216000,0,216000
1934,9,18,7,-1,2,252000,0,252000
1935,19,18,13,-1,2,183000,15000,198000
1936,19,15,14,13,2,348000,150000,498000
1937,7,20,10,-1,2,252000,0,252000
1938,6,12,10,-1,2,243000,0,243000
1939,13,7,8,-1,2,228000,15000,243000
1940,11,19,9,-1,2,207000,0,207000
1941,15,12,11,-1,2,243000,15000,258000
1942,20,5,16,-1,1,198000,0,198000
1943,16,7,8,13,2,384000,200000,584000
1944,12,17,19,-1,2,243000,0,243000
1945,11,6,16,-1,2,252000,15000,267000
1946,18,6,17,-1,2,237000,15000,252000
1947,17,11,18,-1,2,219000,15000,234000
1948,9,11,20,-1,2,243000,0,243000
1949,13,9,17,-1,1,189000,0,189000
1950,20,17,9,11,2,360000,105000,465000
1951,7,16,5,-1,1,216000,0,216000
1952,9,12,11,-1,2,240000,15000,255000
1953,20,11,14,-1,2,189000,0,189000
1954,20,6,17,-1,2,252000,0,252000
1955,20,6,5,-1,2,264000,15000,279000
1956,17,13,9,-1,1,171000,0,171000
1957,18,16,12,12,2,312000,15000,327000
1958,20,9,7,-1,2,252000,0,252000
1959,7,13,17,-1,1,207000,0,207000
1960,18,5,14,-1,1,216000,0,216000
1961,16,7,8,-1,2,264000,15000,279000
1962,7,20,18,-1,2,198000,0,198000
1963,6,16,6,-1,1,207000,0,207000
1964,20,12,17,11,2,297000,30000,327000
1965,9,19,12,-1,2,252000,0,252000
1966,16,9,6,-1,2,252000,0,252000
1967,14,20,13,-1,2,210000,15000,225000
1968,17,8,5,-1,2,264000,15000,279000
1969,14,8,5,-1,2,252000,0,252000
1970,11,13,6,-1,2,243000,0,243000
1971,18,13,20,13,2,282000,0,282000
1972,8,7,12,-1,2,255000,15000,270000
1973,5,11,12,-1,2,255000,15000,270000
1974,15,6,12,-1,2,216000,0,216000
1975,5,8,7,-1,2,267000,15000,282000
1976,7,11,17,-1,1,153000,0,153000
1977,7,5,15,-1,2,252000,0,252000
1978,17,16,10,12,2,336000,75000,411000
1979,19,20,16,-1,2,222000,15000,237000
1980,17,14,8,-1,2,264000,15000,279000
1981,5,9,10,-1,2,288000,45000,333000
1982,12,10,14,-1,2,222000,0,222000
1983,5,19,8,-1,2,252000,0,252000
1984,10,8,7,-1,2,252000,30000,282000
1985,18,20,7,12,2,300000,0,300000
1986,11,7,19,-1,1,216000,0,216000
1987,18,13,20,-1,2,234000,0,234000
1988,15,14,8,-1,2,264000,15000,279000
1989,10,16,19,-1,2,225000,0,225000
1990,11,13,15,-1,2,249000,0,249000
1991,16,20,7,-1,1,198000,0,198000
1992,17,11,20,12,2,360000,90000,450000
1993,7,20,8,-1,2,243000,0,243000
1994,17,15,5,-1,2,225000,0,225000
1995,7,16,14,-1,2,225000,0,225000
1996,11,16,10,-1,2,210000,15000,225000
1997,20,8,6,-1,2,252000,0,252000
1998,6,12,5,-1,2,255000,15000,270000
1999,9,17,11,11,2,276000,45000,321000
2000,14,18,10,-1,1,171000,0,171000
2001,16,5,10,-1,2,252000,15000,267000
2002,9,7,6,-1,2,300000,45000,345000
2003,11,14,5,-1,2,216000,0,216000
2004,5,6,15,-1,2,246000,15000,261000
2005,19,18,16,-1,2,150000,15000,165000
2006,18,16,8,12,2,360000,260000,620000
2007,12,17,11,-1,2,228000,15000,243000
2008,13,14,11,-1,2,249000,15000,264000
2009,20,12,10,-1,2,216000,0,216000
2010,6,20,8,-1,2,252000,0,252000
2011,10,7,8,-1,2,261000,30000,291000
2012,18,8,7,-1,2,219000,15000,234000
2013,12,7,8,12,2,324000,140000,464000
2014,12,19,9,-1,2,207000,0,207000
2015,20,12,18,-1,2,207000,0,207000
2016,11,8,15,-1,2,252000,0,252000
2017,9,6,20,-1,2,252000,0,252000
2018,8,16,11,-1,2,225000,0,225000
2019,20,16,8,-1,1,198000,0,198000
2020,11,12,16,13,2,360000,210000,570000
2021,8,18,17,-1,2,228000,15000,243000
2022,14,10,18,-1,1,180000,0,180000
2023,14,10,17,-1,2,252000,0,252000
2024,10,17,16,-1,2,246000,15000,261000
2025,16,8,6,-1,2,252000,0,252000
2026,15,20,6,-1,1,189000,0,189000
2027,20,15,19,11,2,312000,45000,357000
2028,15,7,13,-1,2,252000,0,252000
2029,10,7,12,-1,2,258000,0,258000
2030,14,11,15,-1,2,204000,15000,219000
2031,7,20,9,-1,2,252000,0,252000
2032,18,7,10,-1,2,225000,0,225000
2033,17,8,7,-1,2,246000,15000,261000
2034,14,7,11,12,2,348000,150000,498000
2035,10,8,17,-1,2,252000,0,252000
2036,8,18,16,-1,2,243000,0,243000
2037,9,18,14,-1,1,180000,0,180000
2038,19,14,15,-1,2,219000,15000,234000
2039,14,10,17,-1,2,264000,15000,279000
2040,13,7,15,-1,2,252000,0,252000
2041,19,7,16,11,2,348000,45000,393000
2042,7,11,10,-1,2,300000,45000,345000
2043,18,12,16,-1,2,180000,0,180000
2044,14,18,10,-1,1,207000,0,207000
2045,11,18,9,-1,2,252000,0,252000
2046,20,15,7,-1,1,216000,0,216000
2047,5,8,19,-1,2,252000,0,252000
2048,8,6,11,13,2,360000,280000,640000
2049,13,18,9,-1,1,216000,0,216000
2050,15,6,10,-1,2,252000,15000,267000
2051,14,19,13,-1,2,201000,15000,216000
2052,12,5,6,-1,2,312000,45000,357000
2053,8,14,10,-1,2,207000,0,207000
2054,7,6,14,-1,2,255000,15000,270000
2055,11,14,15,12,2,336000,135000,471000
2056,12,18,15,-1,2,234000,0,234000
2057,15,18,19,-1,2,231000,15000,246000
2058,19,8,10,-1,2,252000,0,252000
2059,12,11,9,-1,2,267000,15000,282000
2060,16,9,17,-1,2,219000,15000,234000
2061,10,6,13,-1,2,252000,0,252000
2062,19,16,9,13,2,336000,30000,366000
2063,9,13,11,-1,2,288000,15000,303000
2064,10,14,13,-1,2,222000,15000,237000
2065,19,9,6,-1,2,252000,0,252000
2066,11,8,9,-1,2,252000,30000,282000
2067,17,14,19,-1,2,177000,0,177000
2068,10,17,10,-1,1,216000,0,216000
2069,15,9,19,11,2,300000,45000,345000
2070,20,5,19,-1,2,264000,15000,279000
2071,6,15,20,-1,1,216000,0,216000
2072,12,7,8,-1,2,300000,30000,330000
2073,16,5,7,-1,2,225000,0,225000
2074,6,19,17,-1,2,189000,0,189000
2075,5,9,12,-1,2,264000,15000,279000
2076,14,11,5,12,2,336000,120000,456000
2077,9,17,16,-1,2,264000,15000,279000
2078,7,9,10,-1,2,276000,15000,291000
2079,5,12,18,-1,1,189000,0,189000
2080,7,6,8,-1,2,279000,30000,309000
2081,12,13,10,-1,2,195000,15000,210000
2082,20,12,15,-1,2,189000,0,189000
2083,7,10,17,12,2,384000,355000,739000
2084,10,13,14,-1,2,255000,15000,270000
2085,5,16,17,-1,2,219000,15000,234000
2086,19,9,18,-1,2,219000,15000,234000
2087,16,6,13,-1,2,252000,0,252000
2088,18,10,20,-1,2,207000,0,207000
2089,14,13,9,-1,2,246000,15000,261000
2090,11,19,17,13,2,348000,75000,423000
2091,19,5,10,-1,2,252000,15000,267000
2092,15,10,12,-1,2,234000,0,234000
2093,9,7,13,-1,2,252000,0,252000
2094,12,6,17,-1,1,198000,0,198000
2095,14,18,9,-1,1,189000,0,189000
2096,13,11,8,-1,2,288000,15000,303000
2097,11,6,15,13,2,336000,135000,471000
2098,10,18,13,-1,2,252000,0,252000
2099,9,20,19,-1,2,237000,15000,252000
2100,10,16,8,-1,2,252000,0,252000
2101,17,10,7,-1,2,234000,0,234000
2102,20,19,9,-1,2,210000,15000,225000
2103,15,16,14,-1,2,234000,30000,264000
2104,9,6,7,12,2,408000,355000,763000
2105,13,10,13,-1,2,252000,0,252000
2106,15,5,14,-1,2,210000,15000,225000
2107,15,11,5,-1,1,198000,0,198000
2108,19,18,14,-1,2,183000,15000,198000
2109,9,19,12,-1,2,252000,0,252000
2110,10,16,5,-1,2,252000,15000,267000
2111,5,6,17,13,2,372000,145000,517000
2112,13,12,19,-1,2,246000,15000,261000
2113,11,19,5,-1,1,216000,0,216000
2114,18,20,5,-1,2,243000,0,243000
2115,19,17,11,-1,2,216000,0,216000
2116,15,13,5,-1,2,252000,0,252000
2117,9,12,7,-1,2,234000,0,234000
2118,8,11,13,13,2,300000,45000,345000
2119,8,12,7,-1,2,255000,15000,270000
2120,16,11,14,-1,2,213000,0,213000
2121,20,16,6,-1,1,207000,0,207000
2122,12,5,11,-1,2,276000,30000,306000
2123,10,19,6,-1,1,198000,0,198000
2124,15,10,16,-1,2,228000,15000,243000
2125,20,19,12,11,2,336000,60000,396000
2126,11,19,9,-1,1,216000,0,216000
2127,12,10,5,-1,2,252000,0,252000
2128,11,14,13,-1,2,204000,15000,219000
2129,8,12,19,-1,1,198000,0,198000
2130,20,9,7,-1,2,252000,0,252000
2131,18,10,20,-1,2,207000,0,207000
2132,14,12,9,13,2,360000,150000,510000
2133,5,8,6,-1,2,336000,135000,471000
2134,9,20,11,-1,2,198000,0,198000
2135,5,19,9,-1,1,216000,0,216000
2136,16,19,13,-1,2,189000,0,189000
2137,12,15,20,-1,2,243000,0,243000
2138,15,12,16,-1,2,258000,15000,273000
2139,10,14,13,12,2,360000,165000,525000
2140,7,5,18,-1,2,276000,30000,306000
2141,14,6,10,-1,2,252000,15000,267000
2142,17,8,7,-1,2,237000,15000,252000
2143,16,13,7,-1,2,225000,0,225000
2144,10,12,13,-1,2,231000,15000,246000
2145,14,7,13,-1,2,246000,15000,261000
2146,5,17,12,13,2,336000,90000,426000
2147,18,16,19,-1,2,231000,15000,246000
2148,18,17,5,-1,2,264000,15000,279000
2149,18,14,12,-1,2,216000,0,216000
2150,11,16,8,-1,2,252000,0,252000
2151,17,18,11,-1,2,228000,15000,243000
2152,20,5,16,-1,1,216000,0,216000
2153,12,18,7,11,2,372000,235000,607000
2154,20,19,10,-1,2,264000,15000,279000
2155,7,15,7,-1,1,216000,0,216000
2156,18,9,17,-1,2,183000,15000,198000
2157,8,16,11,-1,2,234000,0,234000
2158,16,6,6,-1,1,198000,0,198000
2159,8,5,9,-1,2,231000,15000,246000
2160,19,18,10,13,2,315000,60000,375000
2161,5,6,18,-1,2,276000,30000,306000
2162,18,12,10,-1,2,225000,0,225000
2163,15,20,11,-1,1,180000,0,180000
2164,18,7,13,-1,2,252000,15000,267000
2165,19,6,14,-1,1,216000,0,216000
2166,13,19,10,-1,2,234000,0,234000
2167,19,6,7,11,2,396000,220000,616000
2168,12,20,18,-1,2,234000,0,234000
2169,5,9,12,-1,2,276000,30000,306000
2170,11,18,17,-1,2,210000,15000,225000
2171,7,6,8,-1,2,300000,45000,345000
2172,20,8,11,-1,2,198000,0,198000
2173,15,18,17,-1,2,195000,15000,210000
2174,6,16,11,12,2,360000,360000,720000
2175,10,9,6,-1,2,288000,30000,318000
2176,20,10,16,-1,1,144000,0,144000
2177,18,6,15,-1,2,252000,0,252000
2178,17,20,12,-1,2,216000,0,216000
2179,16,17,6,-1,2,264000,15000,279000
2180,6,20,14,-1,1,216000,0,216000
2181,7,18,12,13,2,348000,165000,513000
2182,18,9,17,-1,2,228000,15000,243000
2183,11,17,17,-1,1,171000,0,171000
2184,19,6,14,-1,1,189000,0,189000
2185,10,11,5,-1,2,264000,15000,279000
2186,6,20,11,-1,1,189000,0,189000
2187,13,18,6,-1,1,216000,0,216000
2188,16,8,9,13,2,372000,160000,532000
2189,16,14,12,-1,2,258000,0,258000
2190,15,6,16,-1,2,264000,15000,279000
2191,13,15,18,-1,2,171000,0,171000
2192,19,17,11,-1,2,243000,0,243000
2193,20,8,14,-1,1,216000,0,216000
2194,19,18,17,-1,2,207000,30000,237000
2195,8,6,6,13,2,360000,215000,575000
2196,13,14,14,-1,2,219000,15000,234000
2197,10,18,8,-1,2,198000,0,198000
2198,19,7,12,-1,1,198000,0,198000
2199,19,14,8,-1,1,207000,0,207000
2200,13,17,18,-1,2,219000,15000,234000
2201,10,17,13,-1,2,252000,0,252000
2202,8,15,12,13,2,348000,305000,653000
2203,6,19,11,-1,1,216000,0,216000
2204,5,7,19,-1,2,252000,0,252000
2205,12,9,13,-1,2,222000,15000,237000
2206,19,15,11,-1,1,162000,0,162000
2207,11,15,12,-1,2,288000,15000,303000
2208,5,8,13,-1,2,252000,0,252000
2209,6,13,9,11,2,360000,135000,495000
2210,14,19,8,-1,1,216000,0,216000
2211,16,18,6,-1,2,252000,0,252000
2212,16,10,15,-1,2,228000,15000,243000
2213,12,5,16,-1,1,216000,0,216000
2214,6,8,13,-1,2,252000,0,252000
2215,10,9,20,-1,2,219000,15000,234000
2216,8,18,9,11,2,372000,105000,477000
2217,5,8,16,-1,2,264000,15000,279000
2218,18,7,5,-1,2,252000,0,252000
2219,11,15,20,-1,1,153000,0,153000
2220,5,6,16,-1,2,276000,30000,306000
2221,18,13,20,-1,2,198000,0,198000
2222,12,15,11,-1,2,279000,15000,294000
2223,11,20,17,12,2,360000,75000,435000
2224,17,12,11,-1,2,264000,15000,279000
2225,15,7,17,-1,2,252000,0,252000
2226,10,7,13,-1,2,234000,0,234000
2227,19,16,12,-1,2,189000,0,189000
2228,6,14,15,-1,2,264000,15000,279000
2229,12,9,15,-1,2,234000,0,234000
2230,5,19,16,11,2,360000,60000,420000
2231,15,18,20,-1,2,240000,0,240000
2232,14,18,11,-1,2,252000,0,252000
2233,10,12,18,-1,2,243000,0,243000
2234,8,6,10,-1,2,288000,15000,303000
2235,13,5,20,-1,1,180000,0,180000
2236,18,11,14,-1,2,198000,0,198000
2237,14,9,13,12,2,360000,195000,555000
2238,13,19,11,-1,1,207000,0,207000
2239,17,5,16,-1,2,255000,15000,270000
2240,14,19,13,-1,2,192000,15000,207000
2241,16,9,11,-1,2,252000,0,252000
2242,6,12,7,-1,2,264000,15000,279000
2243,20,7,10,-1,2,225000,0,225000
2244,18,16,6,12,2,348000,45000,393000
2245,10,12,6,-1,2,276000,30000,306000
2246,12,6,19,-1,1,207000,0,207000
2247,20,5,17,-1,2,225000,0,225000
2248,12,9,7,-1,2,252000,0,252000
2249,12,9,8,-1,2,252000,15000,267000
2250,5,10,18,-1,1,198000,0,198000
2251,11,17,15,13,2,336000,120000,456000
2252,8,11,10,-1,2,300000,45000,345000
2253,11,12,20,-1,2,201000,15000,216000
2254,10,8,7,-1,2,300000,45000,345000
2255,10,13,11,-1,2,216000,30000,246000
2256,6,18,11,-1,1,207000,0,207000
2257,9,17,11,-1,2,225000,0,225000
2258,5,18,15,11,2,360000,60000,420000
2259,9,15,18,-1,2,252000,0,252000
2260,9,17,14,-1,2,243000,0,243000
2261,16,9,18,-1,2,234000,0,234000
2262,11,18,8,-1,2,234000,0,234000
2263,12,10,18,-1,2,216000,0,216000
2264,11,10,7,-1,2,276000,15000,291000
2265,17,19,15,12,2,327000,0,327000
2266,13,10,9,-1,2,300000,30000,330000
2267,18,5,10,-1,1,207000,0,207000
2268,19,18,12,-1,2,201000,15000,216000
2269,7,16,17,-1,2,264000,15000,279000
2270,19,15,6,-1,1,207000,0,207000
2271,8,5,19,-1,2,252000,0,252000
2272,14,10,5,13,2,348000,265000,613000
2273,16,15,18,-1,2,252000,30000,282000
2274,7,10,5,-1,2,312000,45000,357000
2275,6,17,19,-1,2,189000,0,189000
2276,7,13,18,-1,1,207000,0,207000
2277,14,17,6,-1,2,252000,0,252000
2278,19,15,16,-1,2,198000,15000,213000
2279,16,8,5,11,2,408000,370000,778000
2280,17,13,15,-1,2,258000,0,258000
2281,11,15,6,-1,2,252000,15000,267000
2282,20,16,14,-1,2,171000,0,171000
2283,16,19,13,-1,2,234000,0,234000
2284,5,17,12,-1,2,252000,15000,267000
2285,7,10,18,-1,2,252000,0,252000
2286,19,5,17,13,2,348000,45000,393000
2287,15,6,9,-1,2,300000,30000,330000
2288,13,11,14,-1,2,222000,15000,237000
2289,16,19,20,-1,2,186000,15000,201000
2290,8,15,18,-1,2,264000,15000,279000
2291,16,9,14,-1,2,252000,0,252000
2292,12,18,9,-1,2,225000,0,225000
2293,6,15,20,12,2,360000,60000,420000
2294,10,8,20,-1,2,252000,0,252000
2295,12,6,20,-1,1,216000,0,216000
2296,9,16,7,-1,2,252000,0,252000
2297,16,14,12,-1,2,213000,0,213000
2298,17,18,5,-1,2,246000,15000,261000
2299,17,19,18,-1,2,189000,30000,219000
2300,16,19,6,13,2,348000,260000,608000
2301,16,6,7,-1,2,264000,15000,279000
2302,7,13,10,-1,2,243000,0,243000
2303,15,20,18,-1,2,186000,0,186000
2304,12,20,17,-1,2,243000,0,243000
2305,9,8,5,-1,2,312000,90000,402000
2306,7,10,8,-1,2,252000,30000,282000
2307,16,7,12,11,2,336000,60000,396000
2308,13,9,16,-1,2,243000,0,243000
2309,12,11,16,-1,2,228000,15000,243000
2310,17,14,20,-1,2,198000,0,198000
2311,12,20,8,-1,1,216000,0,216000
2312,18,6,5,-1,2,288000,45000,333000
2313,15,5,10,-1,1,216000,0,216000
2314,6,20,18,13,2,336000,45000,381000
2315,12,17,14,-1,2,225000,0,225000
2316,11,20,5,-1,1,216000,0,216000
2317,20,7,13,-1,1,207000,0,207000
2318,10,19,18,-1,2,237000,15000,252000
2319,11,12,10,-1,2,261000,30000,291000
2320,17,16,6,-1,2,237000,15000,252000
2321,6,19,20,11,2,312000,30000,342000
2322,6,9,14,-1,1,216000,0,216000
2323,13,19,14,-1,2,201000,15000,216000
2324,17,19,10,-1,2,252000,0,252000
2325,14,8,18,-1,1,207000,0,207000
2326,6,10,13,-1,2,264000,15000,279000
2327,18,15,8,-1,2,225000,0,225000
2328,16,18,7,13,2,348000,75000,423000
2329,13,7,9,-1,2,300000,30000,330000
2330,8,15,10,-1,2,216000,0,216000
2331,6,15,17,-1,2,234000,0,234000
2332,19,12,8,-1,1,180000,0,180000
2333,14,16,13,-1,2,243000,30000,273000
2334,11,16,6,-1,1,216000,0,216000
2335,7,5,6,12,2,408000,330000,738000
2336,15,17,18,-1,2,222000,15000,237000
2337,12,17,9,-1,2,252000,0,252000
2338,7,20,5,-1,2,252000,0,252000
2339,8,9,19,-1,2,237000,15000,252000
2340,11,12,8,-1,2,249000,15000,264000
2341,20,16,14,-1,2,162000,0,162000
2342,6,10,9,12,2,396000,490000,886000
2343,16,9,19,-1,2,225000,0,225000
2344,6,9,20,-1,2,252000,0,252000
2345,14,9,20,-1,1,171000,0,171000
2346,18,9,13,-1,1,216000,0,216000
2347,9,12,14,-1,2,276000,0,276000
2348,14,10,15,-1,2,219000,15000,234000
2349,19,11,6,12,2,360000,230000,590000
2350,14,11,7,-1,2,300000,45000,345000
2351,6,9,8,-1,2,267000,15000,282000
2352,14,11,19,-1,2,162000,0,162000
2353,10,9,5,-1,2,288000,45000,333000
2354,9,8,10,-1,2,252000,30000,282000
2355,8,19,17,-1,2,198000,0,198000
2356,10,6,14,13,2,348000,315000,663000
2357,13,5,15,-1,2,276000,30000,306000
2358,8,14,10,-1,2,243000,0,243000
2359,5,11,14,-1,2,252000,0,252000
2360,20,9,7,-1,2,216000,0,216000
2361,7,19,11,-1,1,189000,0,189000
2362,9,14,8,-1,2,255000,15000,270000
2363,19,9,6,13,2,360000,155000,515000
2364,15,16,12,-1,2,258000,15000,273000
2365,18,15,16,-1,2,225000,30000,255000
2366,12,17,15,-1,2,258000,0,258000
2367,11,19,17,-1,2,225000,0,225000
2368,7,8,11,-1,2,300000,30000,330000
2369,11,18,18,-1,1,135000,0,135000
2370,18,16,12,13,2,327000,105000,432000
2371,15,9,10,-1,2,300000,30000,330000
2372,12,19,10,-1,2,207000,0,207000
2373,12,13,6,-1,2,264000,15000,279000
2374,19,20,8,-1,2,201000,15000,216000
2375,18,9,6,-1,2,252000,0,252000
2376,17,13,16,-1,2,213000,15000,228000
2377,8,20,11,12,2,372000,245000,617000
2378,10,9,7,-1,2,264000,15000,279000
2379,14,7,9,-1,2,207000,0,207000
2380,8,9,15,-1,2,228000,15000,243000
2381,19,6,14,-1,1,207000,0,207000
2382,10,5,19,-1,1,216000,0,216000
2383,16,14,6,-1,2,252000,0,252000
2384,17,18,8,11,2,336000,75000,411000
2385,5,11,9,-1,2,300000,45000,345000
2386,10,13,15,-1,2,222000,0,222000
2387,14,13,12,-1,2,234000,30000,264000
2388,16,5,13,-1,2,252000,0,252000
2389,14,6,18,-1,1,207000,0,207000
2390,13,9,16,-1,2,225000,0,225000
2391,15,7,20,11,2,360000,60000,420000
2392,17,14,10,-1,2,264000,15000,279000
2393,12,7,17,-1,1,216000,0,216000
2394,13,11,10,-1,2,270000,30000,300000
2395,6,7,19,-1,2,255000,15000,270000
2396,18,17,14,-1,2,177000,15000,192000
2397,12,7,8,-1,2,312000,45000,357000
2398,17,12,5,11,2,336000,60000,396000
2399,17,19,6,-1,2,252000,0,252000
2400,8,18,6,-1,2,252000,0,252000
2401,8,12,7,-1,2,228000,15000,243000
2402,13,7,9,-1,2,225000,0,225000
2403,13,13,17,-1,1,135000,0,135000
2404,10,13,14,-1,2,231000,15000,246000
2405,17,10,15,12,2,348000,105000,453000
2406,18,12,7,-1,2,252000,15000,267000
2407,7,19,17,-1,2,243000,0,243000
2408,15,13,10,-1,2,240000,0,240000
2409,19,9,5,-1,1,216000,0,216000
2410,10,14,8,-1,2,234000,0,234000
2411,16,6,18,-1,2,225000,0,225000
2412,19,14,12,11,2,348000,75000,423000
2413,16,9,15,-1,2,264000,15000,279000
2414,6,14,5,-1,2,264000,15000,279000
2415,16,19,15,-1,2,189000,15000,204000
2416,16,19,13,-1,2,225000,0,225000
2417,9,6,8,-1,2,312000,90000,402000
2418,17,13,5,-1,1,198000,0,198000
2419,6,20,8,11,2,324000,150000,474000
2420,10,9,20,-1,2,264000,15000,279000
2421,17,10,6,-1,1,216000,0,216000
2422,6,16,19,-1,2,252000,0,252000
2423,13,19,8,-1,1,207000,0,207000
2424,8,20,10,-1,2,252000,0,252000
2425,7,6,7,-1,2,210000,15000,225000
2426,17,10,11,12,2,318000,120000,438000
2427,6,7,8,-1,2,312000,60000,372000
2428,6,16,8,-1,2,216000,0,216000
2429,11,20,15,-1,1,144000,0,144000
2430,15,18,9,-1,2,252000,0,252000
2431,18,13,9,-1,1,216000,0,216000
2432,19,5,7,-1,2,252000,0,252000
2433,18,15,6,11,2,360000,60000,420000
2434,7,9,17,-1,2,252000,0,252000
2435,16,12,8,-1,1,207000,0,207000
2436,13,12,17,-1,2,228000,15000,243000
2437,8,9,12,-1,2,300000,30000,330000
2438,5,11,15,-1,1,198000,0,198000
2439,5,10,20,-1,1,216000,0,216000
2440,7,5,11,12,2,372000,255000,627000
2441,11,9,13,-1,2,276000,0,276000
2442,16,15,14,-1,2,198000,30000,228000
2443,14,16,15,-1,2,243000,30000,273000
2444,5,13,15,-1,2,252000,0,252000
2445,20,5,15,-1,1,207000,0,207000
2446,11,14,7,-1,2,252000,0,252000
2447,11,19,7,12,2,348000,90000,438000
2448,14,20,10,-1,1,216000,0,216000
2449,8,9,18,-1,2,264000,15000,279000
2450,19,15,10,-1,1,198000,0,198000
2451,9,20,16,-1,1,216000,0,216000
2452,16,12,7,-1,2,252000,15000,267000
2453,16,16,19,-1,2,171000,0,171000
2454,15,16,14,12,2,348000,75000,423000
2455,11,9,13,-1,2,288000,15000,303000
2456,15,8,16,-1,2,237000,15000,252000
2457,9,12,5,-1,2,252000,0,252000
2458,8,15,12,-1,2,207000,0,207000
2459,12,6,16,-1,1,216000,0,216000
2460,6,7,11,-1,2,264000,15000,279000
2461,18,19,13,11,2,336000,30000,366000
2462,6,7,9,-1,2,312000,60000,372000
2463,7,8,15,-1,2,228000,15000,243000
2464,5,7,15,-1,2,243000,0,243000
2465,20,18,19,-1,2,132000,30000,162000
2466,14,10,11,-1,2,252000,0,252000
2467,14,16,13,-1,2,207000,30000,237000
2468,20,6,12,11,2,372000,205000,577000
2469,17,13,14,-1,2,270000,15000,285000
2470,18,17,13,-1,2,219000,15000,234000
2471,7,8,13,-1,2,300000,30000,330000
2472,15,8,17,-1,2,216000,0,216000
2473,8,18,16,-1,2,225000,0,225000
2474,7,16,13,-1,2,234000,0,234000
2475,20,13,5,13,2,264000,0,264000
2476,5,18,20,-1,2,243000,0,243000
2477,13,14,8,-1,2,255000,15000,270000
2478,9,13,8,-1,2,237000,15000,252000
2479,8,18,9,-1,2,237000,15000,252000
2480,10,6,5,-1,2,264000,15000,279000
2481,7,10,12,-1,2,231000,0,231000
2482,20,18,12,11,2,324000,30000,354000
2483,11,20,5,-1,1,216000,0,216000
2484,6,14,18,-1,1,216000,0,216000
2485,20,6,5,-1,2,276000,30000,306000
2486,10,14,11,-1,2,252000,15000,267000
2487,20,14,13,-1,2,192000,15000,207000
2488,12,16,11,-1,2,255000,15000,270000
2489,19,11,15,13,2,348000,150000,498000
2490,7,14,17,-1,2,243000,0,243000
2491,5,20,18,-1,2,198000,0,198000
2492,16,15,19,-1,2,216000,15000,231000
2493,17,20,11,-1,2,243000,0,243000
2494,12,13,19,-1,2,237000,15000,252000
2495,7,9,20,-1,2,252000,0,252000
2496,6,19,17,12,2,348000,45000,393000
2497,16,10,8,-1,2,252000,0,252000
2498,11,9,18,-1,2,243000,0,243000
2499,5,12,8,-1,2,252000,0,252000
2500,19,15,16,-1,2,189000,15000,204000
2501,16,13,20,-1,2,225000,0,225000
2502,11,9,19,-1,2,252000,0,252000
2503,10,14,6,12,2,360000,345000,705000
2504,11,5,12,-1,2,300000,75000,375000
2505,12,16,15,-1,2,213000,15000,228000
2506,13,6,18,-1,1,216000,0,216000
2507,8,16,18,-1,2,252000,0,252000
2508,9,7,14,-1,2,234000,0,234000
2509,17,5,11,-1,1,207000,0,207000
2510,11,7,12,12,2,300000,60000,360000
2511,10,16,9,-1,2,246000,15000,261000
2512,6,13,11,-1,2,252000,0,252000
2513,14,11,9,-1,2,198000,0,198000
2514,18,16,6,-1,2,234000,0,234000
2515,8,10,11,-1,2,249000,15000,264000
2516,13,9,10,-1,2,234000,15000,249000
2517,6,9,17,11,2,360000,90000,450000
2518,16,5,11,-1,2,252000,15000,267000
2519,20,5,15,-1,1,207000,0,207000
2520,15,12,8,-1,2,243000,0,243000
2521,7,6,11,-1,2,264000,15000,279000
2522,5,9,16,-1,1,198000,0,198000
2523,20,5,12,-1,1,216000,0,216000
2524,11,6,16,12,2,348000,135000,483000
2525,10,15,17,-1,2,252000,0,252000
2526,16,17,15,-1,2,225000,30000,255000
2527,17,12,9,-1,2,252000,0,252000
2528,13,18,10,-1,2,234000,0,234000
2529,5,6,15,-1,2,264000,15000,279000
2530,6,18,8,-1,2,243000,0,243000
2531,18,7,10,13,2,348000,30000,378000
2532,6,9,14,-1,2,288000,15000,303000
2533,8,6,5,-1,2,279000,30000,309000
2534,18,5,16,-1,2,180000,0,180000
2535,9,10,15,-1,2,228000,15000,243000
2536,7,8,17,-1,2,255000,15000,270000
2537,8,14,11,-1,2,216000,0,216000
2538,18,15,8,11,2,360000,90000,450000
2539,8,7,10,-1,2,312000,60000,372000
2540,20,16,14,-1,2,162000,0,162000
2541,10,13,15,-1,2,288000,15000,303000
2542,7,11,20,-1,1,207000,0,207000
2543,9,17,19,-1,2,234000,0,234000
2544,6,12,14,-1,2,252000,0,252000
2545,12,13,9,12,2,300000,75000,375000
2546,6,10,20,-1,1,207000,0,207000
2547,16,7,5,-1,2,252000,0,252000
2548,13,5,15,-1,2,234000,0,234000
2549,8,6,12,-1,2,216000,0,216000
2550,19,10,6,-1,1,189000,0,189000
2551,5,17,19,-1,2,225000,0,225000
2552,15,19,9,11,2,360000,90000,450000
2553,9,19,16,-1,2,252000,0,252000
2554,9,13,20,-1,1,207000,0,207000
2555,5,13,9,-1,2,264000,30000,294000
2556,13,15,5,-1,2,252000,0,252000
2557,8,6,13,-1,2,216000,0,216000
2558,20,11,6,-1,1,189000,0,189000
2559,18,7,13,12,2,348000,75000,423000
2560,6,17,12,-1,2,252000,15000,267000
2561,17,6,5,-1,2,264000,15000,279000
2562,8,11,5,-1,2,252000,0,252000
2563,18,17,19,-1,2,162000,30000,192000
2564,5,11,7,-1,2,324000,60000,384000
2565,15,10,12,-1,2,189000,0,189000
2566,7,14,19,12,2,360000,75000,435000
2567,11,13,17,-1,2,252000,0,252000
2568,17,7,14,-1,2,252000,0,252000
2569,8,8,12,-1,1,198000,0,198000
2570,11,12,19,-1,2,165000,15000,180000
2571,19,7,18,-1,2,246000,15000,261000
2572,7,10,13,-1,2,252000,0,252000
2573,6,5,17,11,2,384000,195000,579000
2574,18,6,13,-1,1,216000,0,216000
2575,14,8,13,-1,2,264000,15000,279000
2576,16,13,10,-1,2,207000,0,207000
2577,19,10,12,-1,2,234000,0,234000
2578,17,9,19,-1,2,234000,0,234000
2579,9,16,18,-1,2,225000,0,225000
2580,8,10,9,13,2,372000,245000,617000
2581,12,14,9,-1,2,288000,15000,303000
2582,13,10,19,-1,2,207000,0,207000
2583,9,11,8,-1,2,288000,30000,318000
2584,5,7,8,-1,2,258000,15000,273000
2585,16,19,18,-1,2,132000,15000,147000
2586,10,18,16,-1,2,252000,0,252000
2587,13,18,9,11,2,372000,165000,537000
2588,5,20,14,-1,1,216000,0,216000
2589,5,8,6,-1,2,324000,105000,429000
2590,12,13,11,-1,2,216000,30000,246000
2591,7,13,10,-1,2,243000,0,243000
2592,7,5,18,-1,2,252000,0,252000
2593,10,19,9,-1,2,201000,15000,216000
2594,11,19,14,13,2,348000,105000,453000
2595,12,10,9,-1,2,300000,45000,345000
2596,19,8,18,-1,2,219000,15000,234000
2597,13,18,15,-1,2,198000,0,198000
2598,19,6,7,-1,2,264000,15000,279000
2599,13,20,11,-1,2,216000,0,216000
2600,17,10,9,-1,2,255000,15000,270000
2601,9,17,13,11,2,360000,150000,510000
2602,7,19,9,-1,2,252000,0,252000
2603,18,11,13,-1,2,216000,0,216000
2604,17,8,7,-1,2,264000,15000,279000
2605,11,6,8,-1,2,243000,0,243000
2606,12,18,20,-1,2,171000,0,171000
2607,6,17,13,-1,1,216000,0,216000
2608,17,11,12,13,2,360000,195000,555000
2609,7,13,16,-1,2,252000,0,252000
2610,13,11,8,-1,2,240000,0,240000
2611,19,17,10,-1,2,198000,0,198000
2612,10,8,19,-1,2,243000,0,243000
2613,8,6,12,-1,2,243000,0,243000
2614,9,17,8,-1,2,219000,15000,234000
2615,16,13,15,12,2,348000,120000,468000
2616,6,17,7,-1,2,264000,15000,279000
2617,15,18,19,-1,2,204000,15000,219000
2618,19,15,8,-1,1,216000,0,216000
2619,20,19,15,-1,2,228000,15000,243000
2620,12,16,5,-1,2,264000,30000,294000
2621,5,6,9,-1,2,312000,45000,357000
2622,5,12,5,11,2,288000,30000,318000
2623,20,9,14,-1,1,162000,0,162000
2624,20,18,11,-1,2,234000,0,234000
2625,18,16,8,-1,2,252000,0,252000
2626,11,18,5,-1,1,216000,0,216000
2627,19,5,18,-1,2,219000,15000,234000
2628,6,16,8,-1,2,252000,0,252000
2629,20,15,6,13,2,324000,30000,354000
2630,5,15,11,-1,2,264000,30000,294000
2631,18,16,9,-1,2,234000,0,234000
2632,14,10,17,-1,2,216000,0,216000
2633,10,7,20,-1,2,252000,0,252000
2634,19,16,13,-1,2,189000,0,189000
2635,15,11,12,-1,2,288000,15000,303000
2636,16,18,17,13,2,348000,45000,393000
2637,16,15,18,-1,2,252000,30000,282000
2638,7,13,10,-1,2,300000,30000,330000
2639,9,18,5,-1,1,207000,0,207000
2640,11,14,6,-1,2,243000,0,243000
2641,20,6,15,-1,1,189000,0,189000
2642,14,7,10,-1,2,252000,0,252000
2643,18,16,5,11,2,348000,45000,393000
2644,6,20,7,-1,2,264000,15000,279000
2645,18,11,9,-1,2,234000,0,234000
2646,15,8,9,-1,2,246000,15000,261000
2647,12,9,20,-1,2,216000,0,216000
2648,10,5,7,-1,2,288000,15000,303000
2649,8,12,19,-1,1,153000,0,153000
2650,11,10,7,12,2,384000,375000,759000
2651,16,20,7,-1,1,216000,0,216000
2652,6,13,12,-1,2,288000,45000,333000
2653,18,20,5,-1,2,216000,0,216000
2654,17,9,6,-1,2,252000,0,252000
2655,14,7,8,-1,2,246000,15000,261000
2656,12,17,5,-1,1,207000,0,207000
2657,18,17,12,13,2,348000,90000,438000
2658,13,10,8,-1,2,300000,30000,330000
2659,14,17,18,-1,2,186000,15000,201000
2660,19,5,9,-1,2,252000,15000,267000
2661,16,14,15,-1,2,225000,30000,255000
2662,5,7,8,-1,2,300000,45000,345000
2663,16,11,18,-1,2,171000,0,171000
2664,11,17,14,13,2,348000,165000,513000
2665,12,10,19,-1,1,207000,0,207000
2666,5,18,19,-1,2,228000,15000,243000
2667,13,10,6,-1,2,264000,15000,279000
2668,12,8,18,-1,1,180000,0,180000
2669,18,13,19,-1,2,219000,15000,234000
2670,17,11,16,-1,2,255000,15000,270000
2671,17,20,15,11,2,348000,45000,393000
2672,5,10,12,-1,2,252000,0,252000
2673,5,18,12,-1,1,189000,0,189000
2674,11,6,19,-1,1,207000,0,207000
2675,6,17,12,-1,1,216000,0,216000
2676,15,6,12,-1,2,252000,0,252000
2677,14,19,13,-1,2,183000,15000,198000
2678,11,8,10,12,2,384000,375000,759000
2679,17,11,19,-1,2,252000,0,252000
2680,14,16,15,-1,2,243000,30000,273000
2681,19,5,8,-1,2,252000,0,252000
2682,13,11,16,-1,2,216000,0,216000
2683,11,7,17,-1,1,216000,0,216000
2684,7,9,17,-1,2,252000,0,252000
2685,5,9,13,12,2,348000,315000,663000
2686,17,11,19,-1,2,252000,0,252000
2687,12,7,13,-1,2,264000,15000,279000
2688,13,11,10,-1,2,243000,30000,273000
2689,10,17,11,-1,2,219000,15000,234000
2690,20,9,12,-1,2,234000,0,234000
2691,19,12,20,-1,2,219000,15000,234000
2692,20,17,9,13,2,348000,60000,408000
2693,15,20,13,-1,1,189000,0,189000
2694,13,11,16,-1,2,234000,0,234000
2695,11,12,9,-1,2,267000,15000,282000
2696,7,9,12,-1,2,225000,0,225000
2697,11,18,8,-1,2,216000,0,216000
2698,8,13,15,-1,2,234000,0,234000
2699,15,13,8,11,2,360000,165000,525000
2700,14,11,6,-1,2,276000,30000,306000
2701,8,16,18,-1,2,234000,0,234000
2702,7,12,11,-1,2,246000,15000,261000
2703,18,8,10,-1,2,216000,0,216000
2704,11,16,8,-1,2,225000,0,225000
2705,12,9,15,-1,2,225000,0,225000
2706,12,16,13,11,2,360000,120000,480000
2707,9,18,16,-1,2,252000,0,252000
2708,19,16,14,-1,2,198000,0,198000
2709,14,19,20,-1,2,237000,15000,252000
2710,15,20,5,-1,1,216000,0,216000
2711,11,9,7,-1,2,300000,30000,330000
2712,7,12,20,-1,1,189000,0,189000
2713,11,7,14,12,2,360000,305000,665000
2714,11,14,5,-1,2,300000,45000,345000
2715,7,20,11,-1,1,198000,0,198000
2716,19,7,18,-1,2,237000,15000,252000
2717,15,14,18,-1,2,225000,15000,240000
2718,18,13,7,-1,1,216000,0,216000
2719,20,13,18,-1,2,216000,0,216000
2720,17,14,15,11,2,372000,135000,507000
2721,14,20,16,-1,1,171000,0,171000
2722,8,19,16,-1,2,252000,0,252000
2723,6,12,5,-1,2,300000,30000,330000
2724,6,18,16,-1,2,198000,0,198000
2725,19,18,20,-1,2,159000,30000,189000
2726,10,13,9,-1,2,252000,0,252000
2727,11,18,12,13,2,348000,135000,483000
2728,6,10,9,-1,2,300000,45000,345000
2729,19,5,7,-1,2,234000,0,234000
2730,19,7,14,-1,1,180000,0,180000
2731,16,9,8,-1,2,255000,15000,270000
2732,16,6,5,-1,2,264000,15000,279000
2733,15,10,17,-1,2,180000,0,180000
2734,17,13,8,11,2,372000,195000,567000
2735,19,10,12,-1,2,252000,0,252000
2736,13,7,11,-1,2,264000,15000,279000
2737,17,6,7,-1,2,246000,15000,261000
2738,8,6,9,-1,2,249000,15000,264000
2739,14,17,11,-1,2,162000,0,162000
2740,14,9,6,-1,2,288000,15000,303000
2741,6,16,8,11,2,360000,155000,515000
2742,8,20,18,-1,2,234000,0,234000
2743,8,18,12,-1,1,207000,0,207000
2744,20,14,19,-1,2,210000,15000,225000
2745,18,6,16,-1,2,252000,0,252000
2746,19,15,14,-1,2,210000,15000,225000
2747,14,6,8,-1,2,300000,30000,330000
2748,5,11,16,13,2,336000,120000,456000
2749,19,14,10,-1,1,216000,0,216000
2750,11,19,14,-1,2,243000,0,243000
2751,16,19,18,-1,2,213000,15000,228000
2752,13,20,6,-1,1,216000,0,216000
2753,15,7,6,-1,2,276000,30000,306000
2754,17,15,18,-1,2,204000,15000,219000
2755,20,9,7,12,2,396000,230000,626000
2756,5,20,13,-1,1,216000,0,216000
2757,18,20,12,-1,2,243000,0,243000
2758,12,15,7,-1,2,264000,15000,279000
2759,18,8,9,-1,2,246000,15000,261000
2760,17,10,6,-1,1,207000,0,207000
2761,14,13,9,-1,2,237000,15000,252000
2762,6,18,8,13,2,360000,155000,515000
2763,16,9,14,-1,2,252000,0,252000
2764,7,10,13,-1,2,252000,0,252000
2765,9,16,15,-1,2,228000,15000,243000
2766,17,11,9,-1,2,225000,0,225000
2767,17,5,18,-1,2,237000,15000,252000
2768,9,16,6,-1,2,252000,0,252000
2769,7,18,17,13,2,336000,45000,381000
2770,18,6,20,-1,2,252000,0,252000
2771,14,12,17,-1,2,216000,0,216000
2772,20,18,7,-1,2,243000,0,243000
2773,5,12,8,-1,2,288000,15000,303000
2774,18,16,8,-1,2,198000,0,198000
2775,18,11,17,-1,2,210000,15000,225000
2776,6,18,15,12,2,360000,90000,450000
2777,10,13,15,-1,2,288000,15000,303000
2778,17,11,16,-1,2,228000,15000,243000
2779,11,7,14,-1,2,264000,15000,279000
2780,8,12,10,-1,2,249000,0,249000
2781,13,9,8,-1,2,219000,15000,234000
2782,6,15,14,-1,2,255000,15000,270000
2783,10,16,15,13,2,336000,120000,456000
2784,15,9,12,-1,2,288000,15000,303000
2785,13,16,18,-1,2,204000,0,204000
2786,19,7,15,-1,1,216000,0,216000
2787,14,17,12,-1,2,225000,0,225000
2788,20,18,14,-1,2,207000,0,207000
2789,17,19,10,-1,2,252000,0,252000
2790,11,17,20,13,2,348000,90000,438000
2791,7,11,16,-1,1,216000,0,216000
2792,18,11,16,-1,2,198000,0,198000
2793,13,10,14,-1,2,258000,15000,273000
2794,8,12,16,-1,1,198000,0,198000
2795,12,6,10,-1,2,264000,15000,279000
2796,13,15,19,-1,2,171000,0,171000
2797,16,15,8,12,2,360000,195000,555000
2798,9,8,12,-1,2,252000,0,252000
2799,8,15,14,-1,2,228000,15000,243000
2800,12,13,6,-1,2,255000,15000,270000
2801,5,11,16,-1,1,198000,0,198000
2802,18,7,6,-1,2,255000,15000,270000
2803,10,17,19,-1,2,189000,0,189000
2804,5,12,19,13,2,348000,135000,483000
2805,8,17,9,-1,2,252000,0,252000
2806,8,20,5,-1,2,225000,0,225000
2807,14,5,17,-1,2,234000,0,234000
2808,10,11,12,-1,2,234000,30000,264000
2809,5,10,19,-1,1,216000,0,216000
2810,5,12,11,-1,2,264000,15000,279000
2811,11,9,7,13,2,348000,200000,548000
2812,18,6,15,-1,2,252000,0,252000
2813,19,20,17,-1,2,168000,15000,183000
2814,14,9,15,-1,2,276000,30000,306000
2815,6,14,12,-1,2,252000,0,252000
2816,16,17,13,-1,2,204000,15000,219000
2817,9,17,20,-1,2,252000,0,252000
2818,19,16,15,13,2,348000,60000,408000
2819,13,20,14,-1,2,255000,15000,270000
2820,18,9,12,-1,2,252000,0,252000
2821,19,15,9,-1,1,207000,0,207000
2822,16,9,19,-1,2,252000,0,252000
2823,9,8,14,-1,2,255000,15000,270000
2824,12,9,10,-1,2,252000,30000,282000
2825,20,13,17,12,2,312000,30000,342000
2826,20,10,6,-1,2,252000,15000,267000
2827,16,5,20,-1,1,216000,0,216000
2828,8,16,7,-1,2,264000,15000,279000
2829,10,18,8,-1,2,234000,0,234000
2830,12,14,7,-1,2,234000,0,234000
2831,11,15,13,-1,2,213000,0,213000
2832,5,14,17,12,2,348000,90000,438000
2833,19,20,14,-1,2,237000,15000,252000
2834,15,14,18,-1,2,261000,15000,276000
2835,20,6,16,-1,1,216000,0,216000
2836,19,12,8,-1,1,216000,0,216000
2837,13,18,11,-1,2,234000,0,234000
2838,5,17,16,-1,2,264000,15000,279000
2839,18,9,15,12,2,348000,90000,438000
2840,20,9,8,-1,2,264000,15000,279000
2841,18,7,19,-1,2,246000,15000,261000
2842,20,8,7,-1,2,264000,15000,279000
2843,17,5,9,-1,1,207000,0,207000
2844,20,13,19,-1,2,192000,15000,207000
2845,20,9,8,-1,2,264000,15000,279000
2846,15,6,12,13,2,348000,180000,528000
2847,7,11,13,-1,2,252000,0,252000
2848,9,5,13,-1,1,189000,0,189000
2849,12,10,15,-1,2,207000,0,207000
2850,10,18,14,-1,1,189000,0,189000
2851,7,13,9,-1,2,288000,15000,303000
2852,20,9,15,-1,1,171000,0,171000
2853,19,16,8,12,2,360000,190000,550000
2854,16,11,8,-1,1,216000,0,216000
2855,18,11,8,-1,2,225000,0,225000
2856,14,6,15,-1,2,264000,15000,279000
2857,16,13,6,-1,2,225000,0,225000
2858,14,6,16,-1,2,234000,0,234000
2859,9,11,6,-1,2,249000,0,249000
2860,8,18,20,11,2,312000,45000,357000
2861,18,18,17,-1,2,210000,15000,225000
2862,18,16,19,-1,2,186000,15000,201000
2863,20,10,19,-1,2,264000,15000,279000
2864,13,6,8,-1,2,252000,0,252000
2865,10,7,9,-1,2,258000,15000,273000
2866,10,9,7,-1,2,231000,15000,246000
2867,7,11,12,13,2,336000,135000,471000
2868,15,11,14,-1,2,258000,15000,273000
2869,19,16,13,-1,2,198000,0,198000
2870,8,17,18,-1,2,264000,15000,279000
2871,8,13,14,-1,2,264000,15000,279000
2872,20,16,11,-1,1,162000,0,162000
2873,16,6,16,-1,1,216000,0,216000
2874,10,11,7,13,2,348000,90000,438000
2875,5,8,9,-1,2,300000,45000,345000
2876,18,14,12,-1,2,171000,0,171000
2877,14,13,6,-1,2,264000,15000,279000
2878,7,5,11,-1,2,252000,0,252000
2879,7,13,18,-1,1,180000,0,180000
2880,12,19,14,-1,2,207000,0,207000
2881,7,16,13,12,2,360000,265000,625000
2882,18,19,10,-1,2,219000,15000,234000
2883,16,15,8,-1,2,255000,15000,270000
2884,5,19,17,-1,2,216000,0,216000
2885,13,10,7,-1,2,243000,0,243000
2886,12,15,9,-1,2,216000,0,216000
2887,18,8,9,-1,2,255000,15000,270000
2888,16,14,7,13,2,336000,90000,426000
2889,6,11,20,-1,1,216000,0,216000
2890,7,16,10,-1,2,288000,15000,303000
2891,10,19,15,-1,1,180000,0,180000
2892,11,8,16,-1,2,252000,0,252000
2893,6,20,15,-1,1,216000,0,216000
2894,17,9,19,-1,2,243000,0,243000
2895,10,9,13,13,2,324000,75000,399000
2896,7,18,6,-1,2,264000,15000,279000
2897,18,11,8,-1,2,207000,0,207000
2898,12,13,14,-1,2,234000,30000,264000
2899,11,19,10,-1,2,237000,15000,252000
2900,6,17,12,-1,1,216000,0,216000
2901,17,7,14,-1,2,252000,0,252000
2902,16,18,11,12,2,348000,90000,438000
2903,10,17,15,-1,2,252000,0,252000
2904,19,6,10,-1,1,216000,0,216000
2905,14,13,18,-1,2,219000,15000,234000
2906,12,20,15,-1,2,234000,0,234000
2907,6,7,8,-1,2,312000,60000,372000
2908,6,18,8,-1,2,225000,0,225000
2909,16,18,6,13,2,324000,15000,339000
2910,14,18,17,-1,2,240000,15000,255000
2911,7,11,15,-1,2,264000,30000,294000
2912,6,9,19,-1,2,252000,0,252000
2913,8,6,18,-1,2,234000,0,234000
2914,7,20,17,-1,2,198000,0,198000
2915,5,9,15,-1,1,216000,0,216000
2916,17,6,10,12,2,360000,300000,660000
2917,14,7,10,-1,2,300000,30000,330000
2918,20,17,5,-1,2,216000,0,216000
2919,8,17,6,-1,2,252000,0,252000
2920,16,6,18,-1,2,216000,0,216000
2921,20,17,6,-1,2,216000,0,216000
2922,15,14,19,-1,2,201000,15000,216000
2923,9,14,20,13,2,348000,235000,583000
2924,5,11,10,-1,2,276000,30000,306000
2925,5,11,8,-1,2,243000,0,243000
2926,18,6,7,-1,2,237000,15000,252000
2927,13,20,14,-1,2,174000,15000,189000
2928,14,15,10,-1,2,264000,15000,279000
2929,8,12,6,-1,2,252000,0,252000
2930,9,17,8,11,2,360000,90000,450000
2931,20,11,18,-1,2,234000,0,234000
2932,20,9,11,-1,2,243000,0,243000
2933,10,17,12,-1,2,216000,0,216000
2934,17,6,7,-1,2,264000,15000,279000
2935,17,13,14,-1,2,207000,15000,222000
2936,12,5,6,-1,2,300000,30000,330000
2937,20,11,8,12,2,300000,45000,345000
2938,20,7,15,-1,1,216000,0,216000
2939,5,10,14,-1,2,300000,45000,345000
2940,13,16,15,-1,2,204000,15000,219000
2941,18,9,16,-1,2,243000,0,243000
2942,10,16,9,-1,2,237000,15000,252000
2943,14,9,5,-1,1,216000,0,216000
2944,12,19,7,13,2,348000,90000,438000
2945,18,5,15,-1,2,264000,15000,279000
2946,7,20,5,-1,2,252000,0,252000
2947,9,5,16,-1,1,216000,0,216000
2948,11,16,5,-1,1,216000,0,216000
2949,12,16,20,-1,1,162000,0,162000
2950,18,7,10,-1,2,264000,15000,279000
2951,7,19,11,12,2,360000,300000,660000
2952,17,14,12,-1,2,234000,0,234000
2953,6,20,9,-1,2,252000,0,252000
2954,5,18,19,-1,2,210000,15000,225000
2955,20,7,15,-1,1,216000,0,216000
2956,13,15,19,-1,2,198000,0,198000
2957,14,15,16,-1,2,252000,30000,282000
2958,20,18,5,13,2,336000,90000,426000
2959,19,10,11,-1,2,237000,15000,252000
2960,8,19,14,-1,1,207000,0,207000
2961,18,11,18,-1,1,189000,0,189000
2962,14,12,6,-1,2,225000,0,225000
2963,12,10,11,-1,2,225000,30000,255000
2964,16,19,11,-1,2,198000,0,198000
2965,5,6,12,11,2,408000,335000,743000
2966,6,7,12,-1,2,312000,45000,357000
2967,18,19,16,-1,2,159000,15000,174000
2968,15,18,6,-1,2,252000,0,252000
2969,11,18,20,-1,2,234000,0,234000
2970,8,5,16,-1,2,252000,0,252000
2971,10,11,8,-1,2,258000,15000,273000
2972,11,16,6,13,2,324000,90000,414000
2973,14,20,19,-1,2,228000,15000,243000
2974,5,6,19,-1,2,276000,30000,306000
2975,7,15,19,-1,1,216000,0,216000
2976,5,20,10,-1,1,216000,0,216000
2977,11,12,5,-1,2,264000,15000,279000
2978,10,16,19,-1,2,198000,0,198000
2979,17,6,10,13,2,348000,340000,688000
2980,8,20,12,-1,1,216000,0,216000
2981,10,6,11,-1,2,264000,15000,279000
2982,10,18,13,-1,2,189000,0,189000
2983,6,13,12,-1,2,264000,15000,279000
2984,7,5,9,-1,2,276000,0,276000
2985,8,5,18,-1,2,207000,0,207000
2986,10,5,16,12,2,336000,120000,456000
2987,17,10,18,-1,2,255000,15000,270000
2988,7,13,18,-1,1,216000,0,216000
2989,9,14,8,-1,2,255000,15000,270000
2990,14,13,16,-1,2,216000,30000,246000
2991,5,19,12,-1,1,216000,0,216000
2992,16,17,18,-1,2,216000,30000,246000
2993,16,7,11,13,2,348000,385000,733000
2994,14,20,9,-1,1,207000,0,207000
2995,10,18,8,-1,2,252000,0,252000
2996,15,18,20,-1,2,195000,0,195000
2997,14,8,15,-1,2,276000,30000,306000
2998,5,9,20,-1,1,216000,0,216000
2999,6,15,20,-1,1,216000,0,216000
3000,19,7,14,12,2,360000,75000,435000
3001,8,5,17,-1,2,264000,15000,279000
3002,10,15,7,-1,2,252000,0,252000
3003,14,17,10,-1,2,216000,0,216000
3004,6,16,8,-1,2,252000,0,252000
3005,6,18,9,-1,2,243000,0,243000
3006,20,5,16,-1,1,180000,0,180000
3007,15,16,11,13,2,348000,165000,513000
3008,19,16,9,-1,2,225000,0,225000
3009,10,13,11,-1,2,252000,30000,282000
3010,7,20,15,-1,1,198000,0,198000
3011,20,19,7,-1,2,228000,15000,243000
3012,11,18,16,-1,2,225000,0,225000
3013,13,19,11,-1,2,225000,0,225000
3014,7,8,19,11,2,396000,285000,681000
3015,18,16,19,-1,2,222000,15000,237000
3016,18,20,19,-1,2,213000,30000,243000
3017,5,10,9,-1,2,276000,30000,306000
3018,19,16,12,-1,2,162000,0,162000
3019,9,20,14,-1,1,216000,0,216000
3020,11,6,14,-1,2,276000,30000,306000
3021,10,15,8,13,2,360000,160000,520000
3022,13,16,11,-1,2,243000,0,243000
3023,11,20,7,-1,1,216000,0,216000
3024,15,6,17,-1,2,252000,0,252000
3025,5,7,19,-1,2,243000,0,243000
3026,18,7,20,-1,2,189000,0,189000
3027,6,20,17,-1,2,234000,0,234000
3028,14,11,15,13,2,348000,135000,483000
3029,5,18,10,-1,2,252000,15000,267000
3030,6,16,16,-1,1,216000,0,216000
3031,16,19,10,-1,2,171000,0,171000
3032,9,8,14,-1,2,264000,15000,279000
3033,13,8,19,-1,1,189000,0,189000
3034,9,13,11,-1,2,267000,0,267000
3035,5,19,14,13,2,336000,60000,396000
3036,6,7,17,-1,2,264000,15000,279000
3037,19,6,9,-1,2,252000,0,252000
3038,13,20,10,-1,2,207000,0,207000
3039,13,5,14,-1,2,264000,15000,279000
3040,15,11,17,-1,2,198000,0,198000
3041,8,16,17,-1,2,264000,15000,279000
3042,8,7,15,13,2,372000,175000,547000
3043,10,13,14,-1,2,267000,15000,282000
3044,7,14,17,-1,2,243000,0,243000
3045,14,18,19,-1,2,183000,15000,198000
3046,11,19,16,-1,2,252000,0,252000
3047,11,5,18,-1,1,216000,0,216000
3048,14,10,8,-1,2,252000,0,252000
3049,13,9,18,12,2,360000,150000,510000
3050,5,15,17,-1,2,252000,0,252000
3051,8,8,14,-1,1,216000,0,216000
3052,8,17,18,-1,2,183000,15000,198000
3053,18,7,14,-1,1,207000,0,207000
3054,7,18,10,-1,2,252000,0,252000
3055,10,16,14,-1,2,207000,0,207000
3056,9,11,15,13,2,360000,135000,495000
3057,15,5,19,-1,1,216000,0,216000
3058,8,20,12,-1,1,216000,0,216000
3059,17,16,20,-1,2,243000,15000,258000
3060,19,8,6,-1,2,264000,15000,279000
3061,11,5,19,-1,1,216000,0,216000
3062,6,16,13,-1,2,252000,0,252000
3063,15,16,5,13,2,336000,60000,396000
3064,17,14,7,-1,2,264000,15000,279000
3065,16,9,16,-1,1,207000,0,207000
3066,15,8,12,-1,2,189000,0,189000
3067,12,19,20,-1,2,210000,15000,225000
3068,15,14,14,-1,2,219000,15000,234000
3069,20,12,13,-1,2,183000,15000,198000
3070,16,14,6,13,2,348000,150000,498000
3071,11,16,18,-1,2,234000,0,234000
3072,10,9,12,-1,2,252000,30000,282000
3073,8,10,11,-1,2,240000,15000,255000
3074,14,6,15,-1,2,237000,15000,252000
3075,19,12,14,-1,2,171000,0,171000
3076,5,9,11,-1,2,276000,30000,306000
3077,11,10,8,12,2,348000,135000,483000
3078,20,18,9,-1,2,243000,0,243000
3079,8,19,9,-1,2,255000,15000,270000
3080,8,10,11,-1,2,249000,15000,264000
3081,18,19,17,-1,2,162000,30000,192000
3082,20,16,15,-1,2,237000,15000,252000
3083,18,17,9,-1,2,264000,15000,279000
3084,11,9,17,13,2,372000,260000,632000
3085,5,15,18,-1,2,264000,15000,279000
3086,15,20,12,-1,2,225000,0,225000
3087,18,6,14,-1,1,216000,0,216000
3088,9,6,20,-1,2,252000,0,252000
3089,14,8,20,-1,1,216000,0,216000
3090,8,6,10,-1,2,288000,15000,303000
3091,17,14,18,13,2,309000,60000,369000
3092,13,7,16,-1,2,264000,15000,279000
3093,18,7,11,-1,1,216000,0,216000
3094,7,15,20,-1,1,216000,0,216000
3095,18,19,13,-1,2,219000,15000,234000
3096,18,14,15,-1,2,252000,15000,267000
3097,18,5,14,-1,1,216000,0,216000
3098,11,12,8,13,2,372000,375000,747000
3099,6,17,9,-1,1,216000,0,216000
3100,7,18,17,-1,2,228000,15000,243000
3101,7,17,5,-1,2,252000,0,252000
3102,8,11,14,-1,2,207000,0,207000
3103,15,6,17,-1,2,243000,0,243000
3104,10,15,12,-1,2,198000,0,198000
3105,5,8,18,12,2,384000,180000,564000
3106,6,12,18,-1,1,216000,0,216000
3107,14,19,13,-1,2,237000,15000,252000
3108,17,20,5,-1,2,252000,0,252000
3109,7,11,12,-1,2,276000,30000,306000
3110,20,5,10,-1,1,207000,0,207000
3111,7,9,15,-1,2,234000,0,234000
3112,13,19,16,11,2,348000,30000,378000
3113,8,12,6,-1,2,288000,15000,303000
3114,16,11,5,-1,1,198000,0,198000
3115,14,18,10,-1,1,171000,0,171000
3116,18,13,19,-1,2,237000,15000,252000
3117,10,17,9,-1,2,264000,15000,279000
3118,16,15,12,-1,2,231000,15000,246000
3119,11,17,6,13,2,348000,315000,663000
3120,13,8,12,-1,2,264000,15000,279000
3121,13,10,10,-1,2,180000,0,180000
3122,7,18,16,-1,2,180000,0,180000
3123,10,15,13,-1,2,231000,0,231000
3124,12,7,19,-1,1,207000,0,207000
3125,15,13,19,-1,2,198000,0,198000
3126,7,15,10,13,2,384000,305000,689000
3127,12,16,18,-1,2,225000,0,225000
3128,7,14,6,-1,2,255000,15000,270000
3129,10,19,7,-1,2,216000,0,216000
3130,15,17,12,-1,2,213000,0,213000
3131,5,14,7,-1,2,252000,0,252000
3132,15,13,10,-1,2,231000,0,231000
3133,18,16,16,11,2,300000,0,300000
3134,8,17,7,-1,2,264000,15000,279000
3135,5,17,18,-1,2,219000,15000,234000
3136,17,20,15,-1,2,171000,0,171000
3137,19,6,17,-1,2,252000,0,252000
3138,7,17,14,-1,2,252000,0,252000
3139,11,5,20,-1,1,216000,0,216000
3140,5,12,7,11,2,384000,280000,664000
3141,19,6,14,-1,1,216000,0,216000
3142,14,19,20,-1,2,219000,15000,234000
3143,12,19,8,-1,1,216000,0,216000
3144,19,6,5,-1,2,276000,30000,306000
3145,12,18,16,-1,2,207000,0,207000
3146,18,5,6,-1,2,264000,15000,279000
3147,15,14,18,13,2,348000,105000,453000
3148,15,8,16,-1,2,264000,15000,279000
3149,19,16,10,-1,2,234000,0,234000
3150,16,10,18,-1,2,234000,0,234000
3151,9,16,19,-1,2,234000,0,234000
3152,11,17,20,-1,2,216000,0,216000
3153,9,14,15,-1,2,264000,15000,279000
3154,9,10,8,13,2,372000,245000,617000
3155,12,9,6,-1,2,300000,30000,330000
3156,14,7,9,-1,2,225000,0,225000
3157,15,8,19,-1,1,180000,0,180000
3158,19,17,6,-1,2,243000,0,243000
3159,13,16,18,-1,2,213000,0,213000
3160,11,5,16,-1,2,252000,15000,267000
3161,16,14,17,11,2,360000,45000,405000
3162,11,16,15,-1,2,255000,15000,270000
3163,20,17,7,-1,2,243000,0,243000
3164,10,9,8,-1,2,279000,30000,309000
3165,6,5,8,-1,2,270000,30000,300000
3166,18,19,7,-1,2,174000,15000,189000
3167,15,18,13,-1,2,198000,0,198000
3168,19,14,20,12,2,348000,90000,438000
3169,5,6,10,-1,2,300000,30000,330000
3170,16,17,15,-1,2,162000,30000,192000
3171,18,6,10,-1,1,216000,0,216000
3172,15,6,11,-1,2,264000,30000,294000
3173,8,19,17,-1,2,225000,0,225000
3174,18,9,13,-1,1,189000,0,189000
3175,8,13,12,11,2,372000,240000,612000
3176,10,20,13,-1,1,207000,0,207000
3177,11,5,15,-1,1,216000,0,216000
3178,9,15,18,-1,2,225000,0,225000
3179,15,10,16,-1,2,237000,15000,252000
3180,15,15,17,-1,2,180000,0,180000
3181,20,19,14,-1,2,174000,15000,189000
3182,11,5,9,11,2,348000,295000,643000
3183,17,11,13,-1,2,225000,0,225000
3184,15,10,6,-1,2,252000,15000,267000
3185,18,7,13,-1,1,198000,0,198000
3186,8,5,17,-1,2,252000,0,252000
3187,7,19,9,-1,2,234000,0,234000
3188,19,13,20,-1,2,183000,15000,198000
3189,5,13,14,13,2,324000,175000,499000
3190,18,20,12,-1,2,225000,0,225000
3191,6,10,19,-1,1,216000,0,216000
3192,10,8,19,-1,2,252000,0,252000
3193,12,9,15,-1,2,225000,0,225000
3194,5,10,13,-1,2,264000,15000,279000
3195,8,7,17,-1,2,237000,15000,252000
3196,18,16,7,11,2,324000,30000,354000
3197,18,8,14,-1,2,252000,15000,267000
3198,20,7,10,-1,2,252000,0,252000
3199,16,13,19,-1,2,189000,0,189000
3200,14,6,13,-1,2,276000,30000,306000
3201,17,10,9,-1,2,246000,15000,261000
3202,8,13,19,-1,1,198000,0,198000
3203,14,19,9,11,2,372000,120000,492000
3204,20,18,5,-1,2,252000,0,252000
3205,8,6,20,-1,2,252000,0,252000
3206,9,15,12,-1,2,216000,0,216000
3207,19,15,20,-1,2,192000,15000,207000
3208,16,13,18,-1,2,267000,0,267000
3209,9,14,6,-1,2,288000,15000,303000
3210,7,15,16,13,2,336000,60000,396000
3211,11,18,17,-1,2,255000,15000,270000
3212,15,11,19,-1,1,189000,0,189000
3213,9,12,20,-1,2,252000,0,252000
3214,15,7,17,-1,2,252000,0,252000
3215,12,15,17,-1,2,222000,0,222000
3216,16,8,12,-1,1,216000,0,216000
3217,8,5,18,12,2,384000,180000,564000
3218,6,16,12,-1,2,264000,30000,294000
3219,5,6,11,-1,2,300000,30000,330000
3220,9,20,19,-1,2,174000,15000,189000
3221,17,20,16,-1,2,216000,15000,231000
3222,7,11,13,-1,2,276000,30000,306000
3223,10,6,8,-1,2,276000,0,276000
3224,5,16,6,12,2,348000,30000,378000
3225,10,8,5,-1,2,288000,15000,303000
3226,6,16,9,-1,2,216000,0,216000
3227,8,7,20,-1,2,237000,15000,252000
3228,19,13,9,-1,1,171000,0,171000
3229,17,15,13,-1,2,240000,0,240000
3230,18,9,14,-1,1,207000,0,207000
3231,13,11,20,13,2,276000,45000,321000
3232,16,20,14,-1,2,234000,0,234000
3233,12,15,6,-1,2,276000,30000,306000
3234,9,12,6,-1,2,288000,15000,303000
3235,10,5,8,-1,2,249000,0,249000
3236,18,11,15,-1,2,162000,0,162000
3237,6,11,15,-1,2,252000,15000,267000
3238,13,19,7,11,2,360000,75000,435000
3239,6,11,14,-1,2,276000,30000,306000
3240,6,11,5,-1,2,264000,15000,279000
3241,8,18,12,-1,1,171000,0,171000
3242,8,18,20,-1,2,234000,0,234000
3243,13,7,16,-1,2,252000,0,252000
3244,14,20,12,-1,2,189000,0,189000
3245,17,12,8,11,2,372000,225000,597000
3246,20,18,5,-1,2,207000,0,207000
3247,19,8,6,-1,2,252000,0,252000
3248,11,16,5,-1,1,207000,0,207000
3249,9,10,11,-1,2,252000,30000,282000
3250,12,7,10,-1,2,249000,0,249000
3251,5,13,15,-1,2,234000,0,234000
3252,9,19,18,11,2,324000,60000,384000
3253,5,11,10,-1,2,288000,45000,333000
3254,14,17,10,-1,2,207000,0,207000
3255,15,9,5,-1,2,252000,15000,267000
3256,12,5,7,-1,2,252000,0,252000
3257,11,5,18,-1,1,189000,0,189000
3258,9,10,13,-1,2,252000,15000,267000
3259,13,12,13,12,2,288000,30000,318000
3260,13,7,19,-1,1,153000,0,153000
3261,9,20,6,-1,2,243000,0,243000
3262,16,12,14,-1,2,204000,0,204000
3263,5,18,16,-1,2,243000,0,243000
3264,12,16,15,-1,2,213000,15000,228000
3265,6,8,13,-1,2,252000,0,252000
3266,5,19,8,11,2,360000,165000,525000
3267,5,14,8,-1,2,300000,30000,330000
3268,8,16,14,-1,2,216000,0,216000
3269,15,12,11,-1,2,234000,15000,249000
3270,5,12,10,-1,2,252000,0,252000
3271,15,8,6,-1,2,225000,0,225000
3272,16,6,12,-1,1,189000,0,189000
3273,15,14,13,12,2,348000,105000,453000
3274,20,10,11,-1,2,264000,15000,279000
3275,16,14,5,-1,2,252000,0,252000
3276,15,11,5,-1,1,216000,0,216000
3277,11,19,15,-1,1,162000,0,162000
3278,10,14,16,-1,2,264000,15000,279000
3279,9,7,19,-1,2,252000,0,252000
3280,7,13,12,11,2,348000,120000,468000
3281,9,16,11,-1,2,252000,0,252000
3282,5,16,19,-1,2,234000,0,234000
3283,7,20,10,-1,2,243000,0,243000
3284,16,15,18,-1,2,198000,30000,228000
3285,18,8,15,-1,2,252000,0,252000
3286,12,17,11,-1,2,237000,15000,252000
3287,11,18,9,13,2,372000,260000,632000
3288,8,14,11,-1,2,300000,30000,330000
3289,7,11,18,-1,1,198000,0,198000
3290,13,18,10,-1,2,225000,0,225000
3291,10,20,8,-1,2,252000,0,252000
3292,9,16,10,-1,2,228000,15000,243000
3293,15,17,11,-1,2,207000,0,207000
3294,7,11,6,12,2,396000,300000,696000
3295,11,19,16,-1,2,243000,0,243000
3296,20,12,14,-1,2,225000,0,225000
3297,16,14,6,-1,2,252000,0,252000
3298,18,10,16,-1,2,216000,0,216000
3299,16,7,9,-1,2,252000,0,252000
3300,14,9,8,-1,2,228000,15000,243000
3301,6,10,14,11,2,360000,165000,525000
3302,15,7,20,-1,1,216000,0,216000
3303,16,9,13,-1,2,264000,15000,279000
3304,16,8,5,-1,2,252000,0,252000
3305,9,17,13,-1,1,180000,0,180000
3306,16,18,9,-1,2,252000,0,252000
3307,9,16,13,-1,2,225000,0,225000
3308,17,18,13,12,2,360000,75000,435000
3309,15,6,8,-1,2,264000,15000,279000
3310,19,12,7,-1,1,216000,0,216000
3311,8,19,17,-1,2,234000,0,234000
3312,10,14,13,-1,2,240000,15000,255000
3313,10,15,11,-1,2,228000,15000,243000
3314,19,10,9,-1,2,246000,15000,261000
3315,15,14,11,13,2,348000,135000,483000
3316,7,18,14,-1,2,252000,15000,267000
3317,6,8,9,-1,2,288000,30000,318000
3318,8,19,18,-1,2,192000,15000,207000
3319,19,17,18,-1,2,198000,30000,228000
3320,12,17,18,-1,2,264000,15000,279000
3321,6,20,16,-1,1,216000,0,216000
3322,9,20,8,11,2,396000,260000,656000
3323,6,5,8,-1,2,324000,105000,429000
3324,7,17,16,-1,2,219000,15000,234000
3325,16,7,17,-1,2,237000,15000,252000
3326,14,8,19,-1,1,189000,0,189000
3327,12,12,10,-1,2,225000,0,225000
3328,6,7,8,-1,2,234000,30000,264000
3329,8,9,20,13,2,312000,15000,327000
3330,13,10,16,-1,2,252000,0,252000
3331,9,6,18,-1,2,252000,0,252000
3332,10,13,17,-1,2,216000,0,216000
3333,10,6,10,-1,1,216000,0,216000
3334,16,20,14,-1,2,126000,0,126000
3335,19,5,16,-1,2,252000,0,252000
3336,19,18,12,13,2,348000,135000,483000
3337,7,20,16,-1,1,207000,0,207000
3338,17,15,6,-1,2,252000,0,252000
3339,11,6,20,-1,1,207000,0,207000
3340,9,18,6,-1,2,252000,0,252000
3341,8,20,6,-1,2,225000,0,225000
3342,16,11,14,-1,2,213000,0,213000
3343,20,17,14,13,2,348000,60000,408000
3344,12,9,18,-1,2,252000,0,252000
3345,7,9,15,-1,2,252000,0,252000
3346,9,15,11,-1,2,234000,0,234000
3347,10,7,11,-1,2,267000,15000,282000
3348,10,18,16,-1,2,189000,0,189000
3349,16,13,10,-1,2,225000,0,225000
3350,5,16,10,11,2,372000,315000,687000
3351,5,15,7,-1,2,276000,30000,306000
3352,19,7,11,-1,1,216000,0,216000
3353,14,15,7,-1,2,264000,15000,279000
3354,18,9,20,-1,2,198000,0,198000
3355,9,13,17,-1,1,198000,0,198000
3356,13,19,20,-1,2,228000,15000,243000
3357,6,10,7,13,2,408000,315000,723000
3358,6,11,20,-1,1,216000,0,216000
3359,14,7,8,-1,2,300000,30000,330000
3360,10,6,19,-1,1,207000,0,207000
3361,5,6,14,-1,2,264000,15000,279000
3362,19,13,11,-1,2,180000,0,180000
3363,20,18,14,-1,2,198000,0,198000
3364,10,9,20,11,2,384000,320000,704000
3365,8,5,7,-1,2,288000,45000,333000
3366,20,9,16,-1,1,144000,0,144000
3367,18,19,20,-1,2,195000,30000,225000
3368,12,16,5,-1,1,216000,0,216000
3369,16,9,17,-1,2,237000,15000,252000
3370,11,13,15,-1,2,231000,0,231000
3371,5,18,7,12,2,372000,180000,552000
3372,8,17,20,-1,2,252000,0,252000
3373,13,12,16,-1,2,243000,15000,258000
3374,12,5,7,-1,2,252000,0,252000
3375,6,7,20,-1,2,237000,15000,252000
3376,20,14,18,-1,2,162000,0,162000
3377,6,7,10,-1,2,324000,90000,414000
3378,14,13,5,11,2,336000,60000,396000
3379,8,17,20,-1,2,252000,0,252000
3380,15,18,5,-1,2,252000,0,252000
3381,6,7,17,-1,2,255000,15000,270000
3382,7,20,12,-1,1,180000,0,180000
3383,6,17,13,-1,1,216000,0,216000
3384,6,14,5,-1,2,264000,15000,279000
3385,14,16,10,12,2,336000,120000,456000
3386,20,7,10,-1,2,252000,0,252000
3387,19,9,8,-1,2,264000,15000,279000
3388,11,20,12,-1,2,210000,15000,225000
3389,7,13,16,-1,2,252000,0,252000
3390,11,9,17,-1,2,225000,0,225000
3391,5,14,9,-1,1,216000,0,216000
3392,20,14,5,13,2,348000,75000,423000
3393,17,13,7,-1,2,252000,15000,267000
3394,18,10,16,-1,2,234000,0,234000
3395,12,6,16,-1,1,216000,0,216000
3396,7,8,10,-1,2,288000,30000,318000
3397,9,10,9,-1,2,183000,15000,198000
3398,19,5,16,-1,2,180000,0,180000
3399,14,14,8,12,2,300000,30000,330000
3400,17,7,18,-1,2,246000,15000,261000
3401,15,12,11,-1,2,243000,15000,258000
3402,16,17,11,-1,2,219000,15000,234000
3403,17,15,20,-1,2,189000,0,189000
3404,13,20,8,-1,1,216000,0,216000
3405,20,8,5,-1,2,276000,30000,306000
3406,10,5,6,12,2,408000,315000,723000
3407,17,15,8,-1,2,252000,0,252000
3408,18,20,9,-1,2,216000,0,216000
3409,14,11,19,-1,2,216000,0,216000
3410,14,17,18,-1,2,231000,15000,246000
3411,16,6,14,-1,2,252000,0,252000
3412,13,11,18,-1,2,216000,0,216000
3413,7,6,15,12,2,396000,240000,636000
3414,11,19,18,-1,2,255000,15000,270000
3415,5,15,10,-1,2,252000,15000,267000
3416,10,20,13,-1,2,207000,0,207000
3417,13,14,6,-1,2,264000,15000,279000
3418,16,11,17,-1,2,210000,15000,225000
3419,19,7,20,-1,2,237000,15000,252000
3420,12,6,5,13,2,396000,300000,696000
3421,9,14,10,-1,2,300000,30000,330000
3422,9,6,10,-1,2,258000,15000,273000
3423,20,8,17,-1,2,189000,0,189000
3424,17,10,7,-1,2,252000,0,252000
3425,20,13,7,-1,1,198000,0,198000
3426,7,8,17,-1,2,264000,15000,279000
3427,13,10,7,11,2,360000,150000,510000
3428,6,9,14,-1,2,288000,15000,303000
3429,16,12,11,-1,2,201000,15000,216000
3430,5,17,10,-1,1,216000,0,216000
3431,15,10,20,-1,1,198000,0,198000
3432,9,5,13,-1,2,288000,30000,318000
3433,19,9,8,-1,2,228000,15000,243000
3434,17,9,5,11,2,348000,245000,593000
3435,7,16,17,-1,2,264000,15000,279000
3436,9,13,18,-1,1,198000,0,198000
3437,8,13,11,-1,2,288000,15000,303000
3438,11,5,7,-1,2,243000,0,243000
3439,6,16,20,-1,1,162000,0,162000
3440,8,20,7,-1,2,264000,15000,279000
3441,10,7,17,12,2,360000,105000,465000
3442,11,17,7,-1,2,252000,15000,267000
3443,20,9,15,-1,1,198000,0,198000
3444,16,18,12,-1,2,225000,0,225000
3445,17,10,18,-1,2,255000,15000,270000
3446,13,9,20,-1,1,198000,0,198000
3447,17,19,8,-1,2,252000,0,252000
3448,12,16,6,11,2,360000,150000,510000
3449,6,8,18,-1,2,252000,0,252000
3450,13,16,8,-1,2,243000,0,243000
3451,19,13,18,-1,2,201000,15000,216000
3452,20,8,16,-1,1,216000,0,216000
3453,6,8,15,-1,2,252000,0,252000
3454,8,20,19,-1,2,228000,15000,243000
3455,15,8,6,12,2,384000,225000,609000
3456,8,5,10,-1,2,312000,75000,387000
3457,9,19,5,-1,1,198000,0,198000
3458,18,12,10,-1,2,207000,0,207000
3459,18,5,14,-1,1,216000,0,216000
3460,20,12,8,-1,1,207000,0,207000
3461,5,6,15,-1,2,264000,15000,279000
3462,20,17,13,11,2,336000,30000,366000
3463,15,7,9,-1,2,300000,30000,330000
3464,8,13,14,-1,2,237000,15000,252000
3465,15,16,10,-1,2,219000,15000,234000
3466,16,12,18,-1,2,207000,0,207000
3467,6,12,11,-1,2,276000,30000,306000
3468,12,16,15,-1,2,213000,15000,228000
3469,12,20,16,11,2,372000,75000,447000
3470,10,6,19,-1,2,252000,15000,267000
3471,20,7,11,-1,1,216000,0,216000
3472,19,7,9,-1,2,252000,0,252000
3473,13,19,15,-1,2,180000,0,180000
3474,17,12,10,-1,2,252000,0,252000
3475,8,15,18,-1,2,243000,0,243000
3476,14,9,15,12,2,360000,165000,525000
3477,5,11,15,-1,2,264000,30000,294000
3478,16,18,10,-1,2,225000,0,225000
3479,11,19,13,-1,2,216000,0,216000
3480,11,5,15,-1,2,252000,15000,267000
3481,8,20,14,-1,1,189000,0,189000
3482,7,16,9,-1,2,252000,0,252000
3483,16,5,7,11,2,372000,155000,527000
3484,8,12,19,-1,1,216000,0,216000
3485,19,9,10,-1,2,255000,15000,270000
3486,14,20,13,-1,2,201000,15000,216000
3487,14,19,12,-1,2,234000,0,234000
3488,16,9,12,-1,2,252000,0,252000
3489,20,5,11,-1,1,216000,0,216000
3490,11,19,14,13,2,348000,105000,453000
3491,5,8,6,-1,2,336000,135000,471000
3492,17,9,11,-1,2,198000,0,198000
3493,10,12,18,-1,2,216000,0,216000
3494,5,9,6,-1,2,300000,30000,330000
3495,15,13,14,-1,2,180000,30000,210000
3496,7,16,8,-1,2,264000,15000,279000
3497,19,15,14,11,2,348000,30000,378000
3498,16,12,5,-1,2,252000,15000,267000
3499,5,12,18,-1,1,216000,0,216000
3500,6,9,5,-1,2,300000,30000,330000
3501,14,9,15,-1,2,192000,15000,207000
3502,20,8,18,-1,2,216000,0,216000
3503,20,17,19,-1,2,186000,15000,201000
3504,17,18,7,11,2,372000,270000,642000
3505,6,13,15,-1,2,252000,0,252000
3506,6,10,19,-1,1,198000,0,198000
3507,6,10,20,-1,1,216000,0,216000
3508,20,11,17,-1,2,207000,0,207000
3509,15,14,19,-1,2,219000,15000,234000
3510,14,17,12,-1,2,243000,0,243000
3511,15,6,17,12,2,360000,235000,595000
3512,18,7,19,-1,2,219000,15000,234000
3513,7,10,15,-1,2,252000,0,252000
3514,5,14,9,-1,1,216000,0,216000
3515,20,10,11,-1,2,219000,15000,234000
3516,14,8,10,-1,2,243000,0,243000
3517,11,10,7,-1,2,258000,15000,273000
3518,17,7,14,12,2,336000,45000,381000
3519,20,6,9,-1,2,252000,0,252000
3520,8,6,16,-1,2,252000,0,252000
3521,11,12,14,-1,2,225000,30000,255000
3522,18,7,17,-1,2,237000,15000,252000
3523,14,20,16,-1,2,180000,0,180000
3524,20,14,12,-1,2,243000,0,243000
3525,10,6,9,12,2,396000,350000,746000
3526,11,14,7,-1,2,276000,30000,306000
3527,6,7,17,-1,2,264000,15000,279000
3528,15,13,10,-1,2,222000,0,222000
3529,15,16,7,-1,2,255000,15000,270000
3530,15,17,11,-1,2,189000,0,189000
3531,20,13,19,-1,2,219000,15000,234000
3532,6,17,16,13,2,348000,195000,543000
3533,18,14,20,-1,2,189000,0,189000
3534,10,20,14,-1,1,216000,0,216000
3535,18,10,19,-1,2,264000,15000,279000
3536,10,13,17,-1,2,234000,0,234000
3537,12,9,12,-1,2,234000,0,234000
3538,9,12,9,-1,2,162000,0,162000
3539,9,11,12,11,2,291000,75000,366000
3540,13,10,16,-1,2,180000,0,180000
3541,18,19,9,-1,2,246000,15000,261000
3542,5,20,8,-1,2,252000,0,252000
3543,20,13,7,-1,1,198000,0,198000
3544,20,8,16,-1,1,207000,0,207000
3545,17,12,15,-1,2,240000,0,240000
3546,15,10,13,11,2,372000,195000,567000
3547,17,7,9,-1,2,264000,15000,279000
3548,16,5,13,-1,2,252000,0,252000
3549,16,8,11,-1,2,234000,0,234000
3550,17,13,14,-1,2,225000,15000,240000
3551,18,17,14,-1,2,222000,15000,237000
3552,6,9,7,-1,2,312000,60000,372000
3553,16,10,8,11,2,348000,75000,423000
3554,7,6,11,-1,2,300000,30000,330000
3555,20,5,13,-1,1,189000,0,189000
3556,12,9,11,-1,2,240000,15000,255000
3557,12,5,11,-1,2,255000,15000,270000
3558,5,19,20,-1,2,183000,15000,198000
3559,7,10,13,-1,2,288000,15000,303000
3560,9,16,7,12,2,348000,30000,378000
3561,10,18,15,-1,2,234000,0,234000
3562,13,18,12,-1,2,228000,15000,243000
3563,9,14,16,-1,2,252000,0,252000
3564,7,20,16,-1,1,198000,0,198000
3565,6,16,8,-1,2,252000,0,252000
3566,5,10,11,-1,2,264000,15000,279000
3567,6,17,8,12,2,336000,15000,351000
3568,17,19,5,-1,2,243000,0,243000
3569,17,17,13,-1,1,153000,0,153000
3570,5,7,10,-1,2,252000,0,252000
3571,5,14,7,-1,2,225000,0,225000
3572,7,13,5,-1,2,225000,0,225000
3573,15,5,13,-1,2,225000,0,225000
3574,12,15,7,11,2,336000,75000,411000
3575,9,18,16,-1,2,243000,0,243000
3576,19,11,14,-1,2,207000,0,207000
3577,13,18,16,-1,2,240000,0,240000
3578,18,20,13,-1,2,216000,0,216000
3579,7,17,6,-1,2,264000,15000,279000
3580,19,20,14,-1,2,201000,15000,216000
3581,8,9,18,12,2,396000,355000,751000
3582,7,6,16,-1,2,252000,0,252000
3583,14,18,9,-1,1,162000,0,162000
3584,18,14,11,-1,2,234000,0,234000
3585,10,8,5,-1,2,300000,30000,330000
3586,9,7,8,-1,2,252000,30000,282000
3587,19,11,10,-1,2,192000,15000,207000
3588,9,14,18,12,2,360000,150000,510000
3589,7,10,6,-1,2,324000,90000,414000
3590,10,7,17,-1,2,225000,0,225000
3591,9,14,15,-1,2,228000,15000,243000
3592,6,14,19,-1,1,216000,0,216000
3593,6,11,10,-1,2,264000,15000,279000
3594,9,12,16,-1,2,198000,0,198000
3595,17,14,19,13,2,348000,75000,423000
3596,9,18,20,-1,2,252000,0,252000
3597,17,11,14,-1,2,234000,0,234000
3598,6,10,20,-1,1,216000,0,216000
3599,12,20,14,-1,2,225000,0,225000
3600,18,12,13,-1,2,237000,15000,252000
3601,10,15,7,-1,2,252000,0,252000
3602,16,13,15,11,2,360000,75000,435000
3603,5,8,15,-1,2,300000,30000,330000
3604,8,18,11,-1,2,225000,0,225000
3605,11,14,7,-1,2,243000,0,243000
3606,18,11,15,-1,2,198000,0,198000
3607,7,13,14,-1,2,264000,15000,279000
3608,13,16,19,-1,2,189000,0,189000
3609,7,15,10,13,2,384000,305000,689000
3610,20,19,18,-1,2,204000,15000,219000
3611,11,13,5,-1,2,276000,30000,306000
3612,14,10,20,-1,1,171000,0,171000
3613,19,12,10,-1,2,252000,0,252000
3614,12,8,5,-1,2,288000,15000,303000
3615,8,19,7,-1,2,219000,15000,234000
3616,8,7,13,13,2,312000,15000,327000
3617,15,5,9,-1,1,216000,0,216000
3618,6,12,18,-1,1,207000,0,207000
3619,14,10,18,-1,1,180000,0,180000
3620,6,16,12,-1,2,252000,15000,267000
3621,9,17,19,-1,2,234000,0,234000
3622,6,14,10,-1,1,216000,0,216000
3623,15,13,9,11,2,360000,165000,525000
3624,16,7,15,-1,2,264000,15000,279000
3625,19,16,8,-1,2,243000,0,243000
3626,12,15,18,-1,2,198000,0,198000
3627,19,12,10,-1,2,252000,0,252000
3628,6,7,12,-1,2,264000,15000,279000
3629,8,12,20,-1,1,180000,0,180000
3630,17,5,7,12,2,384000,195000,579000
3631,16,18,12,-1,2,234000,0,234000
3632,12,6,17,-1,1,216000,0,216000
3633,18,6,8,-1,2,252000,0,252000
3634,19,12,11,-1,2,219000,15000,234000
3635,15,8,13,-1,2,252000,0,252000
3636,18,9,15,-1,2,216000,0,216000
3637,9,6,17,13,2,372000,170000,542000
3638,9,20,7,-1,2,252000,0,252000
3639,7,11,14,-1,2,264000,15000,279000
3640,17,12,9,-1,2,216000,0,216000
3641,7,12,16,-1,1,216000,0,216000
3642,13,19,10,-1,2,225000,0,225000
3643,17,14,6,-1,2,252000,0,252000
3644,6,5,9,11,2,396000,300000,696000
3645,6,18,11,-1,1,216000,0,216000
3646,16,10,14,-1,2,234000,0,234000
3647,12,9,7,-1,2,252000,0,252000
3648,14,5,7,-1,2,243000,0,243000
3649,19,13,12,-1,2,174000,15000,189000
3650,20,11,14,-1,2,234000,0,234000
3651,13,11,20,11,2,288000,15000,303000
3652,20,7,18,-1,2,252000,0,252000
3653,6,11,10,-1,2,276000,30000,306000
3654,15,7,13,-1,2,225000,0,225000
3655,17,19,15,-1,2,177000,0,177000
3656,20,6,10,-1,1,216000,0,216000
3657,12,9,11,-1,2,288000,30000,318000
3658,8,7,18,11,2,360000,90000,450000
3659,11,15,5,-1,2,252000,15000,267000
3660,18,7,18,-1,1,180000,0,180000
3661,10,15,11,-1,2,192000,15000,207000
3662,17,7,13,-1,1,216000,0,216000
3663,13,10,11,-1,2,261000,30000,291000
3664,12,5,18,-1,1,216000,0,216000
3665,12,5,16,11,2,348000,105000,453000
3666,17,19,6,-1,2,252000,0,252000
3667,11,17,9,-1,2,234000,0,234000
3668,10,13,6,-1,2,252000,0,252000
3669,20,9,18,-1,2,198000,0,198000
3670,17,20,19,-1,2,186000,15000,201000
3671,13,7,16,-1,2,276000,30000,306000
3672,6,10,9,11,2,384000,375000,759000
3673,10,12,6,-1,2,300000,45000,345000
3674,8,11,19,-1,2,216000,0,216000
3675,6,20,16,-1,1,198000,0,198000
3676,7,20,18,-1,2,234000,0,234000
3677,13,11,5,-1,2,252000,0,252000
3678,5,20,10,-1,1,207000,0,207000
3679,15,20,18,13,2,336000,15000,351000
3680,15,16,18,-1,2,252000,30000,282000
3681,19,18,17,-1,2,225000,30000,255000
3682,20,18,9,-1,2,252000,0,252000
3683,12,16,15,-1,2,249000,15000,264000
3684,6,15,11,-1,2,252000,15000,267000
3685,19,6,12,-1,1,207000,0,207000
3686,7,11,20,12,2,360000,105000,465000
3687,8,15,14,-1,2,276000,30000,306000
3688,7,14,17,-1,2,252000,0,252000
3689,17,9,16,-1,2,228000,15000,243000
3690,14,15,8,-1,2,246000,15000,261000
3691,19,10,13,-1,2,207000,0,207000
3692,19,7,9,-1,2,252000,0,252000
3693,17,16,12,11,2,348000,60000,408000
3694,13,10,16,-1,2,252000,0,252000
3695,20,12,18,-1,2,216000,0,216000
3696,17,14,18,-1,2,231000,15000,246000
3697,6,18,9,-1,2,252000,0,252000
3698,6,13,16,-1,2,252000,0,252000
3699,12,18,14,-1,2,198000,0,198000
3700,7,18,13,12,2,360000,265000,625000
3701,9,14,11,-1,2,252000,0,252000
3702,6,18,15,-1,2,216000,0,216000
3703,18,8,16,-1,2,225000,0,225000
3704,15,8,11,-1,2,225000,0,225000
3705,10,8,14,-1,2,234000,0,234000
3706,6,18,12,-1,1,207000,0,207000
3707,7,17,20,11,2,348000,45000,393000
3708,19,18,10,-1,2,264000,15000,279000
3709,13,6,18,-1,1,216000,0,216000
3710,17,8,6,-1,2,252000,0,252000
3711,19,13,14,-1,2,192000,15000,207000
3712,11,14,8,-1,2,288000,15000,303000
3713,15,14,13,-1,2,216000,30000,246000
3714,19,6,16,11,2,372000,185000,557000
3715,11,8,6,-1,2,312000,45000,357000
3716,10,12,14,-1,2,213000,0,213000
3717,18,12,17,-1,2,201000,15000,216000
3718,19,16,12,-1,2,225000,0,225000
3719,20,14,11,-1,2,243000,0,243000
3720,10,15,12,-1,2,243000,0,243000
3721,20,16,9,11,2,360000,90000,450000
3722,5,7,14,-1,2,300000,30000,330000
3723,15,8,20,-1,1,180000,0,180000
3724,17,19,15,-1,2,213000,0,213000
3725,9,8,7,-1,2,312000,60000,372000
3726,5,17,6,-1,2,246000,15000,261000
3727,5,16,7,-1,2,225000,0,225000
3728,14,7,10,11,2,348000,105000,453000
3729,18,11,18,-1,1,189000,0,189000
3730,14,19,9,-1,1,162000,0,162000
3731,19,10,14,-1,1,207000,0,207000
3732,16,5,14,-1,2,252000,0,252000
3733,7,13,5,-1,2,252000,0,252000
3734,5,15,6,-1,2,255000,15000,270000
3735,16,5,12,13,2,324000,90000,414000
3736,18,10,15,-1,2,252000,0,252000
3737,8,10,13,-1,2,252000,0,252000
3738,16,17,20,-1,2,189000,15000,204000
3739,5,20,14,-1,1,216000,0,216000
3740,18,15,8,-1,2,252000,0,252000
3741,11,19,14,-1,2,234000,0,234000
3742,9,19,17,12,2,360000,135000,495000
3743,11,18,20,-1,2,216000,0,216000
3744,13,16,5,-1,2,252000,0,252000
3745,18,11,7,-1,1,198000,0,198000
3746,12,20,14,-1,2,207000,0,207000
3747,13,17,5,-1,1,216000,0,216000
3748,12,5,18,-1,1,216000,0,216000
3749,19,20,16,12,2,324000,75000,399000
3750,15,12,19,-1,2,225000,0,225000
3751,16,15,9,-1,2,264000,15000,279000
3752,14,16,9,-1,2,234000,0,234000
3753,20,9,15,-1,1,189000,0,189000
3754,9,19,17,-1,2,252000,0,252000
3755,12,7,16,-1,1,207000,0,207000
3756,9,15,14,11,2,360000,150000,510000
3757,5,20,12,-1,1,216000,0,216000
3758,16,5,8,-1,2,264000,15000,279000
3759,16,12,9,-1,2,243000,0,243000
3760,5,6,7,-1,2,300000,45000,345000
3761,16,7,14,-1,2,198000,0,198000
3762,13,5,7,-1,2,243000,0,243000
3763,18,7,14,13,2,324000,45000,369000
3764,20,15,17,-1,2,198000,0,198000
3765,19,18,10,-1,2,264000,15000,279000
3766,11,13,12,-1,2,270000,30000,300000
3767,6,16,18,-1,2,234000,0,234000
3768,20,8,6,-1,2,234000,0,234000
3769,18,20,15,-1,2,177000,0,177000
3770,17,10,12,13,2,360000,305000,665000
3771,12,14,15,-1,2,231000,15000,246000
3772,18,17,19,-1,2,198000,30000,228000
3773,13,11,15,-1,2,288000,15000,303000
3774,8,20,12,-1,1,198000,0,198000
3775,10,7,19,-1,2,252000,0,252000
3776,19,20,7,-1,2,219000,15000,234000
3777,16,15,19,13,2,348000,75000,423000
3778,5,17,20,-1,2,216000,0,216000
3779,14,9,6,-1,2,252000,0,252000
3780,16,6,14,-1,2,243000,0,243000
3781,14,9,19,-1,1,162000,0,162000
3782,17,20,19,-1,2,204000,15000,219000
3783,8,12,13,-1,2,288000,45000,333000
3784,19,15,17,13,2,348000,60000,408000
3785,16,9,12,-1,2,288000,15000,303000
3786,13,9,13,-1,1,198000,0,198000
3787,18,20,12,-1,2,153000,0,153000
3788,14,7,17,-1,2,252000,0,252000
3789,8,16,13,-1,2,243000,0,243000
3790,14,15,18,-1,2,216000,15000,231000
3791,13,15,11,13,2,312000,90000,402000
3792,7,11,8,-1,2,300000,30000,330000
3793,15,5,6,-1,2,246000,15000,261000
3794,13,5,17,-1,1,189000,0,189000
3795,19,10,5,-1,1,216000,0,216000
3796,7,19,5,-1,2,243000,0,243000
3797,8,7,6,-1,2,261000,30000,291000
3798,19,18,7,13,2,312000,15000,327000
3799,11,19,8,-1,2,252000,0,252000
3800,18,14,11,-1,2,225000,0,225000
3801,19,9,14,-1,1,216000,0,216000
3802,16,9,8,-1,2,264000,15000,279000
3803,7,16,14,-1,2,243000,0,243000
3804,10,8,12,-1,2,240000,0,240000
3805,5,16,14,12,2,336000,60000,396000
3806,10,20,8,-1,2,252000,0,252000
3807,19,20,17,-1,2,177000,15000,192000
3808,7,16,18,-1,2,252000,0,252000
3809,18,7,11,-1,1,216000,0,216000
3810,7,20,12,-1,1,216000,0,216000
3811,9,16,8,-1,2,264000,15000,279000
3812,13,15,10,11,2,360000,165000,525000
3813,18,8,14,-1,2,252000,15000,267000
3814,18,13,17,-1,2,219000,15000,234000
3815,18,10,15,-1,2,252000,0,252000
3816,20,11,18,-1,2,225000,0,225000
3817,17,15,5,-1,2,252000,0,252000
3818,19,15,20,-1,2,174000,15000,189000
3819,15,9,11,12,2,372000,375000,747000
3820,13,9,7,-1,2,252000,0,252000
3821,18,16,10,-1,2,198000,0,198000
3822,11,13,14,-1,2,240000,15000,255000
3823,16,19,20,-1,2,186000,15000,201000
3824,20,11,10,-1,2,264000,15000,279000
3825,11,15,16,-1,2,246000,15000,261000
3826,14,15,10,13,2,348000,165000,513000
3827,5,18,6,-1,2,252000,0,252000
3828,17,19,20,-1,2,159000,15000,174000
3829,17,13,14,-1,2,279000,15000,294000
3830,14,20,11,-1,2,225000,0,225000
3831,16,18,19,-1,2,213000,15000,228000
3832,18,7,10,-1,2,252000,0,252000
3833,17,18,11,13,2,348000,135000,483000
3834,9,17,15,-1,2,243000,0,243000
3835,14,18,10,-1,1,162000,0,162000
3836,17,15,7,-1,2,252000,0,252000
3837,9,15,17,-1,2,234000,0,234000
3838,12,17,16,-1,2,210000,15000,225000
3839,17,13,10,-1,2,243000,0,243000
3840,11,14,20,12,2,360000,135000,495000
3841,12,15,16,-1,2,237000,15000,252000
3842,14,13,9,-1,2,228000,15000,243000
3843,11,19,10,-1,2,228000,15000,243000
3844,20,6,16,-1,1,207000,0,207000
3845,10,6,7,-1,2,300000,30000,330000
3846,18,20,11,-1,2,171000,0,171000
3847,9,6,10,11,2,384000,375000,759000
3848,10,7,15,-1,2,288000,15000,303000
3849,11,19,18,-1,2,219000,15000,234000
3850,15,5,8,-1,2,252000,0,252000
3851,16,20,11,-1,1,171000,0,171000
3852,16,14,15,-1,2,261000,30000,291000
3853,20,15,11,-1,1,198000,0,198000
3854,8,15,9,12,2,396000,400000,796000
3855,15,6,5,-1,2,252000,0,252000
3856,13,16,15,-1,2,186000,15000,201000
3857,18,17,20,-1,2,207000,30000,237000
3858,10,10,18,-1,1,216000,0,216000
3859,15,7,8,-1,2,237000,15000,252000
3860,12,13,19,-1,2,192000,15000,207000
3861,6,13,12,11,2,372000,255000,627000
3862,12,5,20,-1,1,216000,0,216000
3863,9,7,19,-1,2,264000,15000,279000
3864,12,16,13,-1,2,252000,15000,267000
3865,11,5,17,-1,1,216000,0,216000
3866,19,11,10,-1,2,237000,15000,252000
3867,7,6,8,-1,2,300000,45000,345000
3868,12,5,17,11,2,324000,45000,369000
3869,17,18,7,-1,2,255000,15000,270000
3870,20,16,6,-1,1,198000,0,198000
3871,9,8,14,-1,2,264000,15000,279000
3872,9,14,13,-1,2,228000,15000,243000
3873,15,5,17,-1,2,243000,0,243000
3874,11,8,20,-1,2,216000,0,216000
3875,15,9,8,13,2,372000,175000,547000
3876,11,7,14,-1,2,276000,30000,306000
3877,8,5,19,-1,2,252000,0,252000
3878,13,8,11,-1,2,240000,0,240000
3879,17,5,19,-1,2,207000,0,207000
3880,6,12,14,-1,2,252000,0,252000
3881,12,8,6,-1,2,225000,0,225000
3882,12,8,7,13,2,360000,215000,575000
3883,13,19,14,-1,2,228000,15000,243000
3884,5,11,9,-1,2,300000,45000,345000
3885,7,5,11,-1,2,234000,0,234000
3886,5,6,8,-1,2,261000,30000,291000
3887,6,12,19,-1,1,162000,0,162000
3888,20,16,5,-1,1,198000,0,198000
3889,16,11,14,13,2,348000,180000,528000
3890,20,8,9,-1,2,243000,0,243000
3891,16,10,15,-1,2,210000,15000,225000
3892,20,15,7,-1,1,216000,0,216000
3893,14,10,15,-1,2,237000,15000,252000
3894,8,10,12,-1,2,267000,0,267000
3895,15,12,7,-1,2,216000,0,216000
3896,11,10,13,11,2,312000,90000,402000
3897,14,7,19,-1,1,207000,0,207000
3898,12,16,6,-1,1,216000,0,216000
3899,8,6,12,-1,2,252000,0,252000
3900,8,14,16,-1,2,216000,0,216000
3901,10,19,11,-1,2,219000,15000,234000
3902,20,16,12,-1,1,171000,0,171000
3903,8,10,9,13,2,396000,365000,761000
3904,9,11,7,-1,2,264000,15000,279000
3905,11,18,13,-1,2,171000,0,171000
3906,5,6,14,-1,2,264000,15000,279000
3907,18,16,11,-1,2,198000,0,198000
3908,18,13,8,-1,1,216000,0,216000
3909,5,12,18,-1,1,216000,0,216000
3910,15,8,17,13,2,348000,135000,483000
3911,8,16,12,-1,1,216000,0,216000
3912,10,5,12,-1,2,252000,0,252000
3913,8,12,9,-1,2,234000,15000,249000
3914,19,14,15,-1,2,165000,15000,180000
3915,13,12,5,-1,2,288000,45000,333000
3916,8,6,10,-1,2,276000,0,276000
3917,19,8,13,13,2,264000,0,264000
3918,12,20,13,-1,2,201000,15000,216000
3919,15,18,11,-1,2,234000,0,234000
3920,15,17,10,-1,2,243000,0,243000
3921,7,19,17,-1,2,234000,0,234000
3922,13,12,20,-1,2,210000,15000,225000
3923,11,10,7,-1,2,288000,30000,318000
3924,18,14,7,11,2,348000,45000,393000
3925,8,20,10,-1,2,252000,0,252000
3926,13,16,18,-1,2,213000,0,213000
3927,6,12,7,-1,2,300000,30000,330000
3928,13,13,7,-1,1,171000,0,171000
3929,12,9,11,-1,2,195000,15000,210000
3930,9,16,5,-1,1,207000,0,207000
3931,6,18,15,13,2,336000,45000,381000
3932,16,10,15,-1,2,264000,15000,279000
3933,9,14,12,-1,2,267000,0,267000
3934,11,7,14,-1,2,234000,0,234000
3935,8,12,6,-1,2,243000,0,243000
3936,15,17,5,-1,2,216000,0,216000
3937,19,11,18,-1,2,201000,15000,216000
3938,8,14,19,13,2,348000,120000,468000
3939,13,13,7,-1,1,189000,0,189000
3940,12,6,20,-1,1,162000,0,162000
3941,9,8,15,-1,2,246000,15000,261000
3942,18,16,6,-1,2,225000,0,225000
3943,7,8,11,-1,2,270000,15000,285000
3944,7,18,5,-1,2,225000,0,225000
3945,15,19,13,12,2,318000,60000,378000
3946,19,12,9,-1,2,252000,0,252000
3947,16,17,13,-1,2,231000,15000,246000
3948,6,17,12,-1,1,216000,0,216000
3949,8,12,18,-1,1,216000,0,216000
3950,20,16,8,-1,1,216000,0,216000
3951,14,6,5,-1,2,264000,15000,279000
3952,12,11,16,13,2,360000,180000,540000
3953,6,10,9,-1,2,312000,90000,402000
3954,19,8,18,-1,2,210000,15000,225000
3955,20,14,16,-1,2,189000,0,189000
3956,16,15,20,-1,2,228000,15000,243000
3957,15,11,19,-1,2,252000,15000,267000
3958,14,19,11,-1,2,234000,0,234000
3959,6,14,12,13,2,348000,310000,658000
3960,18,10,8,-1,2,243000,0,243000
3961,14,11,19,-1,2,198000,0,198000
3962,10,9,15,-1,2,264000,15000,279000
3963,18,19,20,-1,2,168000,30000,198000
3964,16,13,6,-1,2,252000,0,252000
3965,15,13,20,-1,2,171000,0,171000
3966,8,11,13,12,2,372000,310000,682000
3967,9,6,5,-1,2,300000,30000,330000
3968,17,6,8,-1,2,198000,0,198000
3969,16,9,17,-1,2,210000,15000,225000
3970,9,12,20,-1,2,225000,0,225000
3971,5,17,20,-1,2,234000,0,234000
3972,17,7,9,-1,2,252000,0,252000
3973,13,17,16,11,2,348000,45000,393000
3974,12,8,14,-1,2,264000,15000,279000
3975,14,20,19,-1,2,183000,15000,198000
3976,16,13,7,-1,2,264000,15000,279000
3977,11,13,15,-1,2,249000,0,249000
3978,15,20,6,-1,1,207000,0,207000
3979,11,6,20,-1,1,216000,0,216000
3980,9,16,6,13,2,372000,185000,557000
3981,7,18,15,-1,2,252000,0,252000
3982,6,14,20,-1,1,216000,0,216000
3983,9,6,12,-1,2,300000,30000,330000
3984,19,15,16,-1,2,180000,15000,195000
3985,20,13,9,-1,1,216000,0,216000
3986,16,20,10,-1,1,216000,0,216000
3987,15,8,5,11,2,408000,385000,793000
3988,20,9,13,-1,1,216000,0,216000
3989,10,19,15,-1,1,216000,0,216000
3990,18,20,8,-1,2,252000,0,252000
3991,6,15,17,-1,2,252000,0,252000
3992,13,7,19,-1,1,198000,0,198000
3993,14,7,13,-1,2,264000,15000,279000
3994,10,11,5,13,2,348000,230000,578000
3995,12,15,6,-1,2,264000,15000,279000
3996,20,9,19,-1,2,228000,15000,243000
3997,19,19,13,-1,1,171000,0,171000
3998,13,20,12,-1,2,201000,15000,216000
3999,16,18,19,-1,2,213000,15000,228000
4000,10,12,8,-1,2,300000,30000,330000
4001,10,16,14,12,2,336000,120000,456000
4002,11,10,13,-1,2,288000,30000,318000
4003,16,17,14,-1,2,195000,15000,210000
4004,8,18,14,-1,1,216000,0,216000
4005,19,11,13,-1,2,234000,0,234000
4006,10,11,20,-1,2,246000,15000,261000
4007,6,11,14,-1,2,252000,0,252000
4008,18,17,16,11,2,348000,45000,393000
4009,15,6,14,-1,2,276000,30000,306000
4010,12,11,15,-1,2,252000,15000,267000
4011,7,9,11,-1,2,267000,0,267000
4012,9,15,12,-1,2,189000,0,189000
4013,12,16,8,-1,1,207000,0,207000
4014,13,6,19,-1,1,216000,0,216000
4015,16,15,18,13,2,348000,90000,438000
4016,8,12,7,-1,2,252000,0,252000
4017,18,20,10,-1,2,189000,0,189000
4018,20,11,13,-1,2,216000,0,216000
4019,15,8,5,-1,2,252000,0,252000
4020,13,6,9,-1,2,252000,0,252000
4021,9,8,20,-1,2,228000,15000,243000
4022,8,19,7,13,2,360000,155000,515000
4023,11,12,14,-1,2,279000,30000,309000
4024,7,9,12,-1,2,243000,0,243000
4025,16,9,5,-1,1,207000,0,207000
4026,14,10,16,-1,2,207000,0,207000
4027,6,18,12,-1,1,216000,0,216000
4028,19,12,19,-1,1,171000,0,171000
4029,13,11,6,12,2,348000,150000,498000
4030,8,10,5,-1,2,312000,75000,387000
4031,14,12,16,-1,2,195000,0,195000
4032,13,11,12,-1,2,252000,30000,282000
4033,6,7,17,-1,2,264000,15000,279000
4034,15,14,8,-1,2,219000,15000,234000
4035,9,6,18,-1,2,243000,0,243000
4036,15,17,14,11,2,348000,45000,393000
4037,14,6,7,-1,2,264000,15000,279000
4038,20,5,17,-1,2,225000,0,225000
4039,20,5,9,-1,1,216000,0,216000
4040,12,8,15,-1,2,243000,0,243000
4041,6,15,16,-1,2,255000,15000,270000
4042,11,7,18,-1,1,189000,0,189000
4043,19,14,18,13,2,348000,60000,408000
4044,10,8,14,-1,2,300000,30000,330000
4045,6,15,8,-1,2,243000,0,243000
4046,15,5,6,-1,2,246000,15000,261000
4047,11,19,16,-1,2,171000,0,171000
4048,13,9,18,-1,1,216000,0,216000
4049,19,8,18,-1,2,255000,15000,270000
4050,8,7,17,13,2,384000,185000,569000
4051,15,11,14,-1,2,267000,15000,282000
4052,13,14,8,-1,2,255000,15000,270000
4053,15,17,11,-1,2,198000,0,198000
4054,15,7,10,-1,2,252000,0,252000
4055,17,12,14,-1,2,198000,0,198000
4056,17,20,11,-1,2,234000,0,234000
4057,15,18,17,12,2,360000,90000,450000
4058,11,14,13,-1,2,246000,15000,261000
4059,20,8,10,-1,2,216000,0,216000
4060,10,13,19,-1,2,207000,0,207000
4061,15,7,19,-1,1,216000,0,216000
4062,20,10,7,-1,2,252000,0,252000
4063,11,10,17,-1,2,228000,15000,243000
4064,15,13,8,11,2,372000,195000,567000
4065,8,13,19,-1,1,216000,0,216000
4066,13,9,14,-1,2,276000,30000,306000
4067,13,20,8,-1,1,207000,0,207000
4068,9,11,12,-1,2,267000,15000,282000
4069,18,13,14,-1,2,183000,15000,198000
4070,10,13,12,-1,2,276000,15000,291000
4071,19,11,16,12,2,348000,75000,423000
4072,13,20,8,-1,1,216000,0,216000
4073,6,13,17,-1,2,252000,15000,267000
4074,16,15,13,-1,2,231000,15000,246000
4075,7,8,10,-1,2,300000,45000,345000
4076,15,14,20,-1,2,156000,15000,171000
4077,14,16,9,-1,2,264000,15000,279000
4078,6,15,9,11,2,384000,315000,699000
4079,14,20,5,-1,1,216000,0,216000
4080,13,15,10,-1,2,276000,0,276000
4081,10,18,14,-1,1,180000,0,180000
4082,19,8,12,-1,1,216000,0,216000
4083,18,20,9,-1,2,252000,0,252000
4084,7,6,11,-1,2,300000,30000,330000
4085,18,20,17,11,2,318000,30000,348000
4086,15,16,20,-1,2,219000,15000,234000
4087,20,18,16,-1,2,240000,0,240000
4088,16,13,5,-1,2,264000,15000,279000
4089,8,6,12,-1,2,288000,15000,303000
4090,17,11,16,-1,2,183000,15000,198000
4091,12,17,10,-1,2,234000,0,234000
4092,5,6,12,13,2,384000,295000,679000
4093,19,9,8,-1,2,264000,15000,279000
4094,15,12,11,-1,2,261000,15000,276000
4095,20,18,6,-1,2,216000,0,216000
4096,12,16,19,-1,2,207000,0,207000
4097,6,13,16,-1,2,264000,15000,279000
4098,15,10,10,-1,1,189000,0,189000
4099,6,8,19,13,2,300000,0,300000
4100,7,8,19,-1,2,264000,15000,279000
4101,11,20,15,-1,1,189000,0,189000
4102,20,12,10,-1,2,252000,0,252000
4103,14,5,10,-1,2,252000,15000,267000
4104,14,5,6,-1,2,264000,15000,279000
4105,8,13,6,-1,2,216000,0,216000
4106,8,13,10,13,2,300000,0,300000
4107,10,13,9,-1,2,243000,15000,258000
4108,6,14,11,-1,2,234000,0,234000
4109,15,6,14,-1,2,246000,15000,261000
4110,7,9,17,-1,2,216000,0,216000
4111,5,18,13,-1,1,207000,0,207000
4112,16,7,13,-1,2,234000,0,234000
4113,7,12,13,12,2,300000,45000,345000
4114,5,6,6,-1,2,219000,15000,234000
4115,10,15,18,-1,2,162000,0,162000
4116,12,6,20,-1,1,216000,0,216000
4117,11,15,17,-1,2,225000,0,225000
4118,11,14,14,-1,2,225000,0,225000
4119,15,12,16,-1,2,177000,15000,192000
4120,14,7,12,12,2,312000,45000,357000
4121,15,17,11,-1,2,225000,0,225000
4122,14,13,12,-1,2,252000,30000,282000
4123,17,19,12,-1,2,207000,0,207000
4124,8,12,14,-1,2,264000,15000,279000
4125,19,18,8,-1,2,219000,15000,234000
4126,17,7,19,-1,2,234000,0,234000
4127,16,11,8,12,2,360000,135000,495000
4128,12,13,15,-1,2,279000,30000,309000
4129,19,10,6,-1,1,216000,0,216000
4130,6,9,10,-1,2,288000,30000,318000
4131,16,11,12,-1,2,183000,15000,198000
4132,11,10,15,-1,2,246000,15000,261000
4133,8,9,19,-1,2,255000,15000,270000
4134,15,17,18,11,2,336000,30000,366000
4135,12,17,5,-1,2,252000,15000,267000
4136,12,14,7,-1,2,252000,0,252000
4137,18,7,12,-1,1,198000,0,198000
4138,13,18,10,-1,2,225000,0,225000
4139,20,6,10,-1,1,216000,0,216000
4140,19,10,17,-1,2,234000,0,234000
4141,18,11,5,13,2,348000,260000,608000
4142,19,7,6,-1,2,276000,30000,306000
4143,7,14,9,-1,2,252000,0,252000
4144,14,10,9,-1,2,228000,15000,243000
4145,17,19,7,-1,2,225000,0,225000
4146,16,19,13,-1,2,189000,0,189000
4147,13,8,9,-1,2,312000,45000,357000
4148,17,14,9,12,2,348000,120000,468000
4149,20,18,5,-1,2,252000,0,252000
4150,8,16,20,-1,1,207000,0,207000
4151,6,10,19,-1,1,216000,0,216000
4152,12,14,9,-1,2,267000,0,267000
4153,7,12,14,-1,2,234000,0,234000
4154,16,13,10,-1,2,198000,0,198000
4155,17,6,5,12,2,396000,210000,606000
4156,14,11,18,-1,2,243000,0,243000
4157,11,18,17,-1,2,246000,15000,261000
4158,10,5,15,-1,2,252000,15000,267000
4159,8,12,9,-1,2,261000,15000,276000
4160,11,16,20,-1,1,144000,0,144000
4161,10,13,7,-1,2,300000,30000,330000
4162,18,6,11,12,2,348000,90000,438000
4163,18,11,17,-1,2,264000,15000,279000
4164,7,16,15,-1,2,264000,15000,279000
4165,6,13,10,-1,2,243000,0,243000
4166,7,20,11,-1,1,189000,0,189000
4167,20,9,19,-1,2,228000,15000,243000
4168,12,8,19,-1,1,216000,0,216000
4169,20,8,16,12,2,360000,60000,420000
4170,7,8,14,-1,2,312000,45000,357000
4171,11,16,5,-1,1,216000,0,216000
4172,13,20,12,-1,2,201000,15000,216000
4173,11,13,15,-1,2,258000,0,258000
4174,19,8,6,-1,2,252000,0,252000
4175,5,18,6,-1,2,246000,15000,261000
4176,12,7,10,11,2,348000,120000,468000
4177,18,11,14,-1,2,225000,0,225000
4178,6,19,5,-1,2,264000,15000,279000
4179,14,6,9,-1,2,252000,0,252000
4180,14,6,7,-1,2,246000,15000,261000
4181,7,6,7,-1,2,192000,15000,207000
4182,15,16,12,-1,2,168000,15000,183000
4183,7,6,13,11,2,396000,280000,676000
4184,9,16,13,-1,2,264000,15000,279000
4185,11,15,8,-1,2,243000,0,243000
4186,8,19,12,-1,1,198000,0,198000
4187,11,6,7,-1,2,300000,30000,330000
4188,12,15,18,-1,2,162000,0,162000
4189,18,8,10,-1,2,252000,0,252000
4190,14,17,19,12,2,360000,45000,405000
4191,17,18,10,-1,2,264000,15000,279000
4192,14,11,17,-1,2,225000,0,225000
4193,20,15,11,-1,1,198000,0,198000
4194,5,8,12,-1,2,312000,45000,357000
4195,16,9,7,-1,2,225000,0,225000
4196,14,16,11,-1,2,213000,0,213000
4197,7,17,15,11,2,360000,90000,450000
4198,14,5,7,-1,2,300000,30000,330000
4199,7,10,6,-1,2,270000,15000,285000
4200,13,9,7,-1,2,198000,0,198000
4201,9,11,5,-1,2,243000,0,243000
4202,8,15,16,-1,2,210000,15000,225000
4203,17,5,10,-1,1,216000,0,216000
4204,15,16,14,11,2,348000,45000,393000
4205,14,13,9,-1,2,276000,30000,306000
4206,15,20,9,-1,1,189000,0,189000
4207,18,13,12,-1,2,237000,15000,252000
4208,5,18,10,-1,1,216000,0,216000
4209,20,14,12,-1,2,225000,0,225000
4210,10,12,11,-1,2,279000,30000,309000
4211,11,20,13,12,2,348000,105000,453000
4212,5,8,10,-1,2,312000,75000,387000
4213,17,10,16,-1,2,210000,15000,225000
4214,15,8,7,-1,2,264000,15000,279000
4215,20,17,11,-1,2,189000,0,189000
4216,6,15,9,-1,2,252000,0,252000
4217,19,12,5,-1,1,216000,0,216000
4218,9,8,7,13,2,384000,310000,694000
4219,8,18,14,-1,1,216000,0,216000
4220,20,16,8,-1,1,216000,0,216000
4221,9,10,12,-1,2,300000,45000,345000
4222,19,11,8,-1,2,216000,0,216000
4223,19,16,8,-1,2,234000,0,234000
4224,12,10,13,-1,2,240000,15000,255000
4225,10,20,7,11,2,348000,75000,423000
4226,6,5,12,-1,2,324000,60000,384000
4227,18,14,12,-1,2,171000,0,171000
4228,13,12,11,-1,2,270000,30000,300000
4229,19,8,15,-1,1,198000,0,198000
4230,6,18,8,-1,2,252000,0,252000
4231,13,12,11,-1,2,234000,30000,264000
4232,17,15,16,13,2,348000,75000,423000
4233,5,11,17,-1,2,252000,15000,267000
4234,17,18,13,-1,2,219000,15000,234000
4235,10,18,20,-1,2,252000,0,252000
4236,13,5,7,-1,2,252000,0,252000
4237,14,8,16,-1,2,216000,0,216000
4238,15,9,6,-1,2,243000,0,243000
4239,12,16,14,13,2,336000,150000,486000
4240,17,10,12,-1,2,252000,0,252000
4241,6,7,5,-1,2,312000,60000,372000
4242,7,16,15,-1,2,210000,15000,225000
4243,5,16,10,-1,1,207000,0,207000
4244,13,19,15,-1,2,180000,0,180000
4245,20,8,16,-1,1,216000,0,216000
4246,8,7,20,13,2,396000,220000,616000
4247,12,16,8,-1,2,264000,30000,294000
4248,20,12,10,-1,2,234000,0,234000
4249,15,5,9,-1,1,216000,0,216000
4250,16,6,9,-1,2,252000,0,252000
4251,9,16,15,-1,2,228000,15000,243000
4252,7,19,9,-1,2,243000,0,243000
4253,17,12,8,11,2,348000,105000,453000
4254,11,9,17,-1,2,252000,0,252000
4255,5,8,10,-1,2,288000,15000,303000
4256,10,11,17,-1,2,192000,15000,207000
4257,17,18,7,-1,2,246000,15000,261000
4258,20,8,9,-1,2,246000,15000,261000
4259,15,10,7,-1,2,234000,0,234000
4260,19,10,5,12,2,348000,230000,578000
4261,6,20,18,-1,2,252000,0,252000
4262,16,6,10,-1,1,216000,0,216000
4263,9,5,10,-1,2,276000,30000,306000
4264,11,13,8,-1,2,231000,0,231000
4265,19,14,11,-1,2,189000,0,189000
4266,14,19,6,-1,1,216000,0,216000
4267,20,19,9,12,2,336000,120000,456000
4268,17,20,5,-1,2,243000,0,243000
4269,9,10,17,-1,2,246000,15000,261000
4270,17,9,13,-1,1,189000,0,189000
4271,11,18,8,-1,2,252000,0,252000
4272,18,20,19,-1,2,177000,30000,207000
4273,7,18,11,-1,1,216000,0,216000
4274,15,19,13,11,2,360000,60000,420000
4275,11,17,12,-1,2,255000,15000,270000
4276,17,11,15,-1,2,225000,0,225000
4277,5,6,8,-1,2,312000,60000,372000
4278,16,13,20,-1,2,144000,0,144000
4279,8,14,10,-1,2,288000,15000,303000
4280,16,9,5,-1,1,216000,0,216000
4281,7,13,9,11,2,360000,135000,495000
4282,17,19,8,-1,2,252000,0,252000
4283,8,14,17,-1,2,234000,0,234000
4284,10,15,17,-1,2,216000,0,216000
4285,15,19,14,-1,2,201000,15000,216000
4286,19,10,6,-1,2,252000,15000,267000
4287,16,6,9,-1,2,252000,0,252000
4288,9,18,5,11,2,360000,285000,645000
4289,18,5,17,-1,2,264000,15000,279000
4290,17,7,14,-1,2,252000,0,252000
4291,13,8,14,-1,2,237000,15000,252000
4292,17,5,12,-1,1,216000,0,216000
4293,15,18,9,-1,2,216000,0,216000
4294,15,16,10,-1,2,237000,15000,252000
4295,9,13,14,12,2,360000,165000,525000
4296,18,12,9,-1,2,252000,0,252000
4297,13,16,14,-1,2,261000,30000,291000
4298,14,15,16,-1,2,234000,30000,264000
4299,18,12,20,-1,2,225000,0,225000
4300,13,6,17,-1,1,216000,0,216000
4301,11,19,15,-1,1,198000,0,198000
4302,18,16,17,11,2,348000,105000,453000
4303,14,18,11,-1,2,234000,0,234000
4304,16,5,9,-1,2,252000,15000,267000
4305,7,9,13,-1,2,243000,0,243000
4306,13,20,11,-1,2,189000,0,189000
4307,17,6,14,-1,2,252000,0,252000
4308,18,19,11,-1,2,219000,15000,234000
4309,6,5,19,11,2,396000,220000,616000
4310,15,5,18,-1,2,252000,0,252000
4311,16,8,20,-1,1,216000,0,216000
4312,12,9,19,-1,2,243000,0,243000
4313,17,16,11,-1,2,228000,15000,243000
4314,19,7,14,-1,1,216000,0,216000
4315,9,6,10,-1,2,288000,30000,318000
4316,7,12,16,13,2,336000,105000,441000
4317,9,12,13,-1,2,288000,30000,318000
4318,5,14,9,-1,1,216000,0,216000
4319,19,7,14,-1,1,198000,0,198000
4320,14,18,7,-1,1,216000,0,216000
4321,11,16,18,-1,2,216000,0,216000
4322,17,6,8,-1,2,252000,0,252000
4323,7,14,15,11,2,348000,90000,438000
4324,7,15,12,-1,2,264000,15000,279000
4325,14,17,17,-1,2,189000,0,189000
4326,18,12,16,-1,2,180000,0,180000
4327,14,9,16,-1,2,252000,0,252000
4328,20,10,7,-1,2,243000,0,243000
4329,8,13,6,-1,2,243000,0,243000
4330,12,15,20,11,2,312000,45000,357000
4331,13,6,19,-1,1,216000,0,216000
4332,9,6,19,-1,2,264000,15000,279000
4333,10,14,19,-1,1,198000,0,198000
4334,9,13,17,-1,2,252000,15000,267000
4335,19,13,17,-1,2,198000,0,198000
4336,20,9,18,-1,2,252000,0,252000
4337,11,6,18,12,2,360000,260000,620000
4338,11,16,19,-1,2,252000,0,252000
4339,7,19,13,-1,1,216000,0,216000
4340,5,18,15,-1,2,252000,0,252000
4341,7,13,5,-1,2,252000,0,252000
4342,18,10,12,-1,2,207000,0,207000
4343,5,14,13,-1,2,264000,15000,279000
4344,17,13,10,12,2,336000,105000,441000
4345,11,9,20,-1,2,252000,0,252000
4346,20,15,9,-1,1,198000,0,198000
4347,5,10,8,-1,2,300000,30000,330000
4348,5,20,14,-1,1,189000,0,189000
4349,15,18,6,-1,2,243000,0,243000
4350,9,5,16,-1,1,216000,0,216000
4351,8,11,6,12,2,372000,255000,627000
4352,6,17,18,-1,2,264000,15000,279000
4353,19,11,15,-1,1,171000,0,171000
4354,14,6,10,-1,2,288000,30000,318000
4355,15,6,17,-1,2,234000,0,234000
4356,12,11,19,-1,2,201000,15000,216000
4357,14,13,18,-1,2,219000,15000,234000
4358,11,12,5,13,2,360000,430000,790000
4359,20,10,18,-1,2,225000,0,225000
4360,10,8,5,-1,2,288000,15000,303000
4361,13,19,10,-1,2,180000,0,180000
4362,14,20,13,-1,2,219000,15000,234000
4363,17,10,15,-1,2,252000,0,252000
4364,14,6,18,-1,1,216000,0,216000
4365,10,11,15,11,2,324000,75000,399000
4366,19,7,14,-1,1,216000,0,216000
4367,8,14,17,-1,2,243000,0,243000
4368,9,17,7,-1,2,243000,0,243000
4369,11,5,12,-1,2,255000,15000,270000
4370,8,5,6,-1,2,261000,30000,291000
4371,12,10,17,-1,2,162000,0,162000
4372,15,13,6,12,2,360000,150000,510000
4373,12,18,15,-1,2,243000,0,243000
4374,15,10,7,-1,2,288000,15000,303000
4375,20,6,10,-1,1,207000,0,207000
4376,9,6,5,-1,2,300000,30000,330000
4377,13,6,7,-1,2,210000,15000,225000
4378,18,16,11,-1,2,180000,0,180000
4379,8,13,20,11,2,372000,135000,507000
4380,11,15,20,-1,1,216000,0,216000
4381,19,13,16,-1,2,243000,0,243000
4382,9,13,6,-1,2,312000,45000,357000
4383,9,19,8,-1,2,228000,15000,243000
4384,18,9,13,-1,1,180000,0,180000
4385,9,6,5,-1,2,312000,45000,357000
4386,20,9,7,12,2,300000,0,300000
4387,9,12,17,-1,2,252000,0,252000
4388,16,10,6,-1,2,252000,15000,267000
4389,17,18,20,-1,2,189000,30000,219000
4390,15,11,14,-1,2,288000,30000,318000
4391,18,7,16,-1,2,243000,0,243000
4392,8,15,14,-1,2,237000,15000,252000
4393,12,8,10,11,2,360000,150000,510000
4394,19,8,12,-1,1,216000,0,216000
4395,15,17,8,-1,2,252000,0,252000
4396,13,7,5,-1,2,252000,0,252000
4397,16,8,11,-1,2,207000,0,207000
4398,5,8,10,-1,2,288000,15000,303000
4399,15,10,18,-1,2,171000,0,171000
4400,20,13,15,12,2,360000,90000,450000
4401,19,11,12,-1,2,264000,15000,279000
4402,11,7,8,-1,2,300000,30000,330000
4403,18,6,10,-1,1,189000,0,189000
4404,14,12,15,-1,2,222000,15000,237000
4405,19,9,16,-1,2,234000,0,234000
4406,7,19,8,-1,2,264000,15000,279000
4407,12,14,13,11,2,348000,105000,453000
4408,14,12,18,-1,2,225000,0,225000
4409,20,5,18,-1,2,243000,0,243000
4410,13,17,7,-1,1,216000,0,216000
4411,14,17,13,-1,2,234000,15000,249000
4412,8,13,15,-1,2,252000,0,252000
4413,12,14,8,-1,2,225000,0,225000
4414,17,15,18,13,2,336000,45000,381000
4415,8,17,10,-1,2,252000,0,252000
4416,12,7,8,-1,2,300000,30000,330000
4417,5,9,13,-1,1,189000,0,189000
4418,17,15,8,-1,2,225000,0,225000
4419,7,13,18,-1,1,198000,0,198000
4420,17,6,16,-1,2,255000,15000,270000
4421,14,16,8,13,2,336000,90000,426000
4422,20,11,10,-1,2,264000,15000,279000
4423,20,8,17,-1,2,243000,0,243000
4424,15,10,11,-1,2,237000,15000,252000
4425,6,5,18,-1,2,264000,15000,279000
4426,10,20,9,-1,2,219000,15000,234000
4427,15,12,8,-1,2,234000,0,234000
4428,7,17,15,13,2,348000,105000,453000
4429,12,8,6,-1,2,312000,45000,357000
4430,14,8,17,-1,2,207000,0,207000
4431,11,13,20,-1,2,207000,0,207000
4432,17,8,12,-1,1,216000,0,216000
4433,8,6,5,-1,2,312000,60000,372000
4434,8,7,16,-1,2,210000,15000,225000
4435,6,6,20,12,2,264000,0,264000
4436,19,5,20,-1,2,237000,15000,252000
4437,5,8,18,-1,2,252000,0,252000
4438,13,17,9,-1,1,189000,0,189000
4439,10,12,19,-1,2,243000,0,243000
4440,14,8,12,-1,2,243000,0,243000
4441,6,13,14,-1,2,255000,15000,270000
4442,16,20,8,11,2,324000,75000,399000
4443,13,6,20,-1,1,216000,0,216000
4444,6,20,7,-1,2,276000,30000,306000
4445,13,5,20,-1,1,216000,0,216000
4446,6,8,7,-1,2,300000,45000,345000
4447,8,13,18,-1,1,153000,0,153000
4448,5,11,13,-1,2,264000,15000,279000
4449,6,20,12,13,2,336000,75000,411000
4450,9,15,14,-1,2,276000,30000,306000
4451,6,16,11,-1,1,216000,0,216000
4452,11,7,16,-1,1,216000,0,216000
4453,12,17,7,-1,1,216000,0,216000
4454,20,13,12,-1,2,219000,15000,234000
4455,17,12,14,-1,2,225000,0,225000
4456,6,5,13,11,2,408000,320000,728000
4457,5,16,13,-1,2,264000,15000,279000
4458,17,10,8,-1,2,243000,0,243000
4459,9,11,19,-1,2,216000,0,216000
4460,19,9,6,-1,2,252000,0,252000
4461,12,8,11,-1,2,240000,15000,255000
4462,5,14,16,-1,2,234000,0,234000
4463,5,16,9,11,2,336000,105000,441000
4464,15,12,13,-1,2,261000,30000,291000
4465,12,16,11,-1,2,228000,15000,243000
4466,19,7,10,-1,2,252000,0,252000
4467,18,9,15,-1,2,225000,0,225000
4468,5,15,11,-1,1,216000,0,216000
4469,17,11,16,-1,2,228000,15000,243000
4470,14,6,9,12,2,384000,265000,649000
4471,15,10,7,-1,2,288000,15000,303000
4472,12,20,8,-1,1,198000,0,198000
4473,16,20,6,-1,1,216000,0,216000
4474,13,9,11,-1,2,267000,0,267000
4475,10,7,11,-1,2,249000,15000,264000
4476,11,7,9,-1,2,240000,0,240000
4477,18,6,15,11,2,324000,30000,354000
4478,19,13,10,-1,2,252000,0,252000
4479,19,14,17,-1,2,222000,0,222000
4480,6,15,5,-1,2,276000,30000,306000
4481,16,20,15,-1,2,183000,15000,198000
4482,11,12,16,-1,2,300000,30000,330000
4483,12,5,18,-1,1,216000,0,216000
4484,12,17,18,13,2,348000,90000,438000
4485,19,18,17,-1,2,243000,30000,273000
4486,16,6,8,-1,2,264000,15000,279000
4487,11,18,19,-1,2,237000,15000,252000
4488,10,20,5,-1,1,216000,0,216000
4489,7,5,12,-1,2,288000,15000,303000
4490,12,7,14,-1,2,207000,0,207000
4491,20,7,10,11,2,348000,75000,423000
4492,17,8,7,-1,2,264000,15000,279000
4493,18,19,5,-1,2,237000,15000,252000
4494,20,9,10,-1,2,246000,15000,261000
4495,18,20,10,-1,2,216000,0,216000
4496,17,14,9,-1,2,234000,0,234000
4497,15,6,8,-1,2,252000,0,252000
4498,11,8,7,12,2,372000,230000,602000
4499,6,15,7,-1,2,264000,15000,279000
4500,14,12,13,-1,2,225000,30000,255000
4501,15,17,10,-1,2,225000,0,225000
4502,6,11,16,-1,1,216000,0,216000
4503,15,12,13,-1,2,243000,30000,273000
4504,18,9,19,-1,2,237000,15000,252000
4505,6,17,12,11,2,360000,120000,480000
4506,18,19,14,-1,2,237000,15000,252000
4507,5,20,12,-1,1,216000,0,216000
4508,11,9,20,-1,2,252000,0,252000
4509,19,14,5,-1,1,216000,0,216000
4510,5,15,16,-1,2,264000,15000,279000
4511,13,14,16,-1,2,216000,30000,246000
4512,14,6,19,12,2,360000,75000,435000
4513,7,11,5,-1,2,324000,60000,384000
4514,10,15,11,-1,2,201000,15000,216000
4515,19,20,18,-1,2,177000,30000,207000
4516,12,8,15,-1,2,252000,0,252000
4517,19,15,5,-1,1,189000,0,189000
4518,16,5,15,-1,2,264000,15000,279000
4519,10,16,5,11,2,348000,120000,468000
4520,9,16,6,-1,2,252000,0,252000
4521,14,6,15,-1,2,264000,15000,279000
4522,15,7,19,-1,1,198000,0,198000
4523,14,5,17,-1,2,252000,0,252000
4524,15,20,5,-1,1,198000,0,198000
4525,15,6,11,-1,1,216000,0,216000
4526,11,10,8,13,2,372000,270000,642000
4527,5,6,16,-1,2,276000,30000,306000
4528,9,20,13,-1,1,189000,0,189000
4529,12,5,19,-1,1,216000,0,216000
4530,9,12,13,-1,2,276000,15000,291000
4531,8,7,19,-1,2,246000,15000,261000
4532,12,13,17,-1,2,192000,15000,207000
4533,16,9,17,12,2,360000,165000,525000
4534,16,12,11,-1,2,243000,0,243000
4535,15,6,8,-1,2,243000,0,243000
4536,5,16,7,-1,2,234000,0,234000
4537,9,15,10,-1,2,201000,15000,216000
4538,8,11,18,-1,2,234000,0,234000
4539,10,9,6,-1,2,276000,15000,291000
4540,13,8,13,11,2,300000,75000,375000
4541,18,12,8,-1,1,180000,0,180000
4542,5,15,16,-1,2,264000,15000,279000
4543,11,14,15,-1,2,222000,15000,237000
4544,19,5,13,-1,1,216000,0,216000
4545,19,9,18,-1,2,237000,15000,252000
4546,18,10,8,-1,2,243000,0,243000
4547,15,16,18,13,2,336000,60000,396000
4548,9,14,7,-1,2,288000,15000,303000
4549,12,11,8,-1,2,249000,15000,264000
4550,8,5,20,-1,2,234000,0,234000
4551,14,13,10,-1,2,222000,15000,237000
4552,13,19,16,-1,2,189000,0,189000
4553,9,20,13,-1,1,216000,0,216000
4554,19,20,11,12,2,348000,150000,498000
4555,6,15,11,-1,2,252000,15000,267000
4556,9,10,13,-1,2,261000,15000,276000
4557,7,10,15,-1,2,225000,0,225000
4558,20,13,8,-1,1,189000,0,189000
4559,13,18,8,-1,1,216000,0,216000
4560,17,11,19,-1,2,225000,0,225000
4561,12,9,14,13,2,360000,180000,540000
4562,11,17,10,-1,2,243000,0,243000
4563,17,7,20,-1,2,207000,0,207000
4564,5,13,17,-1,1,216000,0,216000
4565,14,5,9,-1,2,252000,15000,267000
4566,18,15,14,-1,2,198000,15000,213000
4567,15,13,8,-1,2,252000,0,252000
4568,9,12,6,13,2,372000,280000,652000
4569,14,10,16,-1,2,264000,15000,279000
4570,18,19,12,-1,2,219000,15000,234000
4571,10,5,18,-1,1,216000,0,216000
4572,15,13,18,-1,2,216000,0,216000
4573,11,6,17,-1,2,252000,15000,267000
4574,15,12,9,-1,2,234000,0,234000
4575,14,9,12,13,2,360000,150000,510000
4576,5,18,19,-1,2,264000,15000,279000
4577,8,10,15,-1,2,252000,0,252000
4578,5,12,10,-1,2,252000,0,252000
4579,9,10,14,-1,2,210000,15000,225000
4580,19,14,18,-1,2,192000,15000,207000
4581,13,17,15,-1,2,258000,0,258000
4582,10,7,17,13,2,384000,210000,594000
4583,18,11,8,-1,2,252000,0,252000
4584,18,20,14,-1,2,207000,0,207000
4585,6,15,7,-1,2,276000,30000,306000
4586,11,14,10,-1,2,261000,15000,276000
4587,5,15,11,-1,1,216000,0,216000
4588,14,10,15,-1,2,219000,15000,234000
4589,6,9,10,13,2,384000,300000,684000
4590,9,20,14,-1,1,216000,0,216000
4591,10,18,20,-1,2,252000,0,252000
4592,10,6,9,-1,2,288000,30000,318000
4593,18,19,14,-1,2,156000,15000,171000
4594,8,13,17,-1,2,252000,15000,267000
4595,13,16,11,-1,2,225000,0,225000
4596,6,10,12,11,2,372000,360000,732000
4597,9,19,13,-1,2,252000,15000,267000
4598,6,18,16,-1,2,252000,0,252000
4599,8,7,5,-1,2,288000,30000,318000
4600,11,9,13,-1,2,195000,0,195000
4601,16,7,18,-1,2,216000,0,216000
4602,7,18,6,-1,2,255000,15000,270000
4603,8,15,11,12,2,348000,105000,453000
4604,20,15,8,-1,1,216000,0,216000
4605,15,14,18,-1,2,243000,15000,258000
4606,6,10,15,-1,2,252000,15000,267000
4607,14,12,19,-1,2,198000,0,198000
4608,15,10,18,-1,2,243000,0,243000
4609,14,6,13,-1,2,264000,15000,279000
4610,15,7,11,12,2,348000,135000,483000
4611,18,15,10,-1,2,252000,0,252000
4612,17,16,7,-1,2,264000,15000,279000
4613,18,12,16,-1,2,198000,0,198000
4614,5,13,17,-1,1,216000,0,216000
4615,10,15,18,-1,2,243000,0,243000
4616,10,16,5,-1,1,216000,0,216000
4617,18,5,11,13,2,348000,300000,648000
4618,19,6,18,-1,2,219000,15000,234000
4619,8,18,20,-1,2,225000,0,225000
4620,5,14,19,-1,1,216000,0,216000
4621,17,7,17,-1,1,198000,0,198000
4622,20,10,19,-1,2,174000,15000,189000
4623,16,15,17,-1,2,225000,30000,255000
4624,13,18,11,12,2,360000,210000,570000
4625,8,18,6,-1,2,252000,0,252000
4626,8,6,14,-1,2,234000,0,234000
4627,20,8,5,-1,2,225000,0,225000
4628,13,5,19,-1,1,207000,0,207000
4629,13,20,14,-1,2,192000,15000,207000
4630,14,10,18,-1,1,216000,0,216000
4631,6,9,19,11,2,396000,325000,721000
4632,8,17,16,-1,2,264000,15000,279000
4633,8,6,5,-1,2,312000,60000,372000
4634,10,18,6,-1,1,180000,0,180000
4635,10,7,14,-1,2,243000,0,243000
4636,9,16,17,-1,2,228000,15000,243000
4637,7,12,17,-1,1,207000,0,207000
4638,20,11,13,12,2,360000,120000,480000
4639,13,18,15,-1,2,243000,0,243000
4640,13,20,8,-1,1,216000,0,216000
4641,16,8,11,-1,2,252000,0,252000
4642,12,18,17,-1,2,228000,15000,243000
4643,6,16,15,-1,2,264000,15000,279000
4644,10,7,16,-1,2,243000,0,243000
4645,18,5,13,11,2,348000,60000,408000
4646,12,5,13,-1,2,276000,30000,306000
4647,11,10,20,-1,2,228000,15000,243000
4648,20,14,19,-1,2,201000,15000,216000
4649,11,12,20,-1,2,264000,15000,279000
4650,11,18,20,-1,2,225000,0,225000
4651,5,12,13,-1,2,264000,15000,279000
4652,8,20,7,11,2,360000,90000,450000
4653,10,6,5,-1,2,324000,60000,384000
4654,5,15,13,-1,2,225000,0,225000
4655,7,8,5,-1,2,249000,15000,264000
4656,7,5,20,-1,2,189000,0,189000
4657,9,17,7,-1,2,225000,0,225000
4658,11,8,16,-1,2,216000,0,216000
4659,16,13,11,12,2,360000,165000,525000
4660,18,5,20,-1,2,252000,0,252000
4661,8,6,7,-1,2,300000,45000,345000
4662,10,7,5,-1,2,225000,0,225000
4663,7,12,15,-1,2,207000,0,207000
4664,19,9,13,-1,1,180000,0,180000
4665,12,11,10,-1,2,279000,30000,309000
4666,18,8,17,12,2,336000,45000,381000
4667,11,8,5,-1,2,324000,90000,414000
4668,19,14,16,-1,2,162000,0,162000
4669,6,7,18,-1,2,276000,30000,306000
4670,12,13,11,-1,2,252000,30000,282000
4671,16,20,8,-1,1,198000,0,198000
4672,6,18,9,-1,2,252000,0,252000
4673,5,11,7,13,2,360000,280000,640000
4674,13,19,14,-1,2,237000,15000,252000
4675,8,9,15,-1,2,264000,15000,279000
4676,11,13,19,-1,2,216000,0,216000
4677,19,10,16,-1,2,234000,0,234000
4678,18,7,17,-1,2,255000,15000,270000
4679,17,13,8,-1,1,198000,0,198000
4680,17,16,9,13,2,348000,120000,468000
4681,7,10,19,-1,1,216000,0,216000
4682,15,19,20,-1,2,174000,15000,189000
4683,16,12,7,-1,2,264000,30000,294000
4684,11,18,12,-1,2,237000,15000,252000
4685,15,17,18,-1,2,213000,15000,228000
4686,5,8,12,-1,2,312000,45000,357000
4687,15,13,7,11,2,336000,60000,396000
4688,9,7,16,-1,2,252000,0,252000
4689,13,15,8,-1,2,234000,0,234000
4690,14,10,13,-1,2,231000,15000,246000
4691,5,14,12,-1,2,252000,0,252000
4692,19,12,20,-1,2,183000,15000,198000
4693,10,18,5,-1,1,216000,0,216000
4694,15,12,12,13,2,324000,105000,429000
4695,19,14,17,-1,2,231000,0,231000
4696,13,19,16,-1,2,225000,0,225000
4697,9,8,5,-1,2,312000,90000,402000
4698,5,20,18,-1,2,198000,0,198000
4699,9,5,10,-1,2,276000,30000,306000
4700,5,19,14,-1,1,189000,0,189000
4701,7,12,20,12,2,264000,0,264000
4702,18,9,6,-1,2,252000,0,252000
4703,6,13,5,-1,2,264000,15000,279000
4704,12,16,11,-1,2,210000,15000,225000
4705,17,11,8,-1,2,252000,0,252000
4706,18,20,6,-1,2,216000,0,216000
4707,7,8,12,-1,2,264000,15000,279000
4708,17,9,20,11,2,324000,60000,384000
4709,11,15,20,-1,1,216000,0,216000
4710,11,14,18,-1,2,252000,0,252000
4711,16,13,7,-1,2,264000,15000,279000
4712,6,8,12,-1,2,252000,0,252000
4713,20,15,5,-1,1,189000,0,189000
4714,5,11,7,-1,2,288000,15000,303000
4715,7,14,5,12,2,336000,30000,366000
4716,9,11,15,-1,2,234000,0,234000
4717,10,13,7,-1,2,243000,0,243000
4718,18,9,17,-1,2,228000,15000,243000
4719,13,12,5,-1,2,264000,15000,279000
4720,8,20,15,-1,1,171000,0,171000
4721,18,9,6,-1,2,252000,0,252000
4722,16,7,20,13,2,348000,45000,393000
4723,6,11,5,-1,2,324000,60000,384000
4724,20,19,10,-1,2,192000,15000,207000
4725,17,5,11,-1,1,216000,0,216000
4726,17,12,15,-1,2,240000,0,240000
4727,11,12,16,-1,2,237000,15000,252000
4728,8,9,15,-1,2,264000,15000,279000
4729,7,13,7,11,2,300000,30000,330000
4730,18,14,11,-1,2,207000,0,207000
4731,19,10,15,-1,1,207000,0,207000
4732,12,9,8,-1,2,300000,30000,330000
4733,17,15,18,-1,2,177000,15000,192000
4734,6,8,14,-1,2,288000,15000,303000
4735,15,18,20,-1,2,177000,0,177000
4736,17,20,8,13,2,348000,190000,538000
4737,10,20,11,-1,2,246000,15000,261000
4738,7,15,17,-1,2,252000,0,252000
4739,16,10,5,-1,1,207000,0,207000
4740,7,5,16,-1,2,252000,0,252000
4741,19,15,17,-1,2,159000,0,159000
4742,6,18,20,-1,2,252000,0,252000
4743,19,16,7,13,2,348000,45000,393000
4744,6,8,15,-1,2,300000,30000,330000
4745,19,10,12,-1,2,207000,0,207000
4746,10,16,20,-1,1,189000,0,189000
4747,11,7,12,-1,2,288000,45000,333000
4748,15,10,13,-1,2,231000,0,231000
4749,20,17,15,-1,2,171000,0,171000
4750,12,18,6,13,2,348000,355000,703000
4751,9,18,8,-1,2,264000,15000,279000
4752,13,20,14,-1,2,210000,15000,225000
4753,7,16,19,-1,2,252000,0,252000
4754,12,6,5,-1,2,300000,30000,330000
4755,13,10,13,-1,2,180000,0,180000
4756,14,11,19,-1,2,153000,0,153000
4757,6,13,10,11,2,372000,390000,762000
4758,15,5,20,-1,1,198000,0,198000
4759,5,14,18,-1,1,216000,0,216000
4760,10,15,8,-1,2,243000,0,243000
4761,11,16,18,-1,2,198000,0,198000
4762,9,12,16,-1,2,243000,0,243000
4763,9,6,18,-1,2,252000,0,252000
4764,17,7,9,11,2,360000,90000,450000
4765,18,19,12,-1,2,237000,15000,252000
4766,15,20,12,-1,2,225000,0,225000
4767,6,12,5,-1,2,312000,45000,357000
4768,13,10,19,-1,2,189000,0,189000
4769,8,16,14,-1,2,252000,0,252000
4770,19,18,10,-1,2,219000,15000,234000
4771,18,13,5,12,2,360000,120000,480000
4772,6,8,9,-1,2,312000,90000,402000
4773,20,14,13,-1,2,174000,15000,189000
4774,8,14,5,-1,2,300000,30000,330000
4775,8,10,12,-1,2,240000,0,240000
4776,17,6,16,-1,2,219000,15000,234000
4777,7,15,10,-1,2,234000,0,234000
4778,9,6,9,13,2,312000,125000,437000
4779,5,16,6,-1,2,264000,15000,279000
4780,14,19,15,-1,2,165000,15000,180000
4781,6,16,11,-1,2,264000,30000,294000
4782,7,19,12,-1,1,216000,0,216000
4783,16,14,8,-1,2,243000,0,243000
4784,8,12,5,-1,2,252000,0,252000
4785,10,12,13,12,2,300000,75000,375000
4786,18,16,10,-1,2,198000,0,198000
4787,11,9,18,-1,2,234000,0,234000
4788,20,7,13,-1,1,207000,0,207000
4789,14,7,19,-1,1,216000,0,216000
4790,17,6,20,-1,2,234000,0,234000
4791,17,15,11,-1,2,216000,0,216000
4792,19,9,14,13,2,348000,120000,468000
4793,18,17,6,-1,2,228000,15000,243000
4794,5,9,13,-1,2,252000,15000,267000
4795,16,5,11,-1,1,198000,0,198000
4796,13,19,17,-1,2,180000,0,180000
4797,5,16,13,-1,2,264000,15000,279000
4798,7,8,17,-1,2,264000,15000,279000
4799,16,13,14,12,2,336000,105000,441000
4800,9,14,10,-1,2,300000,30000,330000
4801,12,13,16,-1,2,216000,15000,231000
4802,5,6,11,-1,2,300000,30000,330000
4803,8,17,7,-1,2,210000,15000,225000
4804,18,8,15,-1,2,216000,0,216000
4805,5,14,19,-1,1,216000,0,216000
4806,20,7,17,13,2,348000,45000,393000
4807,20,9,6,-1,2,264000,15000,279000
4808,15,14,12,-1,2,240000,15000,255000
4809,9,13,8,-1,2,255000,15000,270000
4810,7,14,6,-1,2,255000,15000,270000
4811,12,6,15,-1,2,225000,0,225000
4812,5,6,20,-1,2,237000,15000,252000
4813,14,16,20,13,2,327000,60000,387000
4814,5,12,16,-1,2,264000,30000,294000
4815,14,8,7,-1,2,264000,15000,279000
4816,15,13,11,-1,2,213000,0,213000
4817,11,6,15,-1,1,216000,0,216000
4818,17,10,13,-1,2,216000,0,216000
4819,6,5,19,-1,2,264000,15000,279000
4820,8,16,5,13,2,360000,145000,505000
4821,16,15,8,-1,2,264000,15000,279000
4822,13,5,7,-1,2,252000,0,252000
4823,17,6,8,-1,2,234000,0,234000
4824,17,10,14,-1,2,189000,0,189000
4825,16,6,17,-1,2,264000,15000,279000
4826,12,11,8,-1,2,249000,15000,264000
4827,6,5,15,11,2,372000,145000,517000
4828,18,6,9,-1,2,252000,0,252000
4829,5,6,15,-1,2,264000,15000,279000
4830,18,7,16,-1,2,207000,0,207000
4831,6,12,20,-1,1,207000,0,207000
4832,5,9,20,-1,1,216000,0,216000
4833,14,18,15,-1,2,216000,15000,231000
4834,11,6,12,13,2,360000,400000,760000
4835,13,8,18,-1,1,216000,0,216000
4836,19,12,7,-1,1,207000,0,207000
4837,19,11,5,-1,1,216000,0,216000
4838,7,6,8,-1,2,300000,45000,345000
4839,6,15,7,-1,2,219000,15000,234000
4840,5,8,7,-1,2,258000,15000,273000
4841,15,11,7,13,2,312000,90000,402000
4842,7,17,15,-1,2,252000,0,252000
4843,11,18,19,-1,2,210000,15000,225000
4844,12,19,10,-1,2,234000,0,234000
4845,10,6,17,-1,1,216000,0,216000
4846,14,8,19,-1,1,207000,0,207000
4847,14,10,12,-1,2,258000,0,258000
4848,13,17,12,13,2,312000,60000,372000
4849,10,16,9,-1,2,237000,15000,252000
4850,10,14,5,-1,1,216000,0,216000
4851,8,16,14,-1,2,234000,0,234000
4852,15,19,13,-1,2,180000,0,180000
4853,6,7,12,-1,2,312000,45000,357000
4854,17,10,9,-1,2,210000,15000,225000
4855,8,16,11,13,2,360000,120000,480000
4856,12,6,11,-1,2,288000,45000,333000
4857,16,6,12,-1,1,216000,0,216000
4858,14,15,16,-1,2,216000,30000,246000
4859,12,9,20,-1,2,252000,0,252000
4860,19,14,16,-1,2,189000,0,189000
4861,15,6,13,-1,2,264000,15000,279000
4862,9,7,5,11,2,384000,285000,669000
4863,5,20,10,-1,1,216000,0,216000
4864,20,13,19,-1,2,228000,15000,243000
4865,6,11,5,-1,2,324000,60000,384000
4866,15,7,19,-1,1,171000,0,171000
4867,19,15,11,-1,1,180000,0,180000
4868,11,6,9,-1,2,312000,75000,387000
4869,19,15,20,12,2,336000,15000,351000
4870,10,20,7,-1,2,252000,0,252000
4871,15,19,10,-1,1,207000,0,207000
4872,20,18,7,-1,2,252000,0,252000
4873,15,7,20,-1,1,216000,0,216000
4874,6,12,15,-1,2,252000,0,252000
4875,7,11,10,-1,2,258000,15000,273000
4876,10,18,12,11,2,348000,105000,453000
4877,12,8,5,-1,2,300000,30000,330000
4878,6,8,9,-1,2,249000,15000,264000
4879,15,17,7,-1,2,198000,0,198000
4880,16,17,10,-1,2,210000,15000,225000
4881,20,17,18,-1,2,198000,30000,228000
4882,11,19,13,-1,2,252000,0,252000
4883,7,8,8,12,2,348000,190000,538000
4884,7,8,9,-1,2,288000,30000,318000
4885,12,15,20,-1,2,162000,0,162000
4886,12,16,9,-1,2,252000,0,252000
4887,19,15,20,-1,2,201000,15000,216000
4888,15,13,18,-1,2,243000,0,243000
4889,16,6,20,-1,1,216000,0,216000
4890,5,19,16,12,2,360000,190000,550000
4891,11,10,9,-1,2,276000,15000,291000
4892,19,12,18,-1,2,174000,15000,189000
4893,14,20,8,-1,1,216000,0,216000
4894,10,12,13,-1,2,267000,15000,282000
4895,11,12,6,-1,2,255000,15000,270000
4896,6,15,16,-1,2,228000,15000,243000
4897,20,8,14,11,2,336000,75000,411000
4898,5,17,14,-1,2,264000,15000,279000
4899,8,15,7,-1,2,264000,15000,279000
4900,20,17,11,-1,2,198000,0,198000
4901,6,5,16,-1,2,264000,15000,279000
4902,20,9,14,-1,1,189000,0,189000
4903,5,12,13,-1,2,276000,30000,306000
4904,15,7,14,12,2,348000,90000,438000
4905,11,16,18,-1,2,243000,0,243000
4906,8,10,6,-1,2,288000,15000,303000
4907,11,20,18,-1,2,171000,0,171000
4908,9,20,18,-1,2,234000,0,234000
4909,8,16,20,-1,1,207000,0,207000
4910,19,10,7,-1,2,252000,0,252000
4911,12,10,9,11,2,372000,210000,582000
4912,5,12,15,-1,2,264000,15000,279000
4913,15,11,14,-1,2,240000,15000,255000
4914,10,7,15,-1,2,252000,0,252000
4915,14,7,17,-1,2,234000,0,234000
4916,11,10,6,-1,2,255000,15000,270000
4917,15,12,16,-1,2,195000,15000,210000
4918,14,17,6,12,2,360000,135000,495000
4919,11,7,18,-1,2,252000,15000,267000
4920,18,9,8,-1,2,264000,15000,279000
4921,5,9,19,-1,1,216000,0,216000
4922,18,9,9,-1,1,180000,0,180000
4923,7,6,9,-1,2,252000,30000,282000
4924,12,19,7,-1,1,162000,0,162000
4925,18,13,20,12,2,336000,60000,396000
4926,8,20,12,-1,1,216000,0,216000
4927,6,14,18,-1,1,207000,0,207000
4928,17,20,16,-1,2,198000,15000,213000
4929,11,10,15,-1,2,300000,30000,330000
4930,5,6,15,-1,2,264000,15000,279000
4931,20,10,8,-1,2,198000,0,198000
4932,9,17,14,11,2,348000,90000,438000
4933,18,11,15,-1,2,243000,0,243000
4934,18,14,16,-1,2,231000,0,231000
4935,10,15,9,-1,2,264000,15000,279000
4936,10,17,16,-1,2,228000,15000,243000
4937,15,18,7,-1,2,252000,0,252000
4938,8,5,17,-1,2,252000,0,252000
4939,15,6,18,11,2,324000,30000,354000
4940,6,7,19,-1,2,276000,30000,306000
4941,15,19,5,-1,1,216000,0,216000
4942,19,17,14,-1,2,213000,0,213000
4943,17,15,20,-1,2,207000,0,207000
4944,8,14,10,-1,2,300000,30000,330000
4945,15,7,11,-1,1,198000,0,198000
4946,11,9,5,13,2,360000,285000,645000
4947,20,16,8,-1,1,216000,0,216000
4948,8,12,17,-1,2,252000,15000,267000
4949,18,19,13,-1,2,219000,15000,234000
4950,12,16,20,-1,1,198000,0,198000
4951,9,6,11,-1,2,312000,75000,387000
4952,15,16,10,-1,2,219000,15000,234000
4953,5,20,15,13,2,348000,60000,408000
4954,8,9,6,-1,2,312000,90000,402000
4955,5,6,6,-1,2,201000,15000,216000
4956,16,17,20,-1,2,144000,15000,159000
4957,9,11,6,-1,2,312000,75000,387000
4958,17,8,18,-1,2,219000,15000,234000
4959,9,16,18,-1,2,225000,0,225000
4960,18,17,5,13,2,348000,75000,423000
4961,5,12,19,-1,1,216000,0,216000
4962,8,10,12,-1,2,300000,30000,330000
4963,19,16,7,-1,2,216000,0,216000
4964,17,14,13,-1,2,225000,15000,240000
4965,15,13,19,-1,2,207000,0,207000
4966,18,12,14,-1,2,234000,0,234000
4967,13,7,8,13,2,348000,190000,538000
4968,16,17,9,-1,2,246000,15000,261000
4969,8,18,14,-1,1,198000,0,198000
4970,9,8,19,-1,2,264000,15000,279000
4971,11,13,17,-1,2,198000,0,198000
4972,6,11,19,-1,1,216000,0,216000
4973,14,12,15,-1,2,240000,15000,255000
4974,8,6,11,13,2,384000,295000,679000
4975,20,17,10,-1,2,243000,0,243000
4976,13,8,10,-1,2,252000,0,252000
4977,6,18,10,-1,1,207000,0,207000
4978,5,17,10,-1,1,216000,0,216000
4979,15,20,17,-1,2,171000,0,171000
4980,16,6,17,-1,2,264000,15000,279000
4981,9,13,14,12,2,360000,195000,555000
4982,7,11,7,-1,1,198000,0,198000
4983,19,13,15,-1,2,135000,0,135000
4984,7,18,20,-1,2,252000,0,252000
4985,13,19,14,-1,2,210000,15000,225000
4986,17,12,14,-1,2,234000,0,234000
4987,13,18,8,-1,1,216000,0,216000
4988,13,11,14,12,2,360000,195000,555000
4989,18,16,11,-1,2,234000,0,234000
4990,8,16,15,-1,2,237000,15000,252000
4991,5,20,18,-1,2,207000,0,207000
4992,17,7,9,-1,2,252000,0,252000
4993,13,19,15,-1,2,171000,0,171000
4994,17,18,16,-1,2,234000,30000,264000
4995,18,8,17,13,2,348000,220000,568000
4996,7,5,9,-1,2,300000,30000,330000
4997,6,19,8,-1,2,207000,0,207000
4998,6,17,10,-1,1,189000,0,189000
4999,17,15,6,-1,2,243000,0,243000
5000,18,9,13,-1,1,171000,0,171000
5001,7,17,6,-1,2,264000,15000,279000
5002,20,16,6,13,2,348000,45000,393000
5003,15,8,6,-1,2,264000,15000,279000
5004,12,7,14,-1,2,252000,0,252000
5005,17,8,15,-1,2,216000,0,216000
5006,8,10,13,-1,2,225000,0,225000
5007,19,5,7,-1,2,243000,0,243000
5008,11,6,12,-1,2,237000,15000,252000
5009,17,13,5,13,2,264000,0,264000
5010,19,15,17,-1,2,204000,0,204000
5011,16,19,7,-1,2,252000,0,252000
5012,12,11,10,-1,2,270000,30000,300000
5013,7,16,10,-1,2,234000,0,234000
5014,7,12,14,-1,2,234000,0,234000
5015,8,5,13,-1,2,243000,0,243000
5016,8,6,6,12,2,300000,0,300000
5017,19,18,15,-1,2,177000,15000,192000
5018,10,9,14,-1,2,300000,30000,330000
5019,7,10,16,-1,2,234000,0,234000
5020,11,18,16,-1,2,198000,0,198000
5021,14,18,9,-1,1,207000,0,207000
5022,12,19,15,-1,2,225000,0,225000
5023,12,17,11,11,2,336000,60000,396000
5024,9,6,15,-1,2,252000,0,252000
5025,20,18,11,-1,2,207000,0,207000
5026,5,17,7,-1,2,252000,0,252000
5027,18,11,19,-1,2,210000,15000,225000
5028,13,20,17,-1,2,207000,0,207000
5029,7,14,7,-1,1,216000,0,216000
5030,11,9,12,13,2,336000,120000,456000
5031,19,16,17,-1,2,225000,30000,255000
5032,7,9,12,-1,2,300000,30000,330000
5033,14,7,19,-1,1,189000,0,189000
5034,10,18,20,-1,2,225000,0,225000
5035,10,6,12,-1,2,264000,15000,279000
5036,20,6,13,-1,1,189000,0,189000
5037,14,18,16,12,2,348000,60000,408000
5038,15,19,19,-1,1,180000,0,180000
5039,20,13,20,-1,1,162000,0,162000
5040,5,9,8,-1,2,276000,15000,291000
5041,8,6,5,-1,2,252000,30000,282000
5042,7,14,11,-1,2,189000,0,189000
5043,19,8,16,-1,2,225000,0,225000
5044,16,19,17,13,2,348000,45000,393000
5045,12,16,20,-1,1,207000,0,207000
5046,9,8,6,-1,2,312000,90000,402000
5047,9,12,14,-1,2,231000,0,231000
5048,20,18,8,-1,2,207000,0,207000
5049,17,18,19,-1,2,198000,30000,228000
5050,6,13,12,-1,2,288000,45000,333000
5051,9,14,13,12,2,360000,165000,525000
5052,18,14,7,-1,2,252000,15000,267000
5053,19,15,19,-1,1,162000,0,162000
5054,11,12,9,-1,2,258000,15000,273000
5055,16,19,15,-1,2,189000,15000,204000
5056,16,8,5,-1,2,264000,15000,279000
5057,15,20,16,-1,2,192000,15000,207000
5058,14,18,16,12,2,360000,150000,510000
5059,11,16,20,-1,1,189000,0,189000
5060,5,20,14,-1,1,216000,0,216000
5061,5,15,11,-1,2,264000,30000,294000
5062,20,6,15,-1,1,216000,0,216000
5063,9,14,19,-1,1,198000,0,198000
5064,14,20,9,-1,1,216000,0,216000
5065,13,17,7,12,2,360000,265000,625000
5066,13,12,19,-1,2,225000,0,225000
5067,15,7,18,-1,2,243000,0,243000
5068,17,7,11,-1,1,198000,0,198000
5069,17,6,7,-1,2,264000,15000,279000
5070,10,7,15,-1,2,225000,0,225000
5071,15,13,10,-1,2,231000,0,231000
5072,9,15,12,11,2,360000,165000,525000
5073,18,19,8,-1,2,264000,15000,279000
5074,13,10,14,-1,2,249000,15000,264000
5075,5,13,8,-1,2,252000,0,252000
5076,19,17,13,-1,2,171000,0,171000
5077,6,20,16,-1,1,216000,0,216000
5078,7,19,15,-1,1,216000,0,216000
5079,12,7,16,13,2,348000,345000,693000
5080,11,6,8,-1,2,288000,15000,303000
5081,9,20,18,-1,2,180000,0,180000
5082,10,20,7,-1,2,252000,0,252000
5083,9,20,17,-1,2,216000,0,216000
5084,13,7,11,-1,2,252000,0,252000
5085,6,18,10,-1,1,198000,0,198000
5086,13,20,10,11,2,360000,120000,480000
5087,17,19,11,-1,2,252000,0,252000
5088,12,20,11,-1,2,237000,15000,252000
5089,15,8,9,-1,2,264000,15000,279000
5090,5,8,12,-1,2,252000,0,252000
5091,15,5,8,-1,2,234000,0,234000
5092,5,17,9,-1,1,198000,0,198000
5093,11,9,18,12,2,348000,75000,423000
5094,9,10,5,-1,2,300000,75000,375000
5095,6,5,7,-1,2,270000,30000,300000
5096,18,14,15,-1,2,162000,15000,177000
5097,5,14,15,-1,2,264000,15000,279000
5098,5,17,11,-1,1,216000,0,216000
5099,20,6,13,-1,1,216000,0,216000
5100,16,9,15,11,2,360000,135000,495000
5101,12,9,14,-1,2,288000,15000,303000
5102,13,12,18,-1,2,201000,15000,216000
5103,12,18,14,-1,2,225000,0,225000
5104,7,14,9,-1,2,252000,0,252000
5105,14,20,13,-1,2,201000,15000,216000
5106,9,16,15,-1,2,264000,15000,279000
5107,20,6,9,13,2,372000,180000,552000
5108,10,20,8,-1,2,252000,0,252000
5109,6,20,18,-1,2,234000,0,234000
5110,5,19,16,-1,2,243000,0,243000
5111,19,11,15,-1,1,171000,0,171000
5112,5,10,7,-1,2,312000,45000,357000
5113,7,20,6,-1,2,228000,15000,243000
5114,7,9,20,13,2,336000,15000,351000
5115,13,15,20,-1,2,225000,0,225000
5116,17,8,9,-1,2,264000,15000,279000
5117,11,7,5,-1,2,288000,15000,303000
5118,11,8,14,-1,2,189000,0,189000
5119,15,18,10,-1,2,216000,0,216000
5120,20,19,8,-1,2,237000,15000,252000
5121,17,12,19,13,2,348000,105000,453000
5122,5,8,9,-1,2,276000,30000,306000
5123,17,20,10,-1,2,180000,0,180000
5124,20,9,15,-1,1,207000,0,207000
5125,14,16,6,-1,2,252000,0,252000
5126,17,20,17,-1,2,153000,0,153000
5127,12,17,5,-1,1,216000,0,216000
5128,20,7,6,13,2,372000,180000,552000
5129,5,13,19,-1,1,216000,0,216000
5130,12,13,19,-1,2,255000,15000,270000
5131,10,17,20,-1,2,243000,0,243000
5132,10,19,18,-1,2,246000,15000,261000
5133,17,18,9,-1,2,246000,15000,261000
5134,12,7,19,-1,1,207000,0,207000
5135,20,5,19,12,2,312000,45000,357000
5136,10,18,17,-1,2,246000,15000,261000
5137,16,5,18,-1,2,243000,0,243000
5138,5,19,9,-1,1,216000,0,216000
5139,11,18,20,-1,2,198000,0,198000
5140,13,5,20,-1,1,216000,0,216000
5141,9,12,10,-1,2,279000,30000,309000
5142,17,18,10,13,2,336000,75000,411000
5143,9,19,11,-1,2,252000,0,252000
5144,8,10,18,-1,2,252000,0,252000
5145,7,13,16,-1,2,234000,0,234000
5146,10,8,7,-1,2,270000,30000,300000
5147,15,5,17,-1,2,207000,0,207000
5148,9,7,19,-1,2,225000,0,225000
5149,14,16,5,13,2,336000,90000,426000
5150,11,18,10,-1,2,264000,15000,279000
5151,13,11,6,-1,2,252000,0,252000
5152,5,15,18,-1,2,225000,0,225000
5153,11,16,18,-1,2,198000,0,198000
5154,10,11,15,-1,2,246000,15000,261000
5155,16,13,12,-1,2,243000,15000,258000
5156,12,17,19,11,2,348000,60000,408000
5157,5,11,14,-1,2,300000,45000,345000
5158,16,12,5,-1,1,216000,0,216000
5159,11,20,10,-1,2,219000,15000,234000
5160,17,18,11,-1,2,228000,15000,243000
5161,17,11,19,-1,2,225000,0,225000
5162,18,13,11,-1,2,225000,0,225000
5163,16,12,17,13,2,348000,150000,498000
5164,20,18,11,-1,2,216000,0,216000
5165,14,17,16,-1,2,213000,15000,228000
5166,10,6,9,-1,2,300000,45000,345000
5167,7,5,19,-1,2,225000,0,225000
5168,17,8,11,-1,2,207000,0,207000
5169,20,13,18,-1,2,189000,0,189000
5170,16,17,7,12,2,360000,220000,580000
5171,13,6,13,-1,1,198000,0,198000
5172,12,19,17,-1,2,144000,0,144000
5173,8,14,17,-1,2,252000,0,252000
5174,10,17,11,-1,2,237000,15000,252000
5175,17,16,10,-1,2,237000,15000,252000
5176,8,20,17,-1,2,234000,0,234000
5177,20,11,5,13,2,348000,230000,578000
5178,5,16,20,-1,1,216000,0,216000
5179,10,14,13,-1,2,288000,30000,318000
5180,19,17,5,-1,2,234000,0,234000
5181,20,14,10,-1,1,180000,0,180000
5182,19,8,15,-1,1,216000,0,216000
5183,10,5,6,-1,2,324000,60000,384000
5184,16,13,6,12,2,324000,60000,384000
5185,16,10,15,-1,2,255000,15000,270000
5186,7,14,10,-1,2,252000,0,252000
5187,6,14,10,-1,1,207000,0,207000
5188,6,14,18,-1,1,216000,0,216000
5189,17,16,8,-1,2,246000,15000,261000
5190,20,7,13,-1,1,198000,0,198000
5191,17,8,12,11,2,372000,195000,567000
5192,9,11,7,-1,2,300000,30000,330000
5193,11,20,12,-1,2,201000,15000,216000
5194,15,9,5,-1,2,252000,15000,267000
5195,12,18,15,-1,2,189000,0,189000
5196,11,13,7,-1,2,276000,30000,306000
5197,5,17,18,-1,2,228000,15000,243000
5198,7,8,10,12,2,384000,285000,669000
5199,11,9,18,-1,2,252000,0,252000
5200,8,14,7,-1,2,255000,15000,270000
5201,16,20,19,-1,2,168000,15000,183000
5202,19,5,16,-1,2,252000,0,252000
5203,15,16,8,-1,2,264000,15000,279000
5204,8,16,7,-1,2,264000,15000,279000
5205,10,6,17,13,2,336000,230000,566000
5206,10,11,7,-1,2,300000,45000,345000
5207,17,19,13,-1,2,180000,0,180000
5208,6,19,5,-1,2,276000,30000,306000
5209,5,20,7,-1,2,243000,0,243000
5210,13,16,6,-1,2,234000,0,234000
5211,20,11,13,-1,2,189000,0,189000
5212,6,8,18,12,2,384000,180000,564000
5213,5,16,11,-1,2,252000,15000,267000
5214,10,11,5,-1,2,276000,30000,306000
5215,20,5,7,-1,2,216000,0,216000
5216,16,5,7,-1,2,243000,0,243000
5217,10,19,12,-1,2,180000,0,180000
5218,7,11,20,-1,1,216000,0,216000
5219,15,8,9,12,2,384000,290000,674000
5220,16,14,18,-1,2,240000,0,240000
5221,12,10,6,-1,2,276000,30000,306000
5222,10,18,9,-1,2,219000,15000,234000
5223,6,5,9,-1,2,300000,30000,330000
5224,20,16,10,-1,1,126000,0,126000
5225,13,18,20,-1,2,225000,0,225000
5226,17,7,15,12,2,360000,235000,595000
5227,18,7,8,-1,2,252000,0,252000
5228,9,8,14,-1,2,228000,15000,243000
5229,14,19,18,-1,2,183000,15000,198000
5230,7,18,8,-1,2,264000,15000,279000
5231,5,11,8,-1,2,300000,30000,330000
5232,19,7,10,-1,2,207000,0,207000
5233,7,12,19,12,2,264000,0,264000
5234,9,7,10,-1,2,288000,30000,318000
5235,14,20,17,-1,2,153000,0,153000
5236,8,14,10,-1,2,300000,30000,330000
5237,7,12,20,-1,1,198000,0,198000
5238,12,20,7,-1,1,216000,0,216000
5239,20,17,12,-1,2,207000,0,207000
5240,14,16,18,12,2,360000,120000,480000
5241,8,16,18,-1,2,234000,0,234000
5242,17,9,19,-1,2,216000,0,216000
5243,8,9,12,-1,2,270000,15000,285000
5244,19,11,13,-1,2,180000,0,180000
5245,7,13,10,-1,2,288000,15000,303000
5246,5,15,20,-1,1,180000,0,180000
5247,20,7,6,12,2,372000,180000,552000
5248,11,20,7,-1,1,216000,0,216000
5249,14,16,20,-1,2,225000,0,225000
5250,20,8,13,-1,1,216000,0,216000
5251,10,9,14,-1,2,300000,30000,330000
5252,16,9,8,-1,2,237000,15000,252000
5253,20,6,13,-1,1,207000,0,207000
5254,16,11,5,12,2,360000,165000,525000
5255,16,10,15,-1,2,264000,15000,279000
5256,18,13,7,-1,1,216000,0,216000
5257,13,8,18,-1,1,216000,0,216000
5258,10,18,8,-1,2,252000,0,252000
5259,8,7,20,-1,2,246000,15000,261000
5260,17,9,5,-1,1,207000,0,207000
5261,6,11,9,12,2,372000,255000,627000
5262,11,15,6,-1,2,252000,15000,267000
5263,10,19,9,-1,2,237000,15000,252000
5264,7,11,10,-1,2,267000,15000,282000
5265,20,16,7,-1,1,171000,0,171000
5266,11,14,15,-1,2,249000,15000,264000
5267,10,19,14,-1,1,189000,0,189000
5268,16,5,11,11,2,336000,155000,491000
5269,19,10,12,-1,2,234000,0,234000
5270,14,11,12,-1,2,252000,30000,282000
5271,6,11,20,-1,1,216000,0,216000
5272,11,20,6,-1,1,216000,0,216000
5273,19,17,20,-1,2,177000,15000,192000
5274,19,7,20,-1,2,264000,15000,279000
5275,9,10,8,11,2,396000,365000,761000
5276,9,20,15,-1,1,216000,0,216000
5277,6,15,10,-1,2,288000,30000,318000
5278,12,20,16,-1,1,153000,0,153000
5279,10,16,14,-1,2,264000,15000,279000
5280,20,8,19,-1,2,237000,15000,252000
5281,13,16,10,-1,2,234000,0,234000
5282,15,5,14,11,2,372000,195000,567000
5283,15,20,16,-1,2,228000,15000,243000
5284,7,17,12,-1,2,264000,30000,294000
5285,8,13,18,-1,1,216000,0,216000
5286,16,8,19,-1,2,252000,0,252000
5287,19,10,7,-1,2,243000,0,243000
5288,7,12,13,-1,2,246000,15000,261000
5289,9,18,16,12,2,348000,75000,423000
5290,9,12,16,-1,2,252000,0,252000
5291,12,5,6,-1,2,300000,30000,330000
5292,10,12,20,-1,2,180000,0,180000
5293,9,10,18,-1,2,246000,15000,261000
5294,16,20,14,-1,2,180000,0,180000
5295,20,7,16,-1,1,216000,0,216000
5296,8,6,5,12,2,420000,400000,820000
5297,11,13,20,-1,2,252000,0,252000
5298,20,15,9,-1,1,207000,0,207000
5299,6,11,7,-1,2,312000,45000,357000
5300,18,8,13,-1,1,162000,0,162000
5301,9,10,11,-1,2,279000,30000,309000
5302,15,13,11,-1,2,213000,0,213000
5303,8,20,7,11,2,372000,230000,602000
5304,5,10,13,-1,2,276000,30000,306000
5305,15,12,11,-1,2,243000,15000,258000
5306,15,19,16,-1,2,207000,15000,222000
5307,6,7,10,-1,2,312000,45000,357000
5308,18,11,5,-1,1,198000,0,198000
5309,5,19,13,-1,1,216000,0,216000
5310,8,15,9,11,2,372000,150000,522000
5311,14,15,5,-1,2,264000,15000,279000
5312,5,19,16,-1,2,234000,0,234000
5313,11,19,17,-1,2,207000,0,207000
5314,16,7,19,-1,2,252000,0,252000
5315,11,6,20,-1,1,216000,0,216000
5316,10,14,17,-1,2,216000,0,216000
5317,13,6,12,13,2,312000,200000,512000
5318,11,16,19,-1,2,234000,0,234000
5319,8,13,14,-1,2,264000,15000,279000
5320,17,13,14,-1,2,225000,15000,240000
5321,11,19,6,-1,1,216000,0,216000
5322,7,9,14,-1,2,252000,0,252000
5323,6,12,5,-1,2,264000,15000,279000
5324,20,19,7,13,2,312000,15000,327000
5325,11,14,12,-1,2,288000,30000,318000
5326,8,11,5,-1,2,288000,15000,303000
5327,18,8,20,-1,2,171000,0,171000
5328,8,15,13,-1,2,243000,0,243000
5329,20,18,16,-1,2,177000,0,177000
5330,8,7,17,-1,2,264000,15000,279000
5331,16,10,18,12,2,360000,120000,480000
5332,11,13,19,-1,2,252000,0,252000
5333,20,10,17,-1,2,243000,0,243000
5334,6,11,16,-1,1,216000,0,216000
5335,19,9,11,-1,2,243000,0,243000
5336,9,14,18,-1,1,189000,0,189000
5337,17,18,16,-1,2,225000,30000,255000
5338,16,9,8,11,2,396000,360000,756000
5339,15,5,8,-1,1,216000,0,216000
5340,19,12,10,-1,2,207000,0,207000
5341,9,12,8,-1,2,279000,15000,294000
5342,12,13,16,-1,2,207000,15000,222000
5343,6,19,18,-1,2,237000,15000,252000
5344,16,8,7,-1,2,264000,15000,279000
5345,11,14,13,12,2,348000,150000,498000
5346,15,8,19,-1,1,216000,0,216000
5347,16,19,12,-1,2,234000,0,234000
5348,16,6,5,-1,2,276000,30000,306000
5349,17,8,6,-1,2,252000,0,252000
5350,17,16,7,-1,2,219000,15000,234000
5351,9,19,18,-1,2,219000,15000,234000
5352,9,6,11,13,2,384000,285000,669000
5353,19,18,16,-1,2,222000,15000,237000
5354,11,20,8,-1,2,252000,0,252000
5355,12,20,9,-1,2,252000,0,252000
5356,6,12,20,-1,1,216000,0,216000
5357,17,8,5,-1,2,252000,0,252000
5358,12,20,16,-1,1,153000,0,153000
5359,7,17,14,11,2,372000,315000,687000
5360,15,18,14,-1,2,225000,15000,240000
5361,17,16,6,-1,2,264000,15000,279000
5362,15,5,13,-1,2,252000,0,252000
5363,16,18,19,-1,2,159000,15000,174000
5364,12,6,8,-1,2,312000,45000,357000
5365,6,19,5,-1,2,237000,15000,252000
5366,6,19,12,12,2,264000,0,264000
5367,6,7,18,-1,2,264000,15000,279000
5368,5,8,16,-1,2,243000,0,243000
5369,13,18,9,-1,1,162000,0,162000
5370,13,15,18,-1,2,216000,0,216000
5371,14,15,9,-1,2,264000,15000,279000
5372,7,9,15,-1,2,252000,0,252000
5373,6,13,15,13,2,288000,15000,303000
5374,16,11,14,-1,2,231000,0,231000
5375,7,6,10,-1,2,300000,30000,330000
5376,14,5,10,-1,1,180000,0,180000
5377,13,11,9,-1,2,240000,0,240000
5378,19,11,16,-1,2,189000,0,189000
5379,17,18,7,-1,2,264000,15000,279000
5380,14,11,16,12,2,360000,165000,525000
5381,9,19,18,-1,2,264000,15000,279000
5382,5,9,6,-1,2,312000,45000,357000
5383,17,8,14,-1,2,189000,0,189000
5384,11,10,16,-1,2,228000,15000,243000
5385,10,18,6,-1,1,216000,0,216000
5386,6,13,12,-1,2,264000,15000,279000
5387,11,13,18,12,2,348000,120000,468000
5388,9,12,19,-1,2,252000,0,252000
5389,20,12,14,-1,2,216000,0,216000
5390,5,7,19,-1,2,252000,0,252000
5391,11,18,5,-1,1,216000,0,216000
5392,18,16,13,-1,2,213000,0,213000
5393,7,12,6,-1,2,300000,30000,330000
5394,20,19,13,11,2,336000,30000,366000
5395,7,10,13,-1,2,300000,30000,330000
5396,15,18,10,-1,2,198000,0,198000
5397,14,18,20,-1,2,198000,0,198000
5398,14,5,18,-1,2,252000,15000,267000
5399,18,5,17,-1,2,255000,15000,270000
5400,5,5,12,-1,1,198000,0,198000
5401,18,15,16,13,2,291000,60000,351000
5402,6,13,8,-1,2,300000,30000,330000
5403,6,15,5,-1,2,255000,15000,270000
5404,8,14,5,-1,2,225000,0,225000
5405,19,16,20,-1,2,159000,15000,174000
5406,16,11,19,-1,2,252000,0,252000
5407,14,17,16,-1,2,240000,15000,255000
5408,17,20,6,13,2,348000,60000,408000
5409,15,12,18,-1,2,234000,0,234000
5410,7,12,10,-1,2,267000,0,267000
5411,8,12,7,-1,2,228000,15000,243000
5412,12,20,8,-1,1,180000,0,180000
5413,11,15,5,-1,2,252000,15000,267000
5414,10,17,20,-1,2,207000,0,207000
5415,10,18,13,12,2,360000,150000,510000
5416,18,5,15,-1,2,264000,15000,279000
5417,7,13,17,-1,1,216000,0,216000
5418,9,8,10,-1,2,300000,45000,345000
5419,19,16,7,-1,2,207000,0,207000
5420,12,6,10,-1,2,252000,0,252000
5421,17,9,15,-1,2,198000,0,198000
5422,12,8,11,12,2,312000,60000,372000
5423,15,7,10,-1,2,252000,0,252000
5424,13,10,16,-1,2,207000,0,207000
5425,7,18,5,-1,2,252000,0,252000
5426,8,15,11,-1,2,225000,0,225000
5427,20,5,10,-1,1,216000,0,216000
5428,6,19,9,-1,2,252000,0,252000
5429,5,13,7,12,2,360000,175000,535000
5430,5,14,19,-1,1,216000,0,216000
5431,13,9,7,-1,2,252000,0,252000
5432,15,18,17,-1,2,186000,15000,201000
5433,7,10,19,-1,2,252000,0,252000
5434,10,8,14,-1,2,252000,0,252000
5435,7,9,5,-1,2,276000,0,276000
5436,10,15,9,12,2,327000,90000,417000
5437,9,10,15,-1,2,255000,15000,270000
5438,20,16,10,-1,1,180000,0,180000
5439,8,9,16,-1,2,264000,15000,279000
5440,16,7,18,-1,2,243000,0,243000
5441,20,19,6,-1,2,210000,15000,225000
5442,19,18,16,-1,2,204000,15000,219000
5443,14,7,20,11,2,372000,215000,587000
5444,12,5,16,-1,1,216000,0,216000
5445,17,14,19,-1,2,204000,0,204000
5446,13,12,20,-1,2,246000,15000,261000
5447,17,14,13,-1,2,252000,15000,267000
5448,17,18,19,-1,2,207000,30000,237000
5449,10,12,11,-1,2,300000,45000,345000
5450,10,8,15,11,2,360000,135000,495000
5451,17,12,11,-1,2,255000,15000,270000
5452,16,17,11,-1,2,237000,15000,252000
5453,17,8,6,-1,2,252000,0,252000
5454,5,8,16,-1,2,252000,0,252000
5455,17,11,7,-1,1,180000,0,180000
5456,10,20,18,-1,2,225000,0,225000
5457,9,12,20,12,2,276000,45000,321000
5458,19,15,13,-1,2,234000,0,234000
5459,18,17,7,-1,2,264000,15000,279000
5460,11,16,20,-1,1,180000,0,180000
5461,20,18,14,-1,2,225000,0,225000
5462,19,9,8,-1,2,264000,15000,279000
5463,5,15,19,-1,1,216000,0,216000
5464,18,8,16,12,2,360000,90000,450000
5465,9,7,16,-1,2,264000,15000,279000
5466,8,6,7,-1,2,300000,45000,345000
5467,13,20,6,-1,1,180000,0,180000
5468,8,15,12,-1,2,234000,0,234000
5469,11,9,13,-1,2,249000,0,249000
5470,9,19,14,-1,1,171000,0,171000
5471,6,10,17,11,2,372000,345000,717000
5472,10,11,7,-1,2,264000,15000,279000
5473,6,19,12,-1,1,180000,0,180000
5474,6,12,17,-1,1,216000,0,216000
5475,15,19,11,-1,1,171000,0,171000
5476,18,13,17,-1,2,246000,15000,261000
5477,10,6,16,-1,2,252000,15000,267000
5478,13,10,15,11,2,372000,195000,567000
5479,11,10,14,-1,2,300000,30000,330000
5480,7,9,16,-1,2,234000,0,234000
5481,8,19,20,-1,2,201000,15000,216000
5482,9,5,16,-1,1,216000,0,216000
5483,7,15,11,-1,2,252000,15000,267000
5484,11,16,17,-1,2,210000,15000,225000
5485,8,12,5,13,2,384000,285000,669000
5486,5,11,10,-1,2,300000,75000,375000
5487,10,15,5,-1,1,207000,0,207000
5488,17,6,7,-1,2,255000,15000,270000
5489,11,18,15,-1,2,180000,0,180000
5490,9,15,12,-1,2,252000,0,252000
5491,18,7,9,-1,2,252000,0,252000
5492,6,7,19,13,2,348000,30000,378000
5493,9,12,7,-1,2,300000,30000,330000
5494,15,13,12,-1,2,207000,30000,237000
5495,16,6,11,-1,1,216000,0,216000
5496,16,18,6,-1,2,243000,0,243000
5497,6,5,18,-1,2,264000,15000,279000
5498,9,17,11,-1,2,189000,0,189000
5499,16,14,9,11,2,360000,150000,510000
5500,7,9,15,-1,2,252000,0,252000
5501,7,10,17,-1,2,252000,0,252000
5502,12,13,17,-1,2,201000,15000,216000
5503,14,9,13,-1,2,264000,15000,279000
5504,16,20,6,-1,1,198000,0,198000
5505,8,13,20,-1,1,216000,0,216000
5506,7,17,5,11,2,384000,180000,564000
5507,11,7,20,-1,1,216000,0,216000
5508,19,12,11,-1,2,255000,15000,270000
5509,11,10,8,-1,2,276000,15000,291000
5510,7,18,16,-1,2,207000,0,207000
5511,19,12,5,-1,1,216000,0,216000
5512,20,17,13,-1,2,180000,0,180000
5513,17,6,16,12,2,360000,220000,580000
5514,19,5,8,-1,2,252000,0,252000
5515,11,10,19,-1,2,219000,15000,234000
5516,6,19,16,-1,2,243000,0,243000
5517,17,9,16,-1,2,237000,15000,252000
5518,12,11,17,-1,2,219000,15000,234000
5519,7,13,18,-1,1,216000,0,216000
5520,14,13,17,12,2,360000,120000,480000
5521,19,17,18,-1,2,243000,30000,273000
5522,9,8,17,-1,2,264000,15000,279000
5523,6,8,11,-1,2,300000,30000,330000
5524,13,12,6,-1,2,228000,15000,243000
5525,16,20,11,-1,1,144000,0,144000
5526,13,6,11,-1,2,276000,30000,306000
5527,7,17,19,13,2,348000,45000,393000
5528,17,13,8,-1,2,252000,15000,267000
5529,9,17,19,-1,2,243000,0,243000
5530,10,7,14,-1,2,243000,0,243000
5531,10,18,5,-1,1,216000,0,216000
5532,11,14,9,-1,2,216000,0,216000
5533,6,19,5,-1,2,264000,15000,279000
5534,8,20,17,11,2,324000,60000,384000
5535,17,20,15,-1,2,225000,0,225000
5536,17,13,10,-1,2,288000,15000,303000
5537,16,9,14,-1,2,234000,0,234000
5538,5,15,11,-1,1,216000,0,216000
5539,13,17,16,-1,2,213000,15000,228000
5540,16,7,8,-1,2,264000,15000,279000
5541,20,6,10,13,2,348000,255000,603000
5542,18,9,19,-1,2,264000,15000,279000
5543,18,5,13,-1,1,216000,0,216000
5544,6,18,16,-1,2,252000,0,252000
5545,14,13,19,-1,2,201000,15000,216000
5546,9,13,12,-1,2,288000,30000,318000
5547,17,14,11,-1,2,198000,0,198000
5548,17,13,5,11,2,372000,250000,622000
5549,11,12,20,-1,2,264000,15000,279000
5550,20,16,17,-1,2,225000,15000,240000
5551,15,5,16,-1,2,264000,15000,279000
5552,16,9,17,-1,2,255000,15000,270000
5553,15,6,17,-1,2,243000,0,243000
5554,18,9,11,-1,2,207000,0,207000
5555,17,5,16,13,2,348000,90000,438000
5556,10,19,13,-1,2,252000,0,252000
5557,15,10,20,-1,1,207000,0,207000
5558,6,19,7,-1,2,264000,15000,279000
5559,19,7,16,-1,2,243000,0,243000
5560,16,15,11,-1,2,219000,15000,234000
5561,20,14,5,-1,1,216000,0,216000
5562,15,18,12,13,2,348000,150000,498000
5563,11,16,15,-1,2,255000,15000,270000
5564,16,11,15,-1,2,201000,15000,216000
5565,10,7,5,-1,2,300000,30000,330000
5566,10,11,5,-1,2,228000,15000,243000
5567,13,20,5,-1,1,189000,0,189000
5568,10,20,18,-1,2,207000,0,207000
5569,11,13,15,12,2,360000,180000,540000
5570,18,19,5,-1,2,264000,15000,279000
5571,14,5,12,-1,2,264000,15000,279000
5572,10,5,9,-1,2,264000,15000,279000
5573,16,17,6,-1,2,210000,15000,225000
5574,13,16,10,-1,2,207000,0,207000
5575,15,18,7,-1,2,252000,0,252000
5576,7,13,8,11,2,384000,305000,689000
5577,19,18,14,-1,2,219000,15000,234000
5578,8,7,15,-1,2,300000,30000,330000
5579,5,7,11,-1,2,252000,0,252000
5580,7,19,11,-1,1,171000,0,171000
5581,10,14,13,-1,2,249000,15000,264000
5582,14,8,12,-1,2,234000,0,234000
5583,16,18,5,12,2,348000,45000,393000
5584,19,6,7,-1,2,264000,15000,279000
5585,15,9,17,-1,2,234000,0,234000
5586,19,5,17,-1,2,225000,0,225000
5587,18,16,11,-1,2,207000,0,207000
5588,11,17,18,-1,2,237000,15000,252000
5589,13,18,14,-1,2,219000,15000,234000
5590,5,17,7,11,2,408000,235000,643000
5591,10,5,8,-1,2,312000,75000,387000
5592,17,13,14,-1,2,198000,15000,213000
5593,8,14,12,-1,2,252000,0,252000
5594,8,14,7,-1,2,246000,15000,261000
5595,5,7,16,-1,2,243000,0,243000
5596,9,14,20,-1,1,153000,0,153000
5597,13,11,14,12,2,360000,195000,555000
5598,10,8,7,-1,2,288000,15000,303000
5599,8,10,5,-1,2,240000,0,240000
5600,15,6,11,-1,1,171000,0,171000
5601,16,10,5,-1,1,216000,0,216000
5602,7,13,6,-1,2,264000,15000,279000
5603,16,20,9,-1,1,162000,0,162000
5604,9,14,10,12,2,384000,195000,579000
5605,8,14,6,-1,2,300000,30000,330000
5606,8,14,5,-1,2,252000,0,252000
5607,17,10,16,-1,2,201000,15000,216000
5608,16,13,10,-1,2,225000,0,225000
5609,6,16,15,-1,2,264000,15000,279000
5610,20,13,8,-1,1,189000,0,189000
5611,6,14,11,11,2,324000,145000,469000
5612,14,13,8,-1,2,255000,15000,270000
5613,5,10,8,-1,2,276000,0,276000
5614,15,17,13,-1,2,168000,0,168000
5615,12,20,15,-1,2,216000,0,216000
5616,16,12,7,-1,2,252000,15000,267000
5617,14,11,13,-1,2,240000,15000,255000
5618,12,14,6,11,2,360000,150000,510000
5619,12,16,18,-1,2,234000,0,234000
5620,5,12,20,-1,1,216000,0,216000
5621,12,14,17,-1,2,225000,0,225000
5622,13,16,13,-1,2,216000,0,216000
5623,9,18,8,-1,2,219000,15000,234000
5624,9,18,8,-1,2,237000,15000,252000
5625,19,10,17,12,2,336000,75000,411000
5626,11,8,14,-1,2,300000,30000,330000
5627,19,7,20,-1,2,210000,15000,225000
5628,13,7,18,-1,1,216000,0,216000
5629,16,18,7,-1,2,252000,0,252000
5630,6,20,15,-1,1,198000,0,198000
5631,19,15,5,-1,1,216000,0,216000
5632,6,18,16,13,2,348000,75000,423000
5633,20,18,20,-1,2,198000,0,198000
5634,11,9,14,-1,2,234000,0,234000
5635,9,13,17,-1,1,189000,0,189000
5636,19,10,5,-1,1,216000,0,216000
5637,20,14,12,-1,2,225000,0,225000
5638,16,13,20,-1,2,216000,0,216000
5639,5,13,12,12,2,336000,240000,576000
5640,13,20,7,-1,1,216000,0,216000
5641,15,8,20,-1,1,216000,0,216000
5642,18,14,13,-1,2,228000,15000,243000
5643,12,15,14,-1,2,258000,15000,273000
5644,19,13,9,-1,1,198000,0,198000
5645,16,5,11,-1,2,252000,15000,267000
5646,18,10,12,11,2,360000,120000,480000
5647,9,14,20,-1,1,216000,0,216000
5648,9,8,20,-1,2,264000,15000,279000
5649,6,8,10,-1,2,288000,15000,303000
5650,7,18,5,-1,2,225000,0,225000
5651,19,7,8,-1,2,219000,15000,234000
5652,8,11,16,-1,2,216000,0,216000
5653,20,11,15,13,2,348000,105000,453000
5654,8,6,20,-1,2,264000,15000,279000
5655,20,7,5,-1,2,252000,0,252000
5656,7,18,12,-1,1,189000,0,189000
5657,13,14,17,-1,2,234000,15000,249000
5658,5,15,18,-1,2,252000,0,252000
5659,19,13,14,-1,2,201000,15000,216000
5660,18,19,20,12,2,324000,45000,369000
5661,17,6,13,-1,2,252000,15000,267000
5662,8,16,8,-1,1,207000,0,207000
5663,16,7,6,-1,2,210000,15000,225000
5664,14,8,15,-1,2,219000,15000,234000
5665,20,8,11,-1,2,225000,0,225000
5666,19,18,8,-1,2,228000,15000,243000
5667,13,8,10,12,2,372000,265000,637000
5668,12,20,16,-1,1,198000,0,198000
5669,19,8,10,-1,2,252000,0,252000
5670,13,11,16,-1,2,234000,0,234000
5671,12,16,17,-1,2,228000,15000,243000
5672,10,7,14,-1,2,288000,15000,303000
5673,16,6,7,-1,2,246000,15000,261000
5674,9,10,17,11,2,348000,120000,468000
5675,6,20,5,-1,2,264000,15000,279000
5676,18,8,19,-1,2,228000,15000,243000
5677,16,13,17,-1,2,222000,15000,237000
5678,7,5,14,-1,2,252000,0,252000
5679,9,19,6,-1,2,252000,0,252000
5680,6,18,13,-1,1,198000,0,198000
5681,14,15,8,13,2,348000,120000,468000
5682,6,13,16,-1,2,264000,15000,279000
5683,7,11,5,-1,2,288000,15000,303000
5684,16,12,11,-1,2,183000,15000,198000
5685,6,7,9,-1,2,300000,45000,345000
5686,9,11,12,-1,2,213000,15000,228000
5687,8,17,20,-1,2,207000,0,207000
5688,6,9,19,11,2,384000,270000,654000
5689,19,9,20,-1,2,255000,15000,270000
5690,18,10,7,-1,2,252000,0,252000
5691,11,14,18,-1,2,207000,0,207000
5692,13,18,7,-1,1,216000,0,216000
5693,16,6,15,-1,2,264000,15000,279000
5694,14,10,20,-1,1,180000,0,180000
5695,7,19,10,12,2,384000,340000,724000
5696,10,14,19,-1,1,207000,0,207000
5697,6,18,13,-1,1,216000,0,216000
5698,14,8,20,-1,1,198000,0,198000
5699,6,9,10,-1,2,288000,30000,318000
5700,14,20,6,-1,1,189000,0,189000
5701,8,11,12,-1,2,258000,15000,273000
5702,12,7,15,11,2,348000,120000,468000
5703,15,12,19,-1,2,225000,0,225000
5704,8,16,12,-1,2,252000,15000,267000
5705,13,15,20,-1,2,198000,0,198000
5706,19,6,13,-1,1,216000,0,216000
5707,6,8,16,-1,2,252000,0,252000
5708,18,8,19,-1,2,237000,15000,252000
5709,5,9,10,12,2,372000,310000,682000
5710,5,8,7,-1,2,312000,90000,402000
5711,7,12,17,-1,1,180000,0,180000
5712,17,11,13,-1,2,216000,0,216000
5713,10,20,6,-1,1,216000,0,216000
5714,14,9,6,-1,2,252000,0,252000
5715,19,7,9,-1,2,243000,0,243000
5716,12,18,18,13,2,312000,45000,357000
5717,19,11,5,-1,1,216000,0,216000
5718,10,11,13,-1,2,243000,30000,273000
5719,17,8,18,-1,2,228000,15000,243000
5720,18,12,8,-1,1,198000,0,198000
5721,6,17,18,-1,2,255000,15000,270000
5722,14,7,11,-1,2,243000,0,243000
5723,17,11,14,13,2,336000,120000,456000
5724,7,18,20,-1,2,252000,0,252000
5725,8,15,20,-1,1,216000,0,216000
5726,18,9,19,-1,2,246000,15000,261000
5727,15,10,5,-1,1,216000,0,216000
5728,11,10,9,-1,2,270000,30000,300000
5729,10,7,9,-1,2,249000,15000,264000
5730,6,8,12,13,2,348000,75000,423000
5731,16,7,17,-1,2,264000,15000,279000
5732,6,15,5,-1,2,264000,15000,279000
5733,15,5,17,-1,2,207000,0,207000
5734,12,8,7,-1,2,237000,15000,252000
5735,19,18,15,-1,2,177000,15000,192000
5736,6,12,10,-1,2,300000,45000,345000
5737,15,17,5,13,2,336000,60000,396000
5738,6,14,10,-1,2,264000,30000,294000
5739,13,19,17,-1,2,189000,0,189000
5740,12,13,19,-1,2,246000,15000,261000
5741,18,17,5,-1,2,264000,15000,279000
5742,15,8,7,-1,2,255000,15000,270000
5743,9,17,14,-1,2,207000,0,207000
5744,9,20,13,11,2,360000,120000,480000
5745,10,7,16,-1,2,288000,15000,303000
5746,10,12,19,-1,2,216000,0,216000
5747,18,12,19,-1,2,219000,15000,234000
5748,15,12,5,-1,2,264000,15000,279000
5749,5,18,16,-1,2,234000,0,234000
5750,13,19,12,-1,2,201000,15000,216000
5751,12,7,15,11,2,372000,265000,637000
5752,18,5,19,-1,2,264000,15000,279000
5753,14,5,19,-1,1,216000,0,216000
5754,11,16,9,-1,2,252000,0,252000
5755,17,20,19,-1,2,177000,15000,192000
5756,5,9,14,-1,2,300000,45000,345000
5757,20,18,6,-1,2,207000,0,207000
5758,19,18,10,11,2,348000,90000,438000
5759,8,5,16,-1,1,216000,0,216000
5760,9,19,12,-1,2,225000,0,225000
5761,10,18,12,-1,2,225000,0,225000
5762,7,14,20,-1,1,216000,0,216000
5763,14,13,15,-1,2,234000,30000,264000
5764,18,16,8,-1,2,252000,0,252000
5765,14,18,7,12,2,348000,60000,408000
5766,13,16,5,-1,2,264000,15000,279000
5767,7,14,20,-1,1,216000,0,216000
5768,12,6,17,-1,1,216000,0,216000
5769,15,18,9,-1,2,234000,0,234000
5770,6,16,13,-1,2,252000,0,252000
5771,7,9,20,-1,2,234000,0,234000
5772,12,19,14,11,2,348000,75000,423000
5773,10,5,19,-1,1,216000,0,216000
5774,20,6,13,-1,1,216000,0,216000
5775,12,7,10,-1,2,288000,15000,303000
5776,8,6,18,-1,2,234000,0,234000
5777,8,9,20,-1,2,219000,15000,234000
5778,9,8,15,-1,2,237000,15000,252000
5779,8,11,13,11,2,312000,90000,402000
5780,9,8,5,-1,2,288000,30000,318000
5781,9,12,20,-1,2,180000,0,180000
5782,12,20,5,-1,1,216000,0,216000
5783,18,16,17,-1,2,207000,30000,237000
5784,12,19,12,-1,1,207000,0,207000
5785,20,17,8,-1,2,207000,0,207000
5786,10,6,19,11,2,372000,245000,617000
5787,14,16,6,-1,2,264000,15000,279000
5788,13,12,20,-1,2,219000,15000,234000
5789,9,20,13,-1,1,216000,0,216000
5790,9,13,11,-1,2,276000,0,276000
5791,11,20,6,-1,1,198000,0,198000
5792,13,10,7,-1,2,243000,0,243000
5793,18,10,7,11,2,360000,90000,450000
5794,18,16,8,-1,2,252000,0,252000
5795,14,7,12,-1,2,252000,0,252000
5796,17,14,5,-1,2,234000,0,234000
5797,13,17,15,-1,2,195000,0,195000
5798,18,7,8,-1,2,264000,15000,279000
5799,16,14,9,-1,2,216000,0,216000
5800,12,17,14,12,2,312000,15000,327000
5801,10,8,18,-1,2,234000,0,234000
5802,5,20,19,-1,2,210000,15000,225000
5803,20,10,15,-1,1,198000,0,198000
5804,11,16,12,-1,2,255000,15000,270000
5805,7,20,16,-1,1,216000,0,216000
5806,9,13,12,-1,2,267000,15000,282000
5807,14,8,5,11,2,372000,185000,557000
5808,16,12,11,-1,2,246000,15000,261000
5809,13,11,19,-1,2,225000,0,225000
5810,18,10,10,-1,1,198000,0,198000
5811,20,18,16,-1,2,150000,0,150000
5812,6,9,11,-1,2,312000,75000,387000
5813,5,15,8,-1,2,243000,0,243000
5814,9,8,19,13,2,348000,30000,378000
5815,10,11,19,-1,2,255000,15000,270000
5816,12,6,8,-1,2,252000,0,252000
5817,10,8,7,-1,2,261000,30000,291000
5818,17,18,7,-1,2,201000,15000,216000
5819,12,9,7,-1,2,243000,0,243000
5820,12,8,16,-1,1,180000,0,180000
5821,12,8,6,11,2,384000,280000,664000
5822,11,9,7,-1,2,300000,30000,330000
5823,8,20,19,-1,2,192000,15000,207000
5824,9,18,11,-1,2,243000,0,243000
5825,7,19,20,-1,2,219000,15000,234000
5826,18,12,11,-1,2,237000,15000,252000
5827,6,8,12,-1,2,288000,15000,303000
5828,6,20,15,12,2,288000,0,288000
5829,18,15,20,-1,2,249000,0,249000
5830,6,8,17,-1,2,264000,15000,279000
5831,10,6,17,-1,1,216000,0,216000
5832,14,13,11,-1,2,240000,15000,255000
5833,19,8,11,-1,2,234000,0,234000
5834,6,13,19,-1,1,216000,0,216000
5835,14,8,16,12,2,348000,105000,453000
5836,9,6,10,-1,2,312000,90000,402000
5837,6,15,18,-1,2,225000,0,225000
5838,8,12,19,-1,1,189000,0,189000
5839,19,9,5,-1,1,216000,0,216000
5840,9,11,8,-1,2,288000,30000,318000
5841,6,12,13,-1,2,237000,15000,252000
5842,10,12,13,11,2,348000,150000,498000
5843,15,8,11,-1,2,252000,0,252000
5844,6,11,16,-1,1,216000,0,216000
5845,13,17,9,-1,1,198000,0,198000
5846,10,6,18,-1,1,216000,0,216000
5847,8,6,12,-1,2,288000,15000,303000
5848,11,6,8,-1,2,225000,0,225000
5849,19,20,5,13,2,312000,15000,327000
5850,16,12,8,-1,2,264000,30000,294000
5851,12,8,20,-1,1,216000,0,216000
5852,19,11,6,-1,1,216000,0,216000
5853,14,16,5,-1,2,252000,0,252000
5854,14,10,12,-1,2,231000,0,231000
5855,19,17,9,-1,2,216000,0,216000
5856,9,11,17,13,2,360000,120000,480000
5857,20,6,18,-1,2,252000,0,252000
5858,17,6,5,-1,2,264000,15000,279000
5859,16,20,5,-1,1,180000,0,180000
5860,13,8,18,-1,1,216000,0,216000
5861,14,7,9,-1,2,252000,0,252000
5862,17,14,8,-1,2,225000,0,225000
5863,9,20,18,13,2,312000,30000,342000
5864,5,19,18,-1,2,228000,15000,243000
5865,19,6,7,-1,2,264000,15000,279000
5866,19,13,15,-1,2,171000,0,171000
5867,17,5,15,-1,2,252000,0,252000
5868,17,20,16,-1,2,207000,15000,222000
5869,5,15,18,-1,2,252000,0,252000
5870,9,10,19,11,2,384000,165000,549000
5871,6,11,12,-1,2,300000,75000,375000
5872,15,19,5,-1,1,198000,0,198000
5873,11,20,8,-1,2,243000,0,243000
5874,15,9,16,-1,2,237000,15000,252000
5875,7,10,19,-1,2,243000,0,243000
5876,17,18,11,-1,2,210000,15000,225000
5877,6,7,9,13,2,396000,325000,721000
5878,14,19,12,-1,2,234000,0,234000
5879,20,16,7,-1,1,216000,0,216000
5880,17,9,11,-1,2,252000,0,252000
5881,19,18,7,-1,2,228000,15000,243000
5882,18,19,19,-1,2,165000,15000,180000
5883,11,7,20,-1,1,216000,0,216000
5884,17,5,16,11,2,360000,120000,480000
5885,9,5,18,-1,2,252000,15000,267000
5886,20,7,6,-1,2,264000,15000,279000
5887,9,17,12,-1,2,216000,0,216000
5888,12,6,13,-1,2,264000,15000,279000
5889,13,8,17,-1,1,180000,0,180000
5890,16,9,16,-1,1,207000,0,207000
5891,11,19,20,13,2,306000,60000,366000
5892,19,12,15,-1,2,243000,0,243000
5893,9,17,15,-1,2,252000,0,252000
5894,19,20,13,-1,2,210000,15000,225000
5895,10,17,13,-1,2,252000,0,252000
5896,14,20,13,-1,2,219000,15000,234000
5897,9,19,16,-1,2,252000,0,252000
5898,15,10,11,13,2,372000,165000,537000
5899,13,14,18,-1,2,255000,15000,270000
5900,6,11,9,-1,2,300000,30000,330000
5901,12,20,10,-1,2,198000,0,198000
5902,5,15,12,-1,2,252000,0,252000
5903,15,13,7,-1,2,234000,0,234000
5904,12,17,19,-1,2,180000,0,180000
5905,15,20,19,11,2,324000,75000,399000
5906,12,7,18,-1,1,216000,0,216000
5907,20,13,16,-1,2,207000,0,207000
5908,17,15,6,-1,2,252000,0,252000
5909,11,7,12,-1,2,276000,30000,306000
5910,12,14,7,-1,2,225000,0,225000
5911,8,9,7,-1,2,261000,30000,291000
5912,11,8,12,13,2,336000,120000,456000
5913,12,17,6,-1,1,216000,0,216000
5914,7,19,10,-1,2,252000,0,252000
5915,13,11,9,-1,2,258000,0,258000
5916,5,10,19,-1,1,207000,0,207000
5917,13,9,14,-1,2,228000,15000,243000
5918,19,9,15,-1,1,189000,0,189000
5919,9,6,16,13,2,384000,225000,609000
5920,14,13,9,-1,2,288000,45000,333000
5921,20,11,8,-1,2,243000,0,243000
5922,18,14,6,-1,1,216000,0,216000
5923,9,12,11,-1,2,249000,15000,264000
5924,8,10,7,-1,2,261000,30000,291000
5925,20,12,18,-1,2,162000,0,162000
5926,11,12,6,11,2,324000,175000,499000
5927,14,20,12,-1,2,216000,0,216000
5928,5,13,18,-1,1,216000,0,216000
5929,16,14,10,-1,2,243000,0,243000
5930,6,16,17,-1,2,255000,15000,270000
5931,18,9,12,-1,2,216000,0,216000
5932,14,8,10,-1,2,243000,0,243000
5933,14,5,9,12,2,348000,315000,663000
5934,8,9,13,-1,2,312000,45000,357000
5935,16,20,17,-1,2,180000,15000,195000
5936,11,14,16,-1,2,276000,0,276000
5937,13,18,17,-1,2,210000,15000,225000
5938,11,7,15,-1,2,264000,30000,294000
5939,15,5,16,-1,2,255000,15000,270000
5940,12,10,11,13,2,348000,135000,483000
5941,20,17,13,-1,2,225000,0,225000
5942,16,11,6,-1,2,264000,30000,294000
5943,12,19,9,-1,2,234000,0,234000
5944,6,9,19,-1,2,252000,0,252000
5945,18,9,16,-1,2,216000,0,216000
5946,17,10,5,-1,1,216000,0,216000
5947,20,8,9,12,2,360000,90000,450000
5948,17,14,19,-1,2,249000,0,249000
5949,5,10,18,-1,1,216000,0,216000
5950,11,19,13,-1,2,243000,0,243000
5951,18,10,16,-1,2,234000,0,234000
5952,7,17,18,-1,2,246000,15000,261000
5953,16,20,15,-1,2,183000,15000,198000
5954,16,9,20,13,2,348000,260000,608000
5955,17,9,18,-1,2,264000,15000,279000
5956,15,10,17,-1,2,216000,0,216000
5957,5,16,10,-1,1,216000,0,216000
5958,6,10,8,-1,2,288000,15000,303000
5959,10,12,6,-1,2,207000,0,207000
5960,7,9,11,-1,2,240000,0,240000
5961,10,9,6,11,2,348000,135000,483000
5962,10,12,10,-1,2,225000,0,225000
5963,12,20,7,-1,1,153000,0,153000
5964,14,16,11,-1,2,240000,0,240000
5965,7,11,20,-1,1,216000,0,216000
5966,9,19,10,-1,2,246000,15000,261000
5967,17,14,5,-1,2,252000,0,252000
5968,11,14,7,13,2,336000,135000,471000
5969,19,6,8,-1,2,252000,0,252000
5970,11,7,20,-1,1,216000,0,216000
5971,15,10,14,-1,2,237000,15000,252000
5972,13,11,5,-1,2,252000,0,252000
5973,17,5,20,-1,2,207000,0,207000
5974,11,15,6,-1,1,216000,0,216000
5975,8,10,12,11,2,372000,180000,552000
5976,13,18,5,-1,1,216000,0,216000
5977,11,6,7,-1,2,312000,45000,357000
5978,9,20,12,-1,2,198000,0,198000
5979,15,7,5,-1,2,252000,0,252000
5980,17,6,11,-1,1,198000,0,198000
5981,6,20,11,-1,1,216000,0,216000
5982,8,9,5,13,2,384000,310000,694000
5983,17,15,6,-1,2,252000,0,252000
5984,19,20,11,-1,2,219000,15000,234000
5985,10,5,16,-1,1,216000,0,216000
5986,7,8,11,-1,2,300000,30000,330000
5987,9,14,8,-1,2,210000,15000,225000
5988,17,19,9,-1,2,216000,0,216000
5989,10,8,12,12,2,312000,60000,372000
5990,18,19,7,-1,2,228000,15000,243000
5991,16,11,10,-1,2,237000,15000,252000
5992,13,20,19,-1,2,210000,15000,225000
5993,17,10,12,-1,2,252000,0,252000
5994,7,20,6,-1,2,264000,15000,279000
5995,17,20,6,-1,2,207000,0,207000
5996,19,10,6,13,2,348000,300000,648000
5997,17,8,5,-1,1,216000,0,216000
5998,14,17,11,-1,2,198000,0,198000
5999,8,15,17,-1,2,252000,0,252000
6000,11,15,6,-1,1,216000,0,216000
6001,19,18,7,-1,2,228000,15000,243000
6002,9,7,6,-1,2,300000,45000,345000
6003,18,16,9,12,2,324000,45000,369000
6004,10,17,19,-1,2,243000,0,243000
6005,5,20,10,-1,1,216000,0,216000
6006,19,18,16,-1,2,195000,15000,210000
6007,11,11,10,-1,2,264000,15000,279000
6008,17,19,11,-1,2,153000,0,153000
6009,19,17,11,-1,2,225000,0,225000
6010,20,6,16,13,2,348000,60000,408000
6011,8,10,14,-1,1,216000,0,216000
6012,5,13,17,-1,1,216000,0,216000
6013,13,7,14,-1,2,246000,15000,261000
6014,20,7,6,-1,2,237000,15000,252000
6015,15,5,8,-1,2,243000,0,243000
6016,8,11,6,-1,2,225000,0,225000
6017,8,17,18,11,2,336000,75000,411000
6018,7,17,14,-1,2,264000,15000,279000
6019,20,18,15,-1,2,213000,0,213000
6020,15,11,9,-1,2,288000,15000,303000
6021,7,13,19,-1,1,198000,0,198000
6022,13,19,15,-1,2,198000,0,198000
6023,18,14,9,-1,1,216000,0,216000
6024,10,19,17,13,2,348000,165000,513000
6025,16,12,18,-1,2,216000,0,216000
6026,15,16,18,-1,2,234000,30000,264000
6027,11,7,5,-1,2,312000,45000,357000
6028,19,11,18,-1,2,183000,15000,198000
6029,11,20,11,-1,1,180000,0,180000
6030,19,17,16,-1,2,180000,30000,210000
6031,18,16,12,13,2,348000,180000,528000
6032,16,17,7,-1,2,264000,15000,279000
6033,5,19,7,-1,2,252000,0,252000
6034,6,8,17,-1,2,225000,0,225000
6035,17,5,9,-1,1,198000,0,198000
6036,5,17,8,-1,2,252000,0,252000
6037,20,8,7,-1,2,228000,15000,243000
6038,6,19,18,12,2,324000,30000,354000
6039,12,16,14,-1,2,276000,0,276000
6040,5,17,19,-1,2,234000,0,234000
6041,9,12,11,-1,2,249000,15000,264000
6042,7,13,16,-1,2,225000,0,225000
6043,20,15,12,-1,2,189000,0,189000
6044,18,20,16,-1,2,222000,0,222000
6045,20,17,5,13,2,348000,190000,538000
6046,13,11,7,-1,2,264000,15000,279000
6047,17,13,20,-1,2,171000,0,171000
6048,9,7,15,-1,2,288000,15000,303000
6049,8,9,5,-1,2,276000,15000,291000
6050,15,13,13,-1,2,144000,0,144000
6051,8,6,5,-1,2,261000,30000,291000
6052,15,12,9,13,2,315000,90000,405000
6053,18,15,12,-1,2,225000,0,225000
6054,16,13,7,-1,2,264000,15000,279000
6055,15,5,6,-1,2,264000,15000,279000
6056,13,20,14,-1,2,183000,15000,198000
6057,5,9,14,-1,2,288000,30000,318000
6058,20,15,5,-1,1,189000,0,189000
6059,17,14,16,12,2,360000,75000,435000
6060,18,7,6,-1,2,276000,30000,306000
6061,11,10,20,-1,2,237000,15000,252000
6062,12,16,10,-1,2,225000,0,225000
6063,14,11,15,-1,2,240000,15000,255000
6064,18,11,12,-1,2,228000,15000,243000
6065,9,7,19,-1,2,252000,0,252000
6066,9,8,16,11,2,372000,135000,507000
6067,9,12,5,-1,2,276000,30000,306000
6068,13,5,12,-1,2,264000,15000,279000
6069,10,20,19,-1,2,183000,15000,198000
6070,12,9,5,-1,2,276000,30000,306000
6071,15,20,6,-1,1,189000,0,189000
6072,17,14,9,-1,2,234000,0,234000
6073,5,12,8,11,2,384000,280000,664000
6074,7,5,16,-1,2,264000,15000,279000
6075,12,20,11,-1,2,219000,15000,234000
6076,6,18,8,-1,2,252000,0,252000
6077,10,12,13,-1,2,231000,15000,246000
6078,11,9,14,-1,2,216000,0,216000
6079,16,9,6,-1,2,252000,0,252000
6080,18,12,19,13,2,336000,60000,396000
6081,9,6,7,-1,2,324000,105000,429000
6082,19,5,10,-1,1,198000,0,198000
6083,16,8,5,-1,2,252000,0,252000
6084,16,10,14,-1,2,189000,0,189000
6085,20,14,18,-1,2,189000,0,189000
6086,13,11,16,-1,2,252000,0,252000
6087,15,18,12,11,2,372000,120000,492000
6088,10,5,17,-1,2,252000,15000,267000
6089,11,20,6,-1,1,216000,0,216000
6090,9,11,6,-1,2,288000,15000,303000
6091,7,19,13,-1,1,180000,0,180000
6092,19,7,9,-1,2,252000,0,252000
6093,20,15,6,-1,1,189000,0,189000
6094,13,7,10,11,2,372000,180000,552000
6095,15,16,13,-1,2,258000,15000,273000
6096,19,14,7,-1,1,216000,0,216000
6097,16,10,19,-1,2,234000,0,234000
6098,8,6,5,-1,2,312000,60000,372000
6099,10,5,16,-1,1,180000,0,180000
6100,20,19,8,-1,2,210000,15000,225000
6101,18,6,20,12,2,336000,45000,381000
6102,20,5,10,-1,1,216000,0,216000
6103,8,16,20,-1,1,198000,0,198000
6104,8,12,17,-1,1,216000,0,216000
6105,20,17,5,-1,2,243000,0,243000
6106,15,8,7,-1,2,264000,15000,279000
6107,11,15,8,-1,2,216000,0,216000
6108,7,8,7,12,2,336000,165000,501000
6109,18,19,9,-1,2,219000,15000,234000
6110,16,13,17,-1,2,222000,15000,237000
6111,10,8,16,-1,2,252000,0,252000
6112,16,11,8,-1,2,234000,0,234000
6113,16,17,18,-1,2,198000,30000,228000
6114,6,7,15,-1,2,276000,30000,306000
6115,12,18,17,13,2,348000,105000,453000
6116,18,6,20,-1,2,207000,0,207000
6117,12,14,17,-1,2,207000,0,207000
6118,10,11,20,-1,2,255000,15000,270000
6119,9,11,20,-1,2,234000,0,234000
6120,16,7,8,-1,2,255000,15000,270000
6121,10,18,6,-1,1,198000,0,198000
6122,12,14,5,13,2,348000,150000,498000
6123,18,20,11,-1,2,252000,0,252000
6124,12,13,15,-1,2,261000,30000,291000
6125,5,19,14,-1,1,216000,0,216000
6126,14,5,9,-1,2,252000,15000,267000
6127,10,11,9,-1,2,243000,30000,273000
6128,19,8,12,-1,1,180000,0,180000
6129,18,19,6,13,2,336000,75000,411000
6130,11,15,12,-1,2,243000,0,243000
6131,14,8,6,-1,2,243000,0,243000
6132,17,5,10,-1,1,198000,0,198000
6133,7,11,17,-1,1,198000,0,198000
6134,14,13,12,-1,2,243000,30000,273000
6135,12,19,12,-1,1,171000,0,171000
6136,5,19,8,13,2,348000,140000,488000
6137,14,7,10,-1,2,288000,15000,303000
6138,19,18,6,-1,2,219000,15000,234000
6139,12,13,11,-1,2,252000,30000,282000
6140,12,14,13,-1,2,234000,30000,264000
6141,15,17,9,-1,2,234000,0,234000
6142,13,16,14,-1,2,225000,30000,255000
6143,9,15,20,13,2,348000,75000,423000
6144,20,14,7,-1,1,207000,0,207000
6145,15,16,19,-1,2,207000,15000,222000
6146,13,10,8,-1,2,288000,15000,303000
6147,7,10,6,-1,2,270000,15000,285000
6148,13,11,18,-1,2,162000,0,162000
6149,6,12,10,-1,2,264000,15000,279000
6150,15,11,18,13,2,336000,105000,441000
6151,6,7,16,-1,2,264000,15000,279000
6152,16,20,12,-1,1,171000,0,171000
6153,5,9,13,-1,2,312000,60000,372000
6154,9,17,10,-1,2,219000,15000,234000
6155,15,5,18,-1,2,243000,0,243000
6156,8,14,11,-1,2,225000,0,225000
6157,10,5,14,12,2,348000,290000,638000
6158,6,5,12,-1,2,324000,60000,384000
6159,8,20,12,-1,1,171000,0,171000
6160,18,7,13,-1,1,216000,0,216000
6161,9,14,13,-1,2,255000,15000,270000
6162,18,7,12,-1,1,207000,0,207000
6163,19,10,17,-1,2,225000,0,225000
6164,12,15,6,11,2,360000,150000,510000
6165,10,18,19,-1,2,264000,15000,279000
6166,17,5,8,-1,2,252000,0,252000
6167,8,15,19,-1,1,198000,0,198000
6168,11,20,14,-1,2,225000,0,225000
6169,11,19,12,-1,2,246000,15000,261000
6170,5,15,9,-1,2,252000,15000,267000
6171,12,11,16,13,2,348000,165000,513000
6172,16,6,10,-1,2,252000,15000,267000
6173,20,10,14,-1,1,198000,0,198000
6174,14,8,20,-1,1,216000,0,216000
6175,19,14,18,-1,2,228000,15000,243000
6176,19,20,5,-1,2,264000,15000,279000
6177,8,13,17,-1,1,216000,0,216000
6178,13,10,5,11,2,372000,360000,732000
6179,6,16,19,-1,2,252000,0,252000
6180,18,11,7,-1,1,216000,0,216000
6181,20,16,12,-1,1,198000,0,198000
6182,8,9,10,-1,2,312000,60000,372000
6183,13,16,14,-1,2,216000,30000,246000
6184,11,11,10,-1,2,237000,15000,252000
6185,17,19,9,11,2,303000,45000,348000
6186,19,18,11,-1,2,246000,15000,261000
6187,10,15,17,-1,2,234000,0,234000
6188,13,7,13,-1,1,207000,0,207000
6189,6,19,17,-1,2,171000,0,171000
6190,12,10,18,-1,2,216000,0,216000
6191,9,15,14,-1,2,246000,15000,261000
6192,12,10,18,13,2,348000,75000,423000
6193,13,19,20,-1,2,246000,15000,261000
6194,8,9,12,-1,2,300000,30000,330000
6195,16,13,13,-1,2,171000,0,171000
6196,11,17,5,-1,1,198000,0,198000
6197,5,6,15,-1,2,264000,15000,279000
6198,7,6,5,-1,2,261000,30000,291000
6199,20,13,8,12,2,288000,30000,318000
6200,10,17,12,-1,2,252000,0,252000
6201,20,11,18,-1,2,216000,0,216000
6202,11,18,20,-1,2,225000,0,225000
6203,5,17,18,-1,2,255000,15000,270000
6204,13,19,8,-1,1,198000,0,198000
6205,20,10,15,-1,1,198000,0,198000
6206,12,11,18,12,2,336000,75000,411000
6207,15,11,10,-1,2,255000,15000,270000
6208,6,5,11,-1,2,300000,30000,330000
6209,16,15,12,-1,2,177000,15000,192000
6210,17,11,14,-1,2,225000,0,225000
6211,7,10,12,-1,2,288000,15000,303000
6212,15,13,8,-1,2,216000,0,216000
6213,17,5,20,11,2,312000,30000,342000
6214,16,14,15,-1,2,240000,15000,255000
6215,8,12,19,-1,1,198000,0,198000
6216,7,20,11,-1,1,216000,0,216000
6217,8,12,16,-1,1,216000,0,216000
6218,14,20,11,-1,2,225000,0,225000
6219,15,5,20,-1,1,216000,0,216000
6220,19,5,12,13,2,348000,305000,653000
6221,16,6,12,-1,1,216000,0,216000
6222,18,17,20,-1,2,198000,30000,228000
6223,7,18,5,-1,2,276000,30000,306000
6224,5,15,19,-1,1,216000,0,216000
6225,8,11,14,-1,2,243000,0,243000
6226,16,9,14,-1,2,225000,0,225000
6227,8,11,20,12,2,360000,90000,450000
6228,11,5,7,-1,2,312000,45000,357000
6229,5,20,6,-1,2,228000,15000,243000
6230,8,16,17,-1,2,228000,15000,243000
6231,15,16,14,-1,2,207000,30000,237000
6232,8,5,13,-1,2,288000,15000,303000
6233,15,16,6,-1,2,237000,15000,252000
6234,8,7,9,12,2,372000,245000,617000
6235,8,16,15,-1,2,264000,15000,279000
6236,6,16,9,-1,2,243000,0,243000
6237,8,6,16,-1,2,234000,0,234000
6238,12,10,20,-1,2,189000,0,189000
6239,9,14,16,-1,2,234000,0,234000
6240,18,10,13,-1,2,216000,0,216000
6241,11,13,20,12,2,360000,135000,495000
6242,13,9,12,-1,2,264000,15000,279000
6243,8,19,17,-1,2,189000,0,189000
6244,12,6,18,-1,1,216000,0,216000
6245,8,11,16,-1,2,234000,0,234000
6246,17,8,14,-1,2,234000,0,234000
6247,18,8,12,-1,1,198000,0,198000
6248,14,17,11,13,2,348000,165000,513000
6249,15,7,12,-1,2,252000,0,252000
6250,19,11,20,-1,2,192000,15000,207000
6251,14,7,13,-1,2,264000,15000,279000
6252,17,6,14,-1,2,243000,0,243000
6253,19,11,14,-1,2,189000,0,189000
6254,17,7,11,-1,1,216000,0,216000
6255,14,11,12,13,2,360000,210000,570000
6256,7,8,16,-1,2,252000,0,252000
6257,20,10,18,-1,2,198000,0,198000
6258,8,16,9,-1,2,255000,15000,270000
6259,11,18,7,-1,1,198000,0,198000
6260,10,5,19,-1,1,216000,0,216000
6261,6,11,20,-1,1,216000,0,216000
6262,16,11,7,13,2,348000,275000,623000
6263,6,9,6,-1,2,264000,15000,279000
6264,9,10,5,-1,2,228000,15000,243000
6265,5,19,6,-1,2,228000,15000,243000
6266,9,15,8,-1,2,219000,15000,234000
6267,6,15,10,-1,1,207000,0,207000
6268,7,14,12,-1,2,243000,0,243000
6269,11,10,16,13,2,348000,105000,453000
6270,20,15,14,-1,2,228000,15000,243000
6271,18,9,9,-1,1,216000,0,216000
6272,9,11,18,-1,2,198000,0,198000
6273,7,13,8,-1,2,255000,15000,270000
6274,18,14,15,-1,2,198000,15000,213000
6275,10,19,16,-1,2,243000,0,243000
6276,8,18,17,12,2,348000,120000,468000
6277,17,13,20,-1,2,216000,0,216000
6278,15,10,5,-1,1,216000,0,216000
6279,14,8,9,-1,2,255000,15000,270000
6280,6,7,12,-1,2,255000,15000,270000
6281,6,8,12,-1,2,225000,0,225000
6282,13,10,12,-1,2,213000,15000,228000
6283,16,12,10,13,2,348000,105000,453000
6284,10,5,19,-1,1,216000,0,216000
6285,20,6,12,-1,1,216000,0,216000
6286,16,19,15,-1,2,243000,15000,258000
6287,9,14,12,-1,2,288000,15000,303000
6288,13,18,9,-1,1,180000,0,180000
6289,16,20,16,-1,1,153000,0,153000
6290,8,13,20,12,2,360000,90000,450000
6291,10,20,17,-1,2,252000,0,252000
6292,6,9,13,-1,2,300000,30000,330000
6293,12,18,15,-1,2,180000,0,180000
6294,19,7,14,-1,1,216000,0,216000
6295,20,14,15,-1,2,228000,15000,243000
6296,13,5,12,-1,2,288000,45000,333000
6297,19,18,9,12,2,336000,90000,426000
6298,16,11,7,-1,1,216000,0,216000
6299,10,18,6,-1,1,216000,0,216000
6300,9,13,8,-1,2,246000,15000,261000
6301,13,11,15,-1,2,222000,0,222000
6302,15,14,12,-1,2,222000,15000,237000
6303,13,15,10,-1,2,249000,0,249000
6304,12,6,8,11,2,372000,240000,612000
6305,14,11,16,-1,2,258000,0,258000
6306,19,12,9,-1,2,234000,0,234000
6307,10,9,20,-1,2,246000,15000,261000
6308,18,12,17,-1,2,210000,15000,225000
6309,8,18,12,-1,1,216000,0,216000
6310,10,14,17,-1,2,243000,0,243000
6311,14,10,9,13,2,384000,280000,664000
6312,10,6,7,-1,2,324000,90000,414000
6313,12,19,10,-1,2,189000,0,189000
6314,9,6,16,-1,2,252000,0,252000
6315,15,20,16,-1,2,174000,15000,189000
6316,15,16,6,-1,2,276000,30000,306000
6317,10,18,15,-1,2,234000,0,234000
6318,8,15,12,13,2,348000,305000,653000
6319,17,10,7,-1,1,216000,0,216000
6320,5,20,9,-1,1,216000,0,216000
6321,14,16,5,-1,2,252000,0,252000
6322,8,10,13,-1,2,207000,0,207000
6323,19,13,15,-1,2,180000,0,180000
6324,12,15,6,-1,2,264000,15000,279000
6325,5,20,15,12,2,360000,60000,420000
6326,16,18,20,-1,2,231000,0,231000
6327,19,7,20,-1,2,264000,15000,279000
6328,12,13,19,-1,2,228000,15000,243000
6329,6,18,12,-1,1,216000,0,216000
6330,11,7,18,-1,1,216000,0,216000
6331,18,5,9,-1,1,216000,0,216000
6332,8,6,17,13,2,384000,210000,594000
6333,13,5,19,-1,1,216000,0,216000
6334,12,6,5,-1,2,324000,60000,384000
6335,17,12,10,-1,2,189000,0,189000
6336,18,14,9,-1,1,198000,0,198000
6337,14,17,19,-1,2,231000,0,231000
6338,19,6,20,-1,2,255000,15000,270000
6339,18,16,7,13,2,348000,120000,468000
6340,7,19,15,-1,1,198000,0,198000
6341,16,15,10,-1,2,237000,15000,252000
6342,13,9,19,-1,1,198000,0,198000
6343,13,16,20,-1,2,216000,0,216000
6344,8,18,19,-1,2,264000,15000,279000
6345,10,17,18,-1,2,246000,15000,261000
6346,8,13,10,12,2,372000,265000,637000
6347,13,6,8,-1,2,288000,15000,303000
6348,5,18,9,-1,1,207000,0,207000
6349,18,10,7,-1,2,234000,0,234000
6350,18,20,14,-1,2,171000,0,171000
6351,9,7,6,-1,2,324000,105000,429000
6352,6,18,13,-1,1,189000,0,189000
6353,11,9,10,13,2,372000,195000,567000
6354,9,5,18,-1,2,252000,15000,267000
6355,9,12,16,-1,2,234000,0,234000
6356,14,8,11,-1,2,243000,0,243000
6357,20,17,10,-1,2,216000,0,216000
6358,16,17,7,-1,2,264000,15000,279000
6359,15,19,20,-1,2,174000,15000,189000
6360,16,10,9,11,2,384000,455000,839000
6361,6,9,16,-1,2,252000,0,252000
6362,19,20,7,-1,2,210000,15000,225000
6363,18,19,20,-1,2,186000,30000,216000
6364,8,5,19,-1,1,216000,0,216000
6365,20,8,13,-1,1,198000,0,198000
6366,12,6,17,-1,1,216000,0,216000
6367,16,10,12,11,2,372000,180000,552000
6368,15,9,6,-1,2,300000,30000,330000
6369,7,17,19,-1,2,225000,0,225000
6370,9,5,17,-1,1,216000,0,216000
6371,19,5,15,-1,1,207000,0,207000
6372,17,9,15,-1,2,234000,0,234000
6373,7,14,15,-1,2,255000,15000,270000
6374,20,7,15,11,2,336000,30000,366000
6375,7,16,17,-1,2,264000,15000,279000
6376,18,5,20,-1,2,225000,0,225000
6377,7,12,20,-1,1,216000,0,216000
6378,20,19,18,-1,2,177000,30000,207000
6379,20,12,13,-1,2,234000,0,234000
6380,10,12,16,-1,2,216000,0,216000
6381,10,18,9,12,2,372000,105000,477000
6382,17,18,16,-1,2,243000,30000,273000
6383,6,9,17,-1,2,264000,15000,279000
6384,17,5,7,-1,2,252000,0,252000
6385,9,15,8,-1,2,237000,15000,252000
6386,13,15,8,-1,2,225000,0,225000
6387,15,14,5,-1,2,255000,15000,270000
6388,11,10,16,13,2,348000,105000,453000
6389,5,7,16,-1,2,252000,0,252000
6390,19,6,12,-1,1,216000,0,216000
6391,14,8,19,-1,1,198000,0,198000
6392,20,18,7,-1,2,234000,0,234000
6393,10,13,7,-1,2,252000,0,252000
6394,19,11,13,-1,2,198000,0,198000
6395,17,16,18,13,2,348000,60000,408000
6396,9,11,12,-1,2,264000,15000,279000
6397,17,20,11,-1,2,171000,0,171000
6398,5,6,7,-1,2,312000,60000,372000
6399,11,6,12,-1,2,228000,15000,243000
6400,7,9,6,-1,2,261000,30000,291000
6401,12,5,11,-1,2,228000,15000,243000
6402,17,13,9,13,2,264000,0,264000
6403,17,12,8,-1,1,198000,0,198000
6404,14,19,5,-1,1,216000,0,216000
6405,13,19,17,-1,2,207000,0,207000
6406,7,19,14,-1,1,216000,0,216000
6407,6,10,15,-1,2,264000,30000,294000
6408,13,15,9,-1,2,225000,0,225000
6409,6,18,20,12,2,312000,30000,342000
6410,11,5,14,-1,2,252000,0,252000
6411,18,10,15,-1,2,198000,0,198000
6412,7,6,15,-1,2,264000,15000,279000
6413,13,8,19,-1,1,189000,0,189000
6414,16,13,12,-1,2,252000,15000,267000
6415,15,13,7,-1,2,252000,0,252000
6416,8,7,13,13,2,312000,15000,327000
6417,7,19,20,-1,2,210000,15000,225000
6418,7,11,15,-1,2,252000,15000,267000
6419,6,9,14,-1,2,243000,0,243000
6420,7,10,5,-1,2,243000,0,243000
6421,10,9,19,-1,2,201000,15000,216000
6422,20,9,7,-1,2,243000,0,243000
6423,14,20,17,13,2,327000,45000,372000
6424,5,7,8,-1,2,312000,90000,402000
6425,19,10,15,-1,1,153000,0,153000
6426,13,12,17,-1,2,246000,15000,261000
6427,11,10,13,-1,2,279000,30000,309000
6428,18,12,14,-1,2,189000,0,189000
6429,12,5,15,-1,2,264000,15000,279000
6430,11,9,14,13,2,360000,135000,495000
6431,11,6,15,-1,2,264000,30000,294000
6432,19,15,20,-1,2,183000,15000,198000
6433,9,17,11,-1,2,252000,0,252000
6434,16,11,5,-1,2,252000,15000,267000
6435,19,14,9,-1,1,189000,0,189000
6436,15,13,6,-1,2,252000,0,252000
6437,16,7,6,13,2,372000,160000,532000
6438,15,11,10,-1,2,264000,15000,279000
6439,6,12,13,-1,2,264000,15000,279000
6440,20,16,17,-1,2,180000,15000,195000
6441,9,19,14,-1,1,216000,0,216000
6442,17,13,20,-1,2,234000,0,234000
6443,6,14,13,-1,2,276000,30000,306000
6444,18,13,11,12,2,360000,135000,495000
6445,19,12,11,-1,2,264000,15000,279000
6446,16,18,7,-1,2,252000,0,252000
6447,14,12,17,-1,2,198000,0,198000
6448,9,19,12,-1,2,252000,0,252000
6449,14,6,8,-1,2,252000,0,252000
6450,5,13,10,-1,2,243000,0,243000
6451,7,14,5,12,2,348000,45000,393000
6452,6,16,9,-1,2,252000,0,252000
6453,13,20,10,-1,2,216000,0,216000
6454,5,13,18,-1,1,216000,0,216000
6455,5,12,19,-1,1,216000,0,216000
6456,8,14,11,-1,2,252000,0,252000
6457,14,9,8,-1,2,246000,15000,261000
6458,20,8,11,12,2,348000,75000,423000
6459,20,15,8,-1,1,216000,0,216000
6460,17,14,13,-1,2,270000,15000,285000
6461,6,15,12,-1,2,252000,0,252000
6462,6,7,20,-1,2,255000,15000,270000
6463,15,9,20,-1,1,171000,0,171000
6464,6,9,14,-1,2,288000,15000,303000
6465,14,5,20,13,2,324000,45000,369000
6466,19,6,14,-1,1,216000,0,216000
6467,9,19,7,-1,2,252000,0,252000
6468,10,16,18,-1,2,234000,0,234000
6469,13,18,16,-1,2,222000,0,222000
6470,9,5,19,-1,1,216000,0,216000
6471,17,7,8,-1,2,264000,15000,279000
6472,13,10,7,11,2,372000,180000,552000
6473,8,9,5,-1,2,312000,90000,402000
6474,10,8,15,-1,2,207000,0,207000
6475,9,17,12,-1,2,216000,0,216000
6476,8,11,9,-1,2,279000,30000,309000
6477,10,6,15,-1,1,189000,0,189000
6478,11,19,16,-1,2,207000,0,207000
6479,17,7,11,13,2,348000,315000,663000
6480,5,16,18,-1,2,234000,0,234000
6481,18,8,13,-1,1,189000,0,189000
6482,7,17,5,-1,2,252000,0,252000
6483,12,7,15,-1,2,234000,0,234000
6484,10,12,19,-1,2,207000,0,207000
6485,7,18,5,-1,2,252000,0,252000
6486,12,9,13,11,2,348000,135000,483000
6487,17,16,7,-1,2,264000,15000,279000
6488,6,19,18,-1,2,228000,15000,243000
6489,6,8,20,-1,2,252000,0,252000
6490,18,7,14,-1,1,189000,0,189000
6491,13,5,16,-1,2,252000,0,252000
6492,13,10,8,-1,2,225000,0,225000
6493,20,19,8,12,2,312000,30000,342000
6494,13,5,18,-1,1,216000,0,216000
6495,15,5,10,-1,1,216000,0,216000
6496,12,17,15,-1,2,222000,0,222000
6497,9,6,10,-1,2,288000,30000,318000
6498,7,19,9,-1,2,216000,0,216000
6499,20,18,10,-1,2,198000,0,198000
6500,15,20,16,12,2,360000,45000,405000
6501,17,19,7,-1,2,252000,0,252000
6502,5,13,8,-1,2,288000,15000,303000
6503,19,9,7,-1,2,216000,0,216000
6504,14,12,13,-1,2,216000,30000,246000
6505,6,5,19,-1,2,264000,15000,279000
6506,20,6,16,-1,1,180000,0,180000
6507,5,19,9,12,2,360000,340000,700000
6508,16,19,11,-1,2,225000,0,225000
6509,17,12,20,-1,2,198000,0,198000
6510,11,19,16,-1,2,243000,0,243000
6511,5,13,19,-1,1,216000,0,216000
6512,12,10,7,-1,2,288000,15000,303000
6513,6,15,20,-1,1,189000,0,189000
6514,16,17,13,11,2,360000,60000,420000
6515,12,6,13,-1,2,288000,45000,333000
6516,7,11,6,-1,2,264000,15000,279000
6517,14,20,15,-1,2,165000,15000,180000
6518,12,6,9,-1,2,312000,45000,357000
6519,9,16,6,-1,2,234000,0,234000
6520,7,10,16,-1,2,225000,0,225000
6521,5,20,12,13,2,348000,90000,438000
6522,9,18,14,-1,2,252000,15000,267000
6523,12,18,20,-1,2,216000,0,216000
6524,17,20,14,-1,2,207000,0,207000
6525,18,5,15,-1,2,264000,15000,279000
6526,8,11,14,-1,2,288000,15000,303000
6527,7,15,8,-1,2,237000,15000,252000
6528,14,11,13,12,2,348000,150000,498000
6529,12,6,15,-1,2,264000,15000,279000
6530,18,8,16,-1,2,243000,0,243000
6531,11,10,8,-1,2,249000,15000,264000
6532,11,9,5,-1,2,234000,0,234000
6533,9,7,11,-1,2,231000,0,231000
6534,17,18,16,-1,2,162000,30000,192000
6535,7,16,8,12,2,408000,265000,673000
6536,9,10,18,-1,2,264000,15000,279000
6537,7,5,15,-1,2,252000,0,252000
6538,18,5,13,-1,1,216000,0,216000
6539,10,12,19,-1,2,216000,0,216000
6540,9,14,6,-1,2,252000,0,252000
6541,20,14,8,-1,1,189000,0,189000
6542,6,5,7,13,2,408000,340000,748000
6543,6,13,15,-1,2,252000,0,252000
6544,12,6,10,-1,2,252000,0,252000
6545,9,20,14,-1,1,162000,0,162000
6546,18,6,12,-1,1,216000,0,216000
6547,9,11,12,-1,2,276000,15000,291000
6548,17,6,12,-1,1,198000,0,198000
6549,5,19,9,13,2,348000,180000,528000
6550,13,17,18,-1,2,246000,15000,261000
6551,18,17,6,-1,2,264000,15000,279000
6552,5,10,18,-1,1,216000,0,216000
6553,6,10,20,-1,1,216000,0,216000
6554,17,5,18,-1,2,246000,15000,261000
6555,14,9,13,-1,2,237000,15000,252000
6556,16,14,13,12,2,348000,120000,468000
6557,16,19,5,-1,2,252000,0,252000
6558,10,11,13,-1,2,279000,30000,309000
6559,20,16,14,-1,2,171000,0,171000
6560,17,5,17,-1,1,216000,0,216000
6561,17,9,5,-1,1,198000,0,198000
6562,10,15,19,-1,1,171000,0,171000
6563,7,10,16,11,2,384000,345000,729000
6564,16,19,17,-1,2,213000,0,213000
6565,6,20,10,-1,1,216000,0,216000
6566,14,20,18,-1,2,198000,0,198000
6567,12,11,8,-1,2,300000,45000,345000
6568,17,5,16,-1,2,237000,15000,252000
6569,13,5,8,-1,2,252000,0,252000
6570,10,20,9,13,2,312000,60000,372000
6571,10,20,14,-1,1,216000,0,216000
6572,15,6,20,-1,1,216000,0,216000
6573,8,13,12,-1,2,288000,45000,333000
6574,6,19,5,-1,2,264000,15000,279000
6575,17,13,9,-1,1,171000,0,171000
6576,20,10,13,-1,2,243000,0,243000
6577,8,5,19,11,2,396000,230000,626000
6578,10,19,8,-1,2,252000,0,252000
6579,9,14,6,-1,2,252000,0,252000
6580,5,13,17,-1,1,216000,0,216000
6581,7,19,14,-1,1,198000,0,198000
6582,5,16,18,-1,2,243000,0,243000
6583,9,5,11,-1,2,252000,0,252000
6584,17,12,13,11,2,327000,75000,402000
6585,9,19,15,-1,1,216000,0,216000
6586,18,11,20,-1,2,234000,0,234000
6587,19,16,12,-1,2,216000,0,216000
6588,11,14,8,-1,2,288000,15000,303000
6589,15,7,8,-1,2,246000,15000,261000
6590,8,11,13,-1,2,240000,0,240000
6591,12,14,9,12,2,300000,75000,375000
6592,11,14,15,-1,2,231000,15000,246000
6593,7,17,13,-1,1,216000,0,216000
6594,20,7,6,-1,2,264000,15000,279000
6595,15,17,8,-1,2,216000,0,216000
6596,18,6,20,-1,2,207000,0,207000
6597,20,8,7,-1,2,264000,15000,279000
6598,15,9,20,11,2,336000,60000,396000
6599,16,13,7,-1,2,264000,15000,279000
6600,7,9,6,-1,2,300000,45000,345000
6601,9,13,20,-1,1,144000,0,144000
6602,11,19,6,-1,1,216000,0,216000
6603,5,10,14,-1,2,264000,30000,294000
6604,15,18,10,-1,2,207000,0,207000
6605,17,9,12,12,2,324000,75000,399000
6606,8,13,19,-1,1,216000,0,216000
6607,20,16,6,-1,1,216000,0,216000
6608,14,13,16,-1,2,243000,30000,273000
6609,20,18,15,-1,2,213000,0,213000
6610,17,7,8,-1,2,264000,15000,279000
6611,9,12,8,-1,2,288000,15000,303000
6612,7,11,15,13,2,324000,105000,429000
6613,16,6,14,-1,2,252000,0,252000
6614,5,13,8,-1,2,252000,0,252000
6615,7,9,18,-1,2,234000,0,234000
6616,12,10,6,-1,2,234000,0,234000
6617,12,13,9,-1,2,222000,15000,237000
6618,7,19,6,-1,2,255000,15000,270000
6619,6,19,16,13,2,324000,15000,339000
6620,13,15,8,-1,2,264000,15000,279000
6621,11,17,8,-1,2,234000,0,234000
6622,5,17,7,-1,2,252000,0,252000
6623,5,12,6,-1,2,246000,15000,261000
6624,8,10,9,-1,2,234000,30000,264000
6625,8,20,9,-1,2,219000,15000,234000
6626,17,20,11,12,2,348000,60000,408000
6627,15,10,5,-1,2,288000,30000,318000
6628,14,6,17,-1,2,243000,0,243000
6629,13,16,14,-1,2,207000,30000,237000
6630,20,11,14,-1,2,225000,0,225000
6631,9,15,13,-1,2,252000,0,252000
6632,7,12,5,-1,2,252000,0,252000
6633,15,7,11,12,2,336000,105000,441000
6634,16,19,13,-1,2,225000,0,225000
6635,11,13,6,-1,2,276000,30000,306000
6636,8,13,17,-1,1,198000,0,198000
6637,7,15,10,-1,2,252000,0,252000
6638,10,6,16,-1,1,216000,0,216000
6639,18,12,13,-1,2,210000,15000,225000
6640,20,16,11,12,2,360000,105000,465000
6641,11,20,16,-1,1,198000,0,198000
6642,8,18,19,-1,2,246000,15000,261000
6643,18,15,6,-1,2,252000,0,252000
6644,7,12,5,-1,2,252000,0,252000
6645,9,7,8,-1,2,243000,30000,273000
6646,17,5,10,-1,1,189000,0,189000
6647,12,18,15,13,2,348000,135000,483000
6648,6,13,9,-1,2,312000,45000,357000
6649,7,20,18,-1,2,198000,0,198000
6650,12,20,19,-1,2,219000,15000,234000
6651,16,8,11,-1,2,252000,0,252000
6652,16,7,6,-1,2,264000,15000,279000
6653,8,9,17,-1,2,228000,15000,243000
6654,8,9,12,11,2,372000,165000,537000
6655,14,5,6,-1,2,264000,15000,279000
6656,15,6,17,-1,2,243000,0,243000
6657,15,17,20,-1,2,153000,0,153000
6658,14,20,19,-1,2,246000,15000,261000
6659,12,18,11,-1,2,264000,15000,279000
6660,11,17,5,-1,1,216000,0,216000
6661,19,13,6,12,2,360000,90000,450000
6662,10,11,8,-1,2,300000,45000,345000
6663,16,7,18,-1,2,225000,0,225000
6664,20,18,10,-1,2,207000,0,207000
6665,16,10,8,-1,2,243000,0,243000
6666,9,15,12,-1,2,216000,0,216000
6667,16,6,15,-1,2,264000,15000,279000
6668,18,17,6,12,2,336000,45000,381000
6669,18,9,16,-1,2,252000,0,252000
6670,6,17,9,-1,2,252000,0,252000
6671,11,9,6,-1,2,276000,0,276000
6672,18,5,15,-1,2,207000,0,207000
6673,14,11,8,-1,2,225000,0,225000
6674,11,15,18,-1,2,207000,0,207000
6675,17,6,19,11,2,360000,215000,575000
6676,16,15,7,-1,2,246000,15000,261000
6677,16,15,10,-1,2,210000,15000,225000
6678,13,11,7,-1,2,252000,0,252000
6679,13,17,6,-1,1,198000,0,198000
6680,9,12,20,-1,2,225000,0,225000
6681,17,11,18,-1,2,228000,15000,243000
6682,12,13,15,11,2,372000,165000,537000
6683,6,13,12,-1,2,288000,45000,333000
6684,8,6,9,-1,2,276000,15000,291000
6685,15,16,19,-1,2,162000,15000,177000
6686,12,5,16,-1,2,252000,15000,267000
6687,16,10,5,-1,1,216000,0,216000
6688,7,13,5,-1,2,252000,0,252000
6689,6,8,14,12,2,360000,160000,520000
6690,15,6,11,-1,2,252000,15000,267000
6691,16,8,17,-1,2,237000,15000,252000
6692,8,10,11,-1,2,249000,15000,264000
6693,9,14,17,-1,2,198000,0,198000
6694,5,14,11,-1,2,252000,0,252000
6695,18,13,8,-1,1,189000,0,189000
6696,12,11,7,13,2,360000,375000,735000
6697,20,11,13,-1,1,198000,0,198000
6698,6,12,19,-1,1,216000,0,216000
6699,20,7,10,-1,2,252000,0,252000
6700,9,16,8,-1,2,237000,15000,252000
6701,18,8,7,-1,2,246000,15000,261000
6702,5,16,12,-1,1,207000,0,207000
6703,15,16,20,11,2,348000,30000,378000
6704,14,11,18,-1,2,252000,0,252000
6705,14,8,10,-1,2,252000,0,252000
6706,17,12,5,-1,1,216000,0,216000
6707,13,17,11,-1,2,207000,0,207000
6708,9,13,15,-1,2,243000,0,243000
6709,7,5,11,-1,2,252000,0,252000
6710,11,16,5,12,2,336000,90000,426000
6711,8,14,19,-1,1,216000,0,216000
6712,12,19,16,-1,2,234000,0,234000
6713,9,20,17,-1,2,252000,0,252000
6714,13,11,14,-1,2,249000,15000,264000
6715,7,12,8,-1,2,255000,15000,270000
6716,8,18,14,-1,1,180000,0,180000
6717,13,20,9,12,2,360000,135000,495000
6718,10,18,17,-1,2,228000,15000,243000
6719,8,11,15,-1,2,234000,0,234000
6720,10,11,6,-1,2,264000,15000,279000
6721,13,6,9,-1,2,225000,0,225000
6722,6,17,5,-1,2,255000,15000,270000
6723,17,8,13,-1,1,162000,0,162000
6724,11,10,13,11,2,324000,105000,429000
6725,11,19,7,-1,1,216000,0,216000
6726,11,12,8,-1,2,276000,15000,291000
6727,10,9,14,-1,2,219000,15000,234000
6728,7,12,11,-1,2,255000,15000,270000
6729,14,10,16,-1,2,198000,0,198000
6730,9,13,12,-1,2,258000,15000,273000
6731,13,10,18,11,2,360000,120000,480000
6732,16,14,8,-1,2,252000,0,252000
6733,14,12,7,-1,2,252000,0,252000
6734,19,19,5,-1,1,153000,0,153000
6735,7,15,10,-1,2,216000,0,216000
6736,20,19,8,-1,2,210000,15000,225000
6737,9,6,14,-1,2,252000,0,252000
6738,7,14,16,11,2,360000,120000,480000
6739,16,6,15,-1,2,264000,15000,279000
6740,11,9,16,-1,2,234000,0,234000
6741,14,17,20,-1,2,180000,0,180000
6742,6,8,18,-1,2,264000,15000,279000
6743,5,6,18,-1,2,264000,15000,279000
6744,9,11,17,-1,2,216000,0,216000
6745,7,6,17,13,2,372000,145000,517000
6746,11,18,15,-1,2,243000,0,243000
6747,6,17,11,-1,1,216000,0,216000
6748,16,11,19,-1,2,234000,0,234000
6749,13,15,12,-1,2,261000,30000,291000
6750,12,8,20,-1,1,207000,0,207000
6751,12,11,14,-1,2,261000,30000,291000
6752,12,10,19,13,2,348000,75000,423000
6753,20,19,13,-1,2,246000,15000,261000
6754,11,15,20,-1,1,207000,0,207000
6755,7,14,16,-1,2,264000,15000,279000
6756,20,6,14,-1,1,216000,0,216000
6757,9,14,8,-1,2,255000,15000,270000
6758,6,10,13,-1,2,243000,0,243000
6759,20,12,5,13,2,336000,75000,411000
6760,6,13,6,-1,1,216000,0,216000
6761,12,11,15,-1,2,216000,15000,231000
6762,11,15,14,-1,2,231000,15000,246000
6763,12,5,7,-1,2,252000,0,252000
6764,15,11,8,-1,2,216000,0,216000
6765,14,17,20,-1,2,180000,0,180000
6766,17,14,20,12,2,360000,105000,465000
6767,5,13,19,-1,1,216000,0,216000
6768,14,8,10,-1,2,252000,0,252000
6769,12,20,9,-1,2,216000,0,216000
6770,20,13,6,-1,1,216000,0,216000
6771,17,16,19,-1,2,207000,30000,237000
6772,8,9,14,-1,2,300000,30000,330000
6773,7,6,20,13,2,360000,155000,515000
6774,12,20,14,-1,2,234000,0,234000
6775,18,8,17,-1,2,264000,15000,279000
6776,5,6,15,-1,2,264000,15000,279000
6777,20,19,9,-1,2,192000,15000,207000
6778,7,6,18,-1,2,264000,15000,279000
6779,11,9,6,-1,2,267000,0,267000
6780,11,5,18,13,2,324000,75000,399000
6781,13,14,10,-1,2,267000,15000,282000
6782,7,16,6,-1,2,264000,15000,279000
6783,16,8,14,-1,2,207000,0,207000
6784,14,11,7,-1,2,234000,0,234000
6785,17,12,8,-1,1,189000,0,189000
6786,6,11,20,-1,1,216000,0,216000
6787,11,5,9,11,2,324000,280000,604000
6788,6,5,7,-1,2,300000,45000,345000
6789,7,8,9,-1,2,234000,30000,264000
6790,9,15,5,-1,1,189000,0,189000
6791,7,20,8,-1,2,246000,15000,261000
6792,6,5,10,-1,2,255000,15000,270000
6793,7,12,14,-1,2,207000,0,207000
6794,12,19,7,13,2,336000,75000,411000
6795,16,10,12,-1,2,252000,0,252000
6796,17,14,19,-1,2,222000,0,222000
6797,20,13,11,-1,2,243000,0,243000
6798,14,16,5,-1,2,252000,0,252000
6799,8,5,9,-1,2,276000,15000,291000
6800,5,17,15,-1,2,198000,0,198000
6801,6,11,5,13,2,360000,255000,615000
6802,11,17,7,-1,1,216000,0,216000
6803,7,10,8,-1,2,300000,45000,345000
6804,18,11,5,-1,1,198000,0,198000
6805,16,18,11,-1,2,198000,0,198000
6806,6,16,10,-1,1,216000,0,216000
6807,8,6,5,-1,2,312000,60000,372000
6808,8,7,16,12,2,348000,30000,378000
6809,15,19,18,-1,2,204000,15000,219000
6810,6,8,11,-1,2,312000,45000,357000
6811,8,5,17,-1,2,234000,0,234000
6812,7,8,6,-1,2,261000,30000,291000
6813,7,14,16,-1,2,198000,0,198000
6814,5,17,9,-1,1,207000,0,207000
6815,7,9,20,12,2,348000,140000,488000
6816,13,14,9,-1,2,276000,30000,306000
6817,6,8,17,-1,2,252000,0,252000
6818,8,11,9,-1,2,243000,30000,273000
6819,5,14,15,-1,2,237000,15000,252000
6820,18,15,19,-1,2,168000,15000,183000
6821,17,19,12,-1,2,243000,0,243000
6822,17,14,18,12,2,360000,105000,465000
6823,9,13,18,-1,1,216000,0,216000
6824,15,11,13,-1,2,222000,0,222000
6825,6,15,8,-1,2,252000,0,252000
6826,17,9,15,-1,2,198000,0,198000
6827,9,6,15,-1,2,252000,0,252000
6828,6,5,14,-1,2,255000,15000,270000
6829,8,20,6,13,2,300000,0,300000
6830,19,9,14,-1,1,216000,0,216000
6831,11,12,15,-1,2,288000,15000,303000
6832,17,19,16,-1,2,198000,30000,228000
6833,15,20,9,-1,1,216000,0,216000
6834,5,17,18,-1,2,264000,15000,279000
6835,19,12,9,-1,2,243000,0,243000
6836,17,7,12,13,2,348000,165000,513000
6837,15,20,6,-1,1,198000,0,198000
6838,8,10,6,-1,2,288000,15000,303000
6839,11,6,11,-1,1,153000,0,153000
6840,13,6,20,-1,1,162000,0,162000
6841,17,18,19,-1,2,189000,30000,219000
6842,11,9,15,-1,2,288000,15000,303000
6843,9,20,18,12,2,324000,75000,399000
6844,14,13,15,-1,2,249000,15000,264000
6845,19,18,14,-1,2,183000,15000,198000
6846,10,19,13,-1,2,252000,0,252000
6847,5,7,16,-1,2,252000,0,252000
6848,20,7,17,-1,2,225000,0,225000
6849,12,19,10,-1,2,225000,0,225000
6850,7,19,5,13,2,372000,180000,552000
6851,5,9,17,-1,2,252000,15000,267000
6852,17,13,12,-1,2,219000,15000,234000
6853,10,7,18,-1,2,252000,0,252000
6854,5,11,15,-1,1,216000,0,216000
6855,20,15,8,-1,1,207000,0,207000
6856,15,14,17,-1,2,234000,30000,264000
6857,20,17,7,12,2,360000,185000,545000
6858,14,8,12,-1,2,252000,0,252000
6859,10,20,13,-1,2,180000,0,180000
6860,13,5,16,-1,2,252000,0,252000
6861,18,6,20,-1,2,216000,0,216000
6862,15,13,16,-1,2,222000,15000,237000
6863,11,19,9,-1,2,243000,0,243000
6864,6,11,12,11,2,312000,60000,372000
6865,5,9,19,-1,1,216000,0,216000
6866,8,5,13,-1,2,252000,0,252000
6867,8,18,6,-1,2,234000,0,234000
6868,17,16,9,-1,2,210000,15000,225000
6869,5,14,19,-1,1,216000,0,216000
6870,9,16,14,-1,2,225000,0,225000
6871,19,16,18,12,2,336000,30000,366000
6872,16,5,15,-1,2,276000,30000,306000
6873,10,20,16,-1,1,198000,0,198000
6874,20,14,11,-1,2,243000,0,243000
6875,14,19,7,-1,1,216000,0,216000
6876,13,15,8,-1,2,252000,0,252000
6877,14,17,10,-1,2,216000,0,216000
6878,12,5,17,11,2,372000,265000,637000
6879,12,17,7,-1,2,252000,15000,267000
6880,16,7,9,-1,2,252000,0,252000
6881,6,12,8,-1,2,243000,0,243000
6882,17,10,13,-1,2,189000,0,189000
6883,18,17,19,-1,2,207000,30000,237000
6884,8,5,7,-1,2,324000,120000,444000
6885,19,13,18,12,2,327000,45000,372000
6886,16,5,18,-1,2,252000,0,252000
6887,17,10,15,-1,2,234000,0,234000
6888,11,8,16,-1,2,243000,0,243000
6889,10,15,13,-1,2,240000,0,240000
6890,15,18,9,-1,2,225000,0,225000
6891,7,13,18,-1,1,216000,0,216000
6892,7,11,5,12,2,384000,285000,669000
6893,10,18,20,-1,2,243000,0,243000
6894,7,8,16,-1,2,264000,15000,279000
6895,5,12,18,-1,1,207000,0,207000
6896,10,9,11,-1,2,252000,30000,282000
6897,9,15,12,-1,2,207000,0,207000
6898,6,15,20,-1,1,216000,0,216000
6899,5,13,7,12,2,372000,240000,612000
6900,12,10,20,-1,2,252000,0,252000
6901,9,20,13,-1,1,198000,0,198000
6902,15,12,16,-1,2,249000,15000,264000
6903,6,17,15,-1,2,252000,0,252000
6904,17,6,14,-1,2,243000,0,243000
6905,15,11,13,-1,2,213000,0,213000
6906,18,6,10,11,2,360000,230000,590000
6907,7,8,14,-1,2,300000,30000,330000
6908,16,18,5,-1,2,225000,0,225000
6909,9,7,18,-1,2,234000,0,234000
6910,11,5,13,-1,2,243000,0,243000
6911,19,15,11,-1,1,135000,0,135000
6912,16,8,18,-1,2,252000,0,252000
6913,8,20,11,13,2,372000,230000,602000
6914,7,10,18,-1,2,264000,15000,279000
6915,7,19,8,-1,2,264000,15000,279000
6916,13,11,14,-1,2,231000,15000,246000
6917,7,20,19,-1,2,219000,15000,234000
6918,16,9,12,-1,2,243000,0,243000
6919,11,6,15,-1,1,216000,0,216000
6920,10,6,17,11,2,372000,305000,677000
6921,11,8,17,-1,2,252000,0,252000
6922,7,8,18,-1,2,264000,15000,279000
6923,16,13,5,-1,2,252000,0,252000
6924,20,5,18,-1,2,198000,0,198000
6925,5,18,10,-1,1,216000,0,216000
6926,5,13,6,-1,2,264000,15000,279000
6927,17,16,19,12,2,336000,30000,366000
6928,13,15,7,-1,2,264000,15000,279000
6929,9,14,10,-1,2,246000,15000,261000
6930,5,7,16,-1,2,252000,0,252000
6931,19,13,15,-1,2,162000,0,162000
6932,14,11,18,-1,2,243000,0,243000
6933,8,14,17,-1,2,252000,0,252000
6934,20,10,14,12,2,360000,120000,480000
6935,20,19,17,-1,2,222000,15000,237000
6936,17,8,15,-1,2,264000,15000,279000
6937,10,17,11,-1,2,246000,15000,261000
6938,12,13,19,-1,2,219000,15000,234000
6939,8,11,6,-1,2,300000,30000,330000
6940,6,19,15,-1,1,171000,0,171000
6941,20,8,10,12,2,360000,215000,575000
6942,9,10,8,-1,2,312000,60000,372000
6943,16,10,12,-1,2,198000,0,198000
6944,5,18,12,-1,1,216000,0,216000
6945,14,15,6,-1,2,264000,15000,279000
6946,17,9,6,-1,2,234000,0,234000
6947,5,13,15,-1,2,243000,0,243000
6948,14,7,8,13,2,348000,60000,408000
6949,10,18,15,-1,2,234000,0,234000
6950,18,12,8,-1,1,216000,0,216000
6951,8,7,13,-1,2,264000,15000,279000
6952,12,16,14,-1,2,213000,0,213000
6953,17,13,17,-1,1,162000,0,162000
6954,14,18,15,-1,2,207000,15000,222000
6955,13,8,14,11,2,372000,240000,612000
6956,9,20,7,-1,1,216000,0,216000
6957,11,5,16,-1,1,216000,0,216000
6958,16,10,15,-1,2,219000,15000,234000
6959,8,15,6,-1,2,252000,0,252000
6960,7,16,6,-1,2,246000,15000,261000
6961,10,7,11,-1,2,240000,15000,255000
6962,7,14,6,13,2,360000,75000,435000
6963,10,7,12,-1,2,288000,15000,303000
6964,12,19,6,-1,1,189000,0,189000
6965,10,15,5,-1,1,216000,0,216000
6966,14,18,7,-1,1,207000,0,207000
6967,11,12,19,-1,2,228000,15000,243000
6968,5,11,17,-1,1,216000,0,216000
6969,13,10,20,12,2,360000,120000,480000
6970,12,15,7,-1,2,276000,30000,306000
6971,15,19,7,-1,1,216000,0,216000
6972,18,14,7,-1,1,216000,0,216000
6973,12,16,8,-1,1,216000,0,216000
6974,7,11,9,-1,2,288000,15000,303000
6975,18,14,12,-1,2,162000,0,162000
6976,16,12,15,12,2,324000,30000,354000
6977,17,20,11,-1,2,225000,0,225000
6978,6,20,16,-1,1,216000,0,216000
6979,6,10,17,-1,1,216000,0,216000
6980,10,8,14,-1,2,252000,0,252000
6981,15,20,17,-1,2,171000,0,171000
6982,12,5,20,-1,1,216000,0,216000
6983,11,17,19,13,2,348000,195000,543000
6984,11,13,15,-1,2,258000,0,258000
6985,12,14,5,-1,2,252000,0,252000
6986,16,6,12,-1,1,189000,0,189000
6987,7,13,6,-1,2,264000,15000,279000
6988,17,9,13,-1,1,162000,0,162000
6989,5,8,13,-1,2,288000,15000,303000
6990,13,18,15,11,2,348000,45000,393000
6991,20,10,8,-1,2,252000,0,252000
6992,20,5,12,-1,1,216000,0,216000
6993,8,15,11,-1,2,234000,0,234000
6994,12,18,9,-1,2,225000,0,225000
6995,14,15,19,-1,2,201000,15000,216000
6996,19,20,10,-1,2,264000,15000,279000
6997,15,7,20,13,2,348000,75000,423000
6998,11,6,7,-1,2,252000,0,252000
6999,10,13,5,-1,2,234000,0,234000
7000,14,17,9,-1,2,198000,0,198000
7001,13,9,10,-1,2,270000,15000,285000
7002,18,9,10,-1,2,219000,15000,234000
7003,6,15,16,-1,2,255000,15000,270000
7004,10,12,18,11,2,348000,105000,453000
7005,8,7,16,-1,2,264000,15000,279000
7006,6,13,19,-1,1,216000,0,216000
7007,11,13,20,-1,2,216000,0,216000
7008,17,9,18,-1,2,255000,15000,270000
7009,17,9,16,-1,2,237000,15000,252000
7010,12,17,9,-1,2,225000,0,225000
7011,9,7,12,11,2,372000,265000,637000
7012,14,16,7,-1,2,252000,0,252000
7013,19,15,11,-1,1,180000,0,180000
7014,6,12,5,-1,2,324000,60000,384000
7015,17,13,14,-1,2,198000,15000,213000
7016,8,6,19,-1,2,252000,0,252000
7017,14,8,20,-1,1,189000,0,189000
7018,12,6,11,13,2,360000,375000,735000
7019,6,9,7,-1,2,288000,15000,303000
7020,18,20,15,-1,2,141000,0,141000
7021,7,20,5,-1,2,264000,15000,279000
7022,20,13,15,-1,2,198000,0,198000
7023,14,20,5,-1,1,216000,0,216000
7024,8,13,16,-1,2,264000,15000,279000
7025,19,20,9,11,2,324000,90000,414000
7026,19,7,13,-1,1,216000,0,216000
7027,10,15,19,-1,1,189000,0,189000
7028,14,20,10,-1,1,216000,0,216000
7029,16,19,8,-1,2,252000,0,252000
7030,9,17,20,-1,2,243000,0,243000
7031,6,15,9,-1,2,252000,0,252000
7032,15,20,11,12,2,348000,90000,438000
7033,8,16,7,-1,2,264000,15000,279000
7034,8,9,20,-1,2,264000,15000,279000
7035,5,9,17,-1,1,216000,0,216000
7036,17,10,8,-1,2,225000,0,225000
7037,11,15,14,-1,2,222000,15000,237000
7038,13,17,6,-1,1,216000,0,216000
7039,10,13,20,11,2,372000,135000,507000
7040,16,9,12,-1,2,288000,15000,303000
7041,16,16,13,-1,2,189000,0,189000
7042,10,15,8,-1,2,207000,0,207000
7043,20,11,14,-1,2,198000,0,198000
7044,20,5,9,-1,1,216000,0,216000
7045,9,17,20,-1,2,252000,0,252000
7046,7,18,6,13,2,384000,170000,554000
7047,11,16,8,-1,2,252000,0,252000
7048,13,20,10,-1,2,234000,0,234000
7049,8,15,19,-1,1,216000,0,216000
7050,13,5,18,-1,1,216000,0,216000
7051,6,16,14,-1,2,252000,0,252000
7052,11,7,13,-1,2,234000,0,234000
7053,9,20,5,12,2,336000,215000,551000
7054,18,9,14,-1,2,252000,15000,267000
7055,11,5,12,-1,2,276000,30000,306000
7056,19,12,16,-1,2,180000,0,180000
7057,11,12,20,-1,2,255000,15000,270000
7058,10,11,17,-1,2,246000,15000,261000
7059,9,18,15,-1,2,234000,0,234000
7060,9,5,6,12,2,396000,310000,706000
7061,16,11,13,-1,2,234000,0,234000
7062,8,9,20,-1,2,264000,15000,279000
7063,10,11,8,-1,2,249000,15000,264000
7064,18,15,14,-1,2,189000,15000,204000
7065,15,13,19,-1,2,216000,0,216000
7066,16,15,9,-1,2,264000,15000,279000
7067,18,20,15,12,2,336000,30000,366000
7068,12,16,11,-1,2,234000,0,234000
7069,18,7,19,-1,2,219000,15000,234000
7070,8,12,19,-1,1,207000,0,207000
7071,8,16,17,-1,2,264000,15000,279000
7072,8,14,12,-1,2,225000,0,225000
7073,15,18,10,-1,2,207000,0,207000
7074,15,12,10,13,2,360000,150000,510000
7075,18,10,13,-1,2,252000,0,252000
7076,14,12,11,-1,2,279000,30000,309000
7077,13,19,18,-1,2,201000,15000,216000
7078,6,17,15,-1,2,252000,0,252000
7079,17,11,9,-1,2,234000,0,234000
7080,7,11,8,-1,2,279000,15000,294000
7081,18,7,14,13,2,324000,45000,369000
7082,6,20,14,-1,1,216000,0,216000
7083,8,12,6,-1,2,288000,15000,303000
7084,13,18,6,-1,1,189000,0,189000
7085,10,5,6,-1,2,300000,30000,330000
7086,18,19,11,-1,2,165000,15000,180000
7087,20,17,13,-1,2,207000,0,207000
7088,5,13,6,12,2,420000,350000,770000
7089,20,14,7,-1,1,216000,0,216000
7090,15,14,20,-1,2,237000,15000,252000
7091,18,15,20,-1,2,240000,0,240000
7092,10,20,19,-1,2,264000,15000,279000
7093,16,9,14,-1,2,243000,0,243000
7094,5,12,17,-1,1,216000,0,216000
7095,10,13,7,12,2,372000,265000,637000
7096,19,10,15,-1,1,216000,0,216000
7097,9,10,9,-1,2,255000,15000,270000
7098,6,12,18,-1,1,162000,0,162000
7099,14,16,12,-1,2,222000,0,222000
7100,10,7,13,-1,2,252000,0,252000
7101,5,16,10,-1,1,216000,0,216000
7102,15,9,14,12,2,348000,135000,483000
7103,8,6,14,-1,2,300000,30000,330000
7104,14,11,17,-1,2,189000,0,189000
7105,9,12,7,-1,2,288000,15000,303000
7106,19,7,6,-1,2,237000,15000,252000
7107,18,5,11,-1,1,198000,0,198000
7108,9,14,12,-1,2,240000,0,240000
7109,14,16,19,13,2,336000,75000,411000
7110,19,14,10,-1,1,216000,0,216000
7111,13,12,7,-1,2,288000,45000,333000
7112,8,10,7,-1,2,279000,30000,309000
7113,7,8,19,-1,2,219000,15000,234000
7114,18,20,12,-1,2,180000,0,180000
7115,18,5,7,-1,2,252000,0,252000
7116,16,13,12,11,2,360000,120000,480000
7117,12,11,10,-1,2,288000,30000,318000
7118,9,7,17,-1,2,234000,0,234000
7119,8,11,14,-1,2,216000,0,216000
7120,14,6,20,-1,1,216000,0,216000
7121,10,8,12,-1,2,258000,0,258000
7122,5,8,9,-1,2,258000,15000,273000
7123,15,18,14,11,2,318000,15000,333000
7124,11,7,17,-1,1,216000,0,216000
7125,13,9,7,-1,2,288000,15000,303000
7126,5,15,8,-1,2,234000,0,234000
7127,10,20,13,-1,2,189000,0,189000
7128,20,14,11,-1,2,225000,0,225000
7129,12,10,13,-1,2,267000,15000,282000
7130,5,16,11,13,2,336000,120000,456000
7131,13,17,9,-1,2,252000,15000,267000
7132,17,11,16,-1,2,237000,15000,252000
7133,11,19,18,-1,2,237000,15000,252000
7134,10,7,12,-1,2,288000,15000,303000
7135,7,20,9,-1,2,216000,0,216000
7136,11,19,7,-1,1,189000,0,189000
7137,16,20,10,13,2,348000,105000,453000
7138,17,6,7,-1,2,252000,0,252000
7139,19,17,20,-1,2,150000,15000,165000
7140,8,12,6,-1,2,312000,45000,357000
7141,8,6,5,-1,2,279000,30000,309000
7142,16,20,17,-1,2,144000,15000,159000
7143,10,6,7,-1,2,324000,90000,414000
7144,5,18,14,13,2,324000,45000,369000
7145,12,15,5,-1,2,264000,15000,279000
7146,17,19,12,-1,2,207000,0,207000
7147,5,14,17,-1,2,252000,0,252000
7148,9,16,7,-1,2,252000,0,252000
7149,8,19,14,-1,1,180000,0,180000
7150,16,14,18,-1,2,222000,0,222000
7151,14,16,19,13,2,348000,105000,453000
7152,12,20,19,-1,2,219000,15000,234000
7153,8,19,12,-1,1,216000,0,216000
7154,18,14,16,-1,2,222000,0,222000
7155,16,6,8,-1,2,252000,0,252000
7156,10,12,7,-1,2,267000,0,267000
7157,16,13,7,-1,2,216000,0,216000
7158,17,5,14,11,2,348000,45000,393000
7159,13,20,11,-1,2,243000,0,243000
7160,10,11,15,-1,2,246000,15000,261000
7161,9,15,5,-1,1,216000,0,216000
7162,11,7,20,-1,1,216000,0,216000
7163,11,20,14,-1,2,216000,0,216000
7164,11,8,19,-1,2,252000,0,252000
7165,8,15,12,11,2,372000,195000,567000
7166,17,7,20,-1,2,252000,0,252000
7167,17,12,16,-1,2,237000,15000,252000
7168,6,5,9,-1,2,312000,45000,357000
7169,18,19,17,-1,2,153000,30000,183000
7170,15,20,8,-1,1,216000,0,216000
7171,20,15,7,-1,1,216000,0,216000
7172,16,19,17,13,2,348000,120000,468000
7173,18,20,13,-1,2,216000,0,216000
7174,14,10,19,-1,1,216000,0,216000
7175,8,17,13,-1,2,252000,15000,267000
7176,12,6,11,-1,2,264000,15000,279000
7177,17,11,16,-1,2,201000,15000,216000
7178,11,18,5,-1,1,216000,0,216000
7179,18,10,17,11,2,372000,120000,492000
7180,19,6,17,-1,2,252000,0,252000
7181,19,7,14,-1,1,216000,0,216000
7182,16,13,14,-1,2,252000,30000,282000
7183,8,14,11,-1,2,252000,0,252000
7184,17,11,14,-1,2,207000,0,207000
7185,17,11,15,-1,2,234000,0,234000
7186,12,10,11,13,2,372000,180000,552000
7187,15,6,9,-1,2,300000,30000,330000
7188,11,12,14,-1,2,243000,30000,273000
7189,9,5,10,-1,2,276000,30000,306000
7190,7,13,15,-1,2,207000,0,207000
7191,16,11,5,-1,1,207000,0,207000
7192,18,19,13,-1,2,192000,15000,207000
7193,18,20,19,13,2,324000,45000,369000
7194,19,7,9,-1,2,252000,0,252000
7195,5,12,14,-1,2,252000,0,252000
7196,10,9,5,-1,2,255000,15000,270000
7197,7,11,5,-1,2,225000,0,225000
7198,13,15,20,-1,2,153000,0,153000
7199,9,6,16,-1,2,252000,0,252000
7200,17,13,9,12,2,360000,195000,555000
7201,17,15,8,-1,2,234000,0,234000
7202,6,12,5,-1,2,255000,15000,270000
7203,15,8,16,-1,2,210000,15000,225000
7204,20,18,18,-1,2,135000,0,135000
7205,19,10,16,-1,2,225000,0,225000
7206,5,6,10,-1,2,312000,45000,357000
7207,6,16,11,11,2,264000,0,264000
7208,17,14,5,-1,2,243000,0,243000
7209,12,5,16,-1,1,207000,0,207000
7210,16,6,20,-1,1,189000,0,189000
7211,9,7,20,-1,2,252000,0,252000
7212,20,18,16,-1,2,177000,0,177000
7213,20,9,7,-1,2,252000,0,252000
7214,12,17,6,11,2,372000,265000,637000
7215,17,11,14,-1,2,252000,0,252000
7216,7,11,8,-1,2,300000,30000,330000
7217,19,5,15,-1,1,180000,0,180000
7218,7,12,8,-1,2,264000,15000,279000
7219,12,6,9,-1,2,234000,0,234000
7220,8,13,18,-1,1,180000,0,180000
7221,19,18,8,12,2,336000,75000,411000
7222,9,6,13,-1,2,252000,15000,267000
7223,19,6,18,-1,2,201000,15000,216000
7224,19,17,12,-1,2,207000,0,207000
7225,18,12,11,-1,2,246000,15000,261000
7226,5,10,11,-1,2,276000,30000,306000
7227,8,15,6,-1,2,234000,0,234000
7228,18,20,19,13,2,306000,30000,336000
7229,5,19,11,-1,1,216000,0,216000
7230,9,15,5,-1,1,216000,0,216000
7231,5,16,9,-1,1,216000,0,216000
7232,13,16,6,-1,2,243000,0,243000
7233,12,6,20,-1,1,198000,0,198000
7234,5,14,15,-1,2,264000,15000,279000
7235,18,14,12,11,2,336000,60000,396000
7236,16,17,12,-1,2,237000,15000,252000
7237,10,13,7,-1,2,288000,15000,303000
7238,13,10,8,-1,2,216000,0,216000
7239,16,20,11,-1,1,162000,0,162000
7240,13,14,11,-1,2,276000,15000,291000
7241,19,18,13,-1,2,201000,15000,216000
7242,15,14,17,13,2,348000,165000,513000
7243,15,14,12,-1,2,231000,15000,246000
7244,13,16,11,-1,2,216000,0,216000
7245,9,16,13,-1,2,243000,0,243000
7246,18,16,11,-1,2,216000,0,216000
7247,19,12,6,-1,1,216000,0,216000
7248,8,13,10,-1,2,252000,0,252000
7249,9,12,11,13,2,348000,135000,483000
7250,13,20,16,-1,2,225000,0,225000
7251,16,8,9,-1,2,264000,15000,279000
7252,16,14,20,-1,2,198000,0,198000
7253,5,15,7,-1,2,264000,15000,279000
7254,20,11,10,-1,2,237000,15000,252000
7255,10,19,18,-1,2,237000,15000,252000
7256,18,7,19,12,2,336000,75000,411000
7257,16,10,7,-1,1,216000,0,216000
7258,20,11,12,-1,2,210000,15000,225000
7259,14,9,18,-1,1,207000,0,207000
7260,10,8,13,-1,2,288000,15000,303000
7261,19,14,13,-1,2,174000,15000,189000
7262,10,17,5,-1,2,252000,15000,267000
7263,12,18,16,13,2,348000,135000,483000
7264,8,5,15,-1,1,216000,0,216000
7265,10,7,13,-1,2,234000,0,234000
7266,10,14,17,-1,2,207000,0,207000
7267,18,19,20,-1,2,186000,30000,216000
7268,18,19,7,-1,2,228000,15000,243000
7269,20,19,14,-1,2,201000,15000,216000
7270,10,13,17,12,2,360000,240000,600000
7271,9,13,18,-1,1,198000,0,198000
7272,8,19,17,-1,2,252000,0,252000
7273,19,18,8,-1,2,228000,15000,243000
7274,15,9,19,-1,1,198000,0,198000
7275,15,9,12,-1,2,252000,0,252000
7276,16,17,12,-1,2,219000,15000,234000
7277,7,9,20,11,2,384000,270000,654000
7278,15,11,9,-1,2,288000,15000,303000
7279,9,10,14,-1,2,228000,15000,243000
7280,17,12,15,-1,2,222000,0,222000
7281,19,16,8,-1,2,252000,0,252000
7282,10,16,5,-1,1,216000,0,216000
7283,11,6,9,-1,2,276000,0,276000
7284,5,16,11,13,2,324000,90000,414000
7285,13,19,9,-1,1,216000,0,216000
7286,13,6,8,-1,2,288000,15000,303000
7287,5,14,10,-1,1,198000,0,198000
7288,8,18,5,-1,2,252000,0,252000
7289,7,20,14,-1,1,180000,0,180000
7290,19,9,18,-1,2,237000,15000,252000
7291,7,14,9,13,2,372000,240000,612000
7292,16,17,14,-1,2,240000,15000,255000
7293,18,9,14,-1,1,216000,0,216000
7294,9,7,12,-1,2,288000,15000,303000
7295,18,20,17,-1,2,162000,30000,192000
7296,9,6,20,-1,2,264000,15000,279000
7297,10,14,5,-1,2,264000,30000,294000
7298,5,10,8,12,2,372000,280000,652000
7299,6,14,8,-1,2,252000,0,252000
7300,8,13,15,-1,2,234000,0,234000
7301,12,8,14,-1,2,225000,0,225000
7302,6,16,20,-1,1,189000,0,189000
7303,17,16,14,-1,2,222000,15000,237000
7304,12,14,10,-1,2,267000,0,267000
7305,11,10,6,13,2,360000,270000,630000
7306,15,12,7,-1,2,264000,15000,279000
7307,17,7,11,-1,1,216000,0,216000
7308,19,17,6,-1,2,234000,0,234000
7309,8,11,10,-1,2,258000,15000,273000
7310,20,8,18,-1,2,189000,0,189000
7311,15,10,18,-1,2,225000,0,225000
7312,15,6,18,12,2,360000,90000,450000
7313,9,10,20,-1,2,264000,15000,279000
7314,14,16,11,-1,2,258000,0,258000
7315,11,19,14,-1,2,216000,0,216000
7316,20,9,18,-1,2,243000,0,243000
7317,9,5,7,-1,2,288000,15000,303000
7318,20,9,17,-1,2,180000,0,180000
7319,15,7,16,11,2,360000,120000,480000
7320,9,11,7,-1,2,300000,30000,330000
7321,6,10,19,-1,1,198000,0,198000
7322,13,18,19,-1,2,201000,15000,216000
7323,19,18,17,-1,2,225000,30000,255000
7324,18,8,15,-1,2,264000,15000,279000
7325,14,15,17,-1,2,243000,30000,273000
7326,19,13,17,11,2,372000,60000,432000
7327,13,14,14,-1,2,255000,15000,270000
7328,10,9,20,-1,2,201000,15000,216000
7329,16,8,13,-1,2,234000,0,234000
7330,8,15,14,-1,2,246000,15000,261000
7331,19,16,9,-1,2,216000,0,216000
7332,20,19,10,-1,2,228000,15000,243000
7333,15,11,8,12,2,372000,165000,537000
7334,19,6,8,-1,2,264000,15000,279000
7335,5,19,12,-1,1,216000,0,216000
7336,15,5,16,-1,2,264000,15000,279000
7337,7,12,7,-1,1,189000,0,189000
7338,5,10,12,-1,2,207000,0,207000
7339,19,15,8,-1,1,162000,0,162000
7340,17,7,9,11,2,384000,300000,684000
7341,17,9,12,-1,2,252000,0,252000
7342,9,17,11,-1,2,243000,0,243000
7343,6,8,11,-1,2,252000,0,252000
7344,6,7,13,-1,2,237000,15000,252000
7345,5,6,16,-1,2,246000,15000,261000
7346,18,8,15,-1,2,198000,0,198000
7347,10,14,13,12,2,348000,135000,483000
7348,20,19,5,-1,2,264000,15000,279000
7349,11,15,14,-1,2,249000,15000,264000
7350,20,9,14,-1,1,198000,0,198000
7351,19,8,12,-1,1,216000,0,216000
7352,6,5,17,-1,2,264000,15000,279000
7353,5,10,12,-1,2,252000,0,252000
7354,18,12,9,13,2,336000,60000,396000
7355,9,5,13,-1,2,288000,30000,318000
7356,10,13,18,-1,2,198000,0,198000
7357,8,18,6,-1,2,252000,0,252000
7358,6,15,13,-1,2,243000,0,243000
7359,9,8,18,-1,2,219000,15000,234000
7360,5,20,10,-1,1,216000,0,216000
7361,12,15,17,12,2,312000,0,312000
7362,8,19,10,-1,2,225000,0,225000
7363,19,9,18,-1,2,219000,15000,234000
7364,17,15,10,-1,2,225000,0,225000
7365,20,13,16,-1,2,198000,0,198000
7366,19,10,14,-1,1,216000,0,216000
7367,17,10,16,-1,2,264000,15000,279000
7368,11,7,5,12,2,384000,285000,669000
7369,16,7,8,-1,2,264000,15000,279000
7370,11,10,5,-1,2,276000,30000,306000
7371,10,17,13,-1,2,189000,0,189000
7372,8,13,10,-1,2,252000,0,252000
7373,5,14,6,-1,2,264000,15000,279000
7374,10,7,19,-1,2,207000,0,207000
7375,20,13,19,12,2,336000,45000,381000
7376,11,8,6,-1,2,312000,45000,357000
7377,19,20,10,-1,2,201000,15000,216000
7378,6,14,5,-1,2,264000,15000,279000
7379,13,18,7,-1,1,198000,0,198000
7380,20,9,16,-1,1,198000,0,198000
7381,13,12,19,-1,2,237000,15000,252000
7382,5,9,6,13,2,408000,325000,733000
7383,13,6,12,-1,2,276000,30000,306000
7384,7,14,10,-1,2,243000,0,243000
7385,12,15,17,-1,2,213000,0,213000
7386,12,20,10,-1,2,234000,0,234000
7387,17,10,6,-1,1,216000,0,216000
7388,12,19,8,-1,1,207000,0,207000
7389,5,18,10,12,2,360000,300000,660000
7390,6,7,5,-1,2,336000,120000,456000
7391,18,11,17,-1,2,192000,15000,207000
7392,9,13,12,-1,2,267000,15000,282000
7393,20,5,9,-1,1,216000,0,216000
7394,9,17,6,-1,2,243000,0,243000
7395,16,5,14,-1,2,234000,0,234000
7396,18,14,5,11,2,336000,30000,366000
7397,5,11,18,-1,1,216000,0,216000
7398,12,9,11,-1,2,276000,15000,291000
7399,8,13,19,-1,1,180000,0,180000
7400,16,15,11,-1,2,237000,15000,252000
7401,15,5,9,-1,2,252000,15000,267000
7402,6,7,9,-1,2,279000,30000,309000
7403,6,7,11,12,2,360000,90000,450000
7404,7,14,19,-1,1,216000,0,216000
7405,15,18,5,-1,2,252000,0,252000
7406,8,14,6,-1,2,243000,0,243000
7407,20,14,9,-1,1,162000,0,162000
7408,16,17,6,-1,2,264000,15000,279000
7409,16,14,6,-1,2,252000,0,252000
7410,5,13,16,11,2,336000,45000,381000
7411,16,15,17,-1,2,234000,30000,264000
7412,16,9,14,-1,2,252000,0,252000
7413,6,14,20,-1,1,216000,0,216000
7414,7,8,14,-1,2,264000,15000,279000
7415,14,19,10,-1,1,162000,0,162000
7416,7,16,17,-1,2,264000,15000,279000
7417,19,16,18,12,2,336000,45000,381000
7418,20,14,6,-1,1,207000,0,207000
7419,20,6,14,-1,1,216000,0,216000
7420,9,7,11,-1,2,267000,0,267000
7421,9,15,16,-1,2,201000,15000,216000
7422,10,18,14,-1,1,180000,0,180000
7423,17,5,20,-1,2,252000,0,252000
7424,8,11,9,12,2,384000,335000,719000
7425,17,9,12,-1,2,252000,0,252000
7426,8,20,12,-1,1,216000,0,216000
7427,20,14,12,-1,2,225000,0,225000
7428,15,12,11,-1,2,270000,15000,285000
7429,17,14,9,-1,2,225000,0,225000
7430,6,16,13,-1,2,252000,0,252000
7431,5,12,18,11,2,348000,75000,423000
7432,15,9,10,-1,2,264000,15000,279000
7433,17,13,15,-1,2,222000,0,222000
7434,5,18,15,-1,2,252000,0,252000
7435,6,10,11,-1,2,264000,15000,279000
7436,10,18,13,-1,2,189000,0,189000
7437,17,12,8,-1,1,216000,0,216000
7438,8,17,13,12,2,360000,150000,510000
7439,14,5,6,-1,2,324000,60000,384000
7440,8,17,11,-1,2,216000,0,216000
7441,16,13,11,-1,2,207000,0,207000
7442,8,15,14,-1,2,264000,15000,279000
7443,7,11,9,-1,2,258000,0,258000
7444,20,17,19,-1,2,141000,15000,156000
7445,8,20,10,12,2,384000,325000,709000
7446,9,11,10,-1,2,276000,15000,291000
7447,5,18,7,-1,2,225000,0,225000
7448,20,17,11,-1,2,171000,0,171000
7449,18,16,11,-1,2,234000,0,234000
7450,7,13,17,-1,1,216000,0,216000
7451,19,20,7,-1,2,237000,15000,252000
7452,14,20,8,11,2,372000,120000,492000
7453,17,19,8,-1,2,252000,0,252000
7454,8,18,6,-1,2,252000,0,252000
7455,8,14,11,-1,2,234000,0,234000
7456,5,12,9,-1,2,264000,15000,279000
7457,14,8,13,-1,2,219000,15000,234000
7458,9,8,5,-1,2,276000,15000,291000
7459,15,7,16,11,2,324000,30000,354000
7460,9,20,19,-1,2,246000,15000,261000
7461,18,12,5,-1,1,216000,0,216000
7462,13,17,16,-1,2,231000,15000,246000
7463,10,15,9,-1,2,264000,15000,279000
7464,6,19,20,-1,2,219000,15000,234000
7465,6,8,19,-1,2,252000,0,252000
7466,10,6,8,12,2,372000,280000,652000
7467,10,19,5,-1,1,216000,0,216000
7468,9,11,19,-1,2,243000,0,243000
7469,12,18,10,-1,2,216000,0,216000
7470,6,17,11,-1,1,216000,0,216000
7471,6,5,8,-1,2,300000,45000,345000
7472,16,19,14,-1,2,135000,0,135000
7473,6,20,12,13,2,348000,330000,678000
7474,5,18,14,-1,1,216000,0,216000
7475,20,14,18,-1,2,207000,0,207000
7476,19,9,7,-1,2,252000,0,252000
7477,19,9,17,-1,2,243000,0,243000
7478,13,6,16,-1,2,252000,0,252000
7479,20,16,7,-1,1,180000,0,180000
7480,9,15,20,11,2,372000,105000,477000
7481,19,15,18,-1,2,240000,15000,255000
7482,8,6,16,-1,2,264000,15000,279000
7483,17,13,5,-1,1,216000,0,216000
7484,17,6,7,-1,2,264000,15000,279000
7485,10,12,19,-1,2,198000,0,198000
7486,15,17,19,-1,2,204000,0,204000
7487,17,13,18,13,2,324000,30000,354000
7488,20,11,10,-1,2,264000,15000,279000
7489,16,20,7,-1,1,207000,0,207000
7490,16,17,19,-1,2,216000,30000,246000
7491,7,20,19,-1,2,264000,15000,279000
7492,16,7,11,-1,1,216000,0,216000
7493,14,6,11,-1,2,264000,15000,279000
7494,19,17,18,12,2,336000,30000,366000
7495,6,18,10,-1,2,252000,15000,267000
7496,5,20,14,-1,1,216000,0,216000
7497,13,14,20,-1,2,228000,15000,243000
7498,8,19,17,-1,2,252000,0,252000
7499,8,14,16,-1,2,243000,0,243000
7500,12,13,19,-1,2,201000,15000,216000
7501,6,14,16,13,2,348000,150000,498000
7502,7,19,18,-1,2,228000,15000,243000
7503,17,13,19,-1,2,198000,0,198000
7504,14,8,16,-1,2,252000,0,252000
7505,13,9,12,-1,2,258000,15000,273000
7506,9,12,5,-1,2,252000,0,252000
7507,7,19,18,-1,2,201000,15000,216000
7508,9,13,9,11,2,312000,90000,402000
7509,12,13,11,-1,2,252000,30000,282000
7510,6,16,20,-1,1,198000,0,198000
7511,6,8,19,-1,2,252000,0,252000
7512,17,20,20,-1,2,144000,0,144000
7513,18,9,8,-1,2,255000,15000,270000
7514,5,11,11,-1,1,189000,0,189000
7515,16,20,18,11,2,297000,0,297000
7516,7,9,13,-1,2,288000,15000,303000
7517,5,17,19,-1,2,207000,0,207000
7518,20,5,17,-1,2,225000,0,225000
7519,9,11,18,-1,2,234000,0,234000
7520,12,18,16,-1,2,198000,0,198000
7521,12,14,7,-1,2,264000,15000,279000
7522,8,11,5,12,2,372000,280000,652000
7523,6,16,12,-1,2,252000,15000,267000
7524,8,10,16,-1,2,243000,0,243000
7525,18,13,11,-1,2,198000,0,198000
7526,8,6,10,-1,2,288000,15000,303000
7527,10,6,16,-1,1,180000,0,180000
7528,14,17,16,-1,2,204000,15000,219000
7529,12,11,14,13,2,360000,210000,570000
7530,20,7,6,-1,2,252000,0,252000
7531,8,20,10,-1,2,216000,0,216000
7532,16,6,19,-1,2,225000,0,225000
7533,11,18,9,-1,2,225000,0,225000
7534,14,17,11,-1,2,207000,0,207000
7535,5,8,6,-1,2,312000,60000,372000
7536,18,15,12,11,2,327000,45000,372000
7537,19,8,15,-1,1,216000,0,216000
7538,5,6,20,-1,2,264000,15000,279000
7539,12,13,9,-1,2,249000,15000,264000
7540,13,10,9,-1,2,252000,15000,267000
7541,16,15,17,-1,2,189000,30000,219000
7542,8,13,14,-1,2,276000,30000,306000
7543,16,14,17,12,2,348000,60000,408000
7544,19,10,14,-1,1,216000,0,216000
7545,16,19,9,-1,2,252000,0,252000
7546,5,19,15,-1,1,216000,0,216000
7547,19,17,15,-1,2,222000,0,222000
7548,18,15,10,-1,2,252000,0,252000
7549,14,5,6,-1,2,264000,15000,279000
7550,8,14,18,11,2,360000,105000,465000
7551,13,9,11,-1,2,288000,15000,303000
7552,6,14,10,-1,1,198000,0,198000
7553,18,5,17,-1,2,237000,15000,252000
7554,8,13,19,-1,1,198000,0,198000
7555,20,7,13,-1,1,216000,0,216000
7556,19,11,16,-1,2,225000,0,225000
7557,6,14,15,13,2,348000,150000,498000
7558,15,16,7,-1,2,255000,15000,270000
7559,10,19,5,-1,1,207000,0,207000
7560,19,15,7,-1,1,198000,0,198000
7561,5,8,11,-1,2,288000,15000,303000
7562,14,16,11,-1,2,195000,0,195000
7563,8,12,20,-1,1,207000,0,207000
7564,18,5,17,13,2,348000,120000,468000
7565,20,18,8,-1,2,207000,0,207000
7566,17,18,20,-1,2,198000,30000,228000
7567,10,19,14,-1,2,252000,15000,267000
7568,18,5,14,-1,1,216000,0,216000
7569,13,17,5,-1,1,216000,0,216000
7570,6,19,14,-1,1,216000,0,216000
7571,14,16,19,12,2,360000,105000,465000
7572,19,8,10,-1,1,216000,0,216000
7573,15,14,7,-1,2,246000,15000,261000
7574,12,16,10,-1,2,198000,0,198000
7575,14,7,6,-1,2,264000,15000,279000
7576,17,10,18,-1,2,210000,15000,225000
7577,19,16,20,-1,2,195000,15000,210000
7578,20,14,7,11,2,372000,285000,657000
7579,14,15,5,-1,2,264000,15000,279000
7580,15,18,11,-1,2,189000,0,189000
7581,20,8,10,-1,2,252000,0,252000
7582,14,18,9,-1,1,189000,0,189000
7583,6,13,11,-1,2,264000,15000,279000
7584,14,6,8,-1,2,243000,0,243000
7585,9,11,7,12,2,348000,75000,423000
7586,8,13,19,-1,1,216000,0,216000
7587,8,10,14,-1,2,252000,0,252000
7588,9,13,7,-1,2,234000,0,234000
7589,14,15,20,-1,2,174000,15000,189000
7590,18,12,10,-1,2,252000,0,252000
7591,10,17,20,-1,2,234000,0,234000
7592,12,15,11,11,2,324000,60000,384000
7593,15,13,8,-1,2,243000,0,243000
7594,18,5,13,-1,1,216000,0,216000
7595,18,19,11,-1,2,210000,15000,225000
7596,18,14,12,-1,2,216000,0,216000
7597,8,18,7,-1,2,264000,15000,279000
7598,20,5,11,-1,1,216000,0,216000
7599,15,7,13,11,2,360000,135000,495000
7600,17,10,16,-1,2,264000,15000,279000
7601,7,8,18,-1,2,264000,15000,279000
7602,11,12,6,-1,2,246000,15000,261000
7603,7,12,17,-1,1,180000,0,180000
7604,17,13,20,-1,2,198000,0,198000
7605,12,7,20,-1,1,216000,0,216000
7606,13,11,19,13,2,324000,75000,399000
7607,8,10,7,-1,2,312000,60000,372000
7608,9,14,15,-1,2,210000,15000,225000
7609,12,20,7,-1,1,207000,0,207000
7610,14,19,9,-1,1,198000,0,198000
7611,20,10,18,-1,2,243000,0,243000
7612,15,9,17,-1,2,234000,0,234000
7613,14,8,20,11,2,360000,105000,465000
7614,6,11,11,-1,1,216000,0,216000
7615,20,14,11,-1,2,180000,0,180000
7616,7,19,13,-1,1,216000,0,216000
7617,12,14,18,-1,2,225000,0,225000
7618,19,10,17,-1,2,243000,0,243000
7619,17,9,12,-1,2,234000,0,234000
7620,18,14,10,13,2,348000,165000,513000
7621,8,17,6,-1,1,216000,0,216000
7622,18,9,16,-1,2,216000,0,216000
7623,8,11,14,-1,2,234000,0,234000
7624,6,18,11,-1,1,216000,0,216000
7625,8,10,16,-1,2,234000,0,234000
7626,7,19,20,-1,2,210000,15000,225000
7627,14,17,6,11,2,372000,235000,607000
7628,5,16,15,-1,2,264000,15000,279000
7629,16,17,6,-1,2,264000,15000,279000
7630,11,13,12,-1,2,234000,30000,264000
7631,5,6,19,-1,2,264000,15000,279000
7632,13,18,19,-1,2,174000,15000,189000
7633,6,14,7,-1,2,300000,30000,330000
7634,18,12,14,11,2,348000,75000,423000
7635,5,11,18,-1,1,216000,0,216000
7636,19,5,8,-1,2,252000,0,252000
7637,11,13,5,-1,2,252000,0,252000
7638,14,10,11,-1,2,234000,15000,249000
7639,19,5,17,-1,2,216000,0,216000
7640,17,11,9,-1,2,225000,0,225000
7641,18,12,11,13,2,360000,150000,510000
7642,19,15,10,-1,1,216000,0,216000
7643,9,20,15,-1,1,216000,0,216000
7644,11,9,16,-1,2,252000,0,252000
7645,18,17,12,-1,2,228000,15000,243000
7646,9,5,19,-1,1,216000,0,216000
7647,15,7,12,-1,2,264000,15000,279000
7648,13,20,17,12,2,348000,45000,393000
7649,8,5,9,-1,2,312000,90000,402000
7650,14,8,16,-1,2,216000,0,216000
7651,20,6,14,-1,1,207000,0,207000
7652,5,16,6,-1,2,264000,15000,279000
7653,9,12,7,-1,2,216000,0,216000
7654,19,12,14,-1,2,180000,0,180000
7655,11,15,19,13,2,348000,150000,498000
7656,10,13,15,-1,2,252000,0,252000
7657,12,7,18,-1,1,180000,0,180000
7658,18,13,16,-1,2,222000,0,222000
7659,9,20,15,-1,1,216000,0,216000
7660,11,9,17,-1,2,252000,0,252000
7661,11,18,17,-1,2,219000,15000,234000
7662,9,16,6,11,2,384000,300000,684000
7663,12,19,5,-1,1,216000,0,216000
7664,14,20,12,-1,2,243000,0,243000
7665,19,14,18,-1,2,219000,15000,234000
7666,20,6,15,-1,1,216000,0,216000
7667,19,14,11,-1,2,252000,0,252000
7668,16,11,8,-1,2,252000,0,252000
7669,9,14,12,13,2,360000,150000,510000
7670,7,15,10,-1,2,300000,30000,330000
7671,15,19,20,-1,2,183000,15000,198000
7672,10,14,12,-1,2,288000,15000,303000
7673,17,5,15,-1,2,243000,0,243000
7674,12,18,5,-1,1,207000,0,207000
7675,7,19,5,-1,2,243000,0,243000
7676,16,15,6,13,2,324000,45000,369000
7677,10,14,19,-1,1,216000,0,216000
7678,14,16,7,-1,2,252000,0,252000
7679,7,17,20,-1,2,234000,0,234000
7680,13,18,15,-1,2,198000,0,198000
7681,12,20,15,-1,2,234000,0,234000
7682,9,20,10,-1,2,264000,15000,279000
7683,12,10,18,13,2,360000,120000,480000
7684,6,8,7,-1,2,324000,90000,414000
7685,17,15,16,-1,2,180000,30000,210000
7686,15,6,14,-1,2,264000,15000,279000
7687,10,11,12,-1,2,261000,30000,291000
7688,5,6,19,-1,2,255000,15000,270000
7689,19,15,5,-1,1,180000,0,180000
7690,16,18,20,12,2,336000,30000,366000
7691,18,16,19,-1,2,201000,15000,216000
7692,7,13,17,-1,1,216000,0,216000
7693,15,13,17,-1,2,240000,0,240000
7694,16,8,11,-1,2,252000,0,252000
7695,18,10,19,-1,2,228000,15000,243000
7696,6,15,14,-1,2,264000,15000,279000
7697,13,17,11,12,2,348000,135000,483000
7698,17,20,7,-1,2,252000,0,252000
7699,18,7,20,-1,2,234000,0,234000
7700,10,11,14,-1,2,261000,15000,276000
7701,14,5,13,-1,2,264000,15000,279000
7702,7,10,15,-1,2,207000,0,207000
7703,19,14,16,-1,2,171000,0,171000
7704,15,16,14,13,2,348000,150000,498000
7705,9,16,8,-1,2,264000,15000,279000
7706,12,13,6,-1,2,255000,15000,270000
7707,6,8,9,-1,2,249000,15000,264000
7708,13,6,9,-1,2,207000,0,207000
7709,14,11,5,-1,2,243000,0,243000
7710,19,5,15,-1,1,180000,0,180000
7711,16,14,11,12,2,360000,165000,525000
7712,18,7,15,-1,2,264000,15000,279000
7713,17,16,19,-1,2,225000,30000,255000
7714,15,7,11,-1,2,264000,30000,294000
7715,10,16,9,-1,2,246000,15000,261000
7716,18,12,13,-1,2,210000,15000,225000
7717,6,18,11,-1,1,216000,0,216000
7718,16,12,5,13,2,348000,320000,668000
7719,10,20,7,-1,2,252000,0,252000
7720,9,17,8,-1,2,237000,15000,252000
7721,18,13,8,-1,1,189000,0,189000
7722,8,10,19,-1,2,252000,0,252000
7723,17,12,6,-1,1,207000,0,207000
7724,14,5,10,-1,1,216000,0,216000
7725,7,10,17,13,2,372000,170000,542000
7726,5,9,13,-1,2,288000,30000,318000
7727,16,17,11,-1,2,201000,15000,216000
7728,11,12,16,-1,2,237000,15000,252000
7729,20,13,11,-1,2,225000,0,225000
7730,6,14,9,-1,2,252000,0,252000
7731,15,17,19,-1,2,195000,0,195000
7732,17,9,19,12,2,360000,195000,555000
7733,19,13,15,-1,2,198000,0,198000
7734,10,18,7,-1,2,252000,0,252000
7735,13,15,10,-1,2,258000,0,258000
7736,19,13,9,-1,1,189000,0,189000
7737,17,10,14,-1,2,243000,0,243000
7738,6,20,8,-1,2,252000,0,252000
7739,9,5,19,11,2,348000,230000,578000
7740,13,16,19,-1,2,225000,0,225000
7741,17,13,8,-1,2,252000,15000,267000
7742,10,17,19,-1,2,234000,0,234000
7743,8,8,14,-1,1,207000,0,207000
7744,14,15,5,-1,2,210000,15000,225000
7745,16,20,14,-1,2,153000,0,153000
7746,13,10,20,12,2,360000,195000,555000
7747,7,15,12,-1,2,252000,0,252000
7748,12,8,10,-1,2,249000,0,249000
7749,6,17,20,-1,2,198000,0,198000
7750,6,15,7,-1,2,264000,15000,279000
7751,15,14,10,-1,2,210000,15000,225000
7752,17,15,6,-1,2,252000,0,252000
7753,16,17,9,12,2,348000,90000,438000
7754,11,5,18,-1,1,216000,0,216000
7755,14,15,9,-1,2,264000,15000,279000
7756,5,8,19,-1,2,252000,0,252000
7757,5,17,12,-1,1,216000,0,216000
7758,19,7,18,-1,2,219000,15000,234000
7759,5,17,15,-1,2,252000,0,252000
7760,16,13,11,13,2,300000,60000,360000
7761,16,20,5,-1,1,189000,0,189000
7762,8,5,16,-1,2,252000,0,252000
7763,11,6,10,-1,2,264000,15000,279000
7764,10,16,8,-1,2,207000,0,207000
7765,18,6,5,-1,2,264000,15000,279000
7766,8,12,9,-1,2,234000,15000,249000
7767,15,9,16,13,2,324000,45000,369000
7768,13,8,10,-1,2,288000,15000,303000
7769,17,19,5,-1,2,207000,0,207000
7770,17,7,5,-1,2,252000,0,252000
7771,13,8,5,-1,2,234000,0,234000
7772,13,7,19,-1,1,180000,0,180000
7773,15,16,20,-1,2,192000,15000,207000
7774,16,14,5,13,2,348000,345000,693000
7775,19,16,20,-1,2,213000,15000,228000
7776,17,6,7,-1,2,276000,30000,306000
7777,20,17,15,-1,2,189000,0,189000
7778,16,13,10,-1,2,288000,15000,303000
7779,14,5,10,-1,2,252000,15000,267000
7780,16,8,14,-1,2,216000,0,216000
7781,8,5,9,12,2,372000,295000,667000
7782,13,20,10,-1,2,243000,0,243000
7783,11,17,7,-1,1,216000,0,216000
7784,20,14,16,-1,2,198000,0,198000
7785,14,11,17,-1,2,252000,0,252000
7786,9,13,5,-1,2,264000,30000,294000
7787,20,16,16,-1,1,117000,0,117000
7788,5,7,15,12,2,384000,225000,609000
7789,6,19,13,-1,1,216000,0,216000
7790,7,12,5,-1,2,300000,30000,330000
7791,6,7,5,-1,2,270000,30000,300000
7792,10,17,14,-1,2,162000,0,162000
7793,17,11,16,-1,2,237000,15000,252000
7794,10,12,17,-1,2,234000,0,234000
7795,16,13,17,12,2,360000,90000,450000
7796,12,10,17,-1,2,252000,0,252000
7797,17,12,11,-1,2,237000,15000,252000
7798,17,20,15,-1,2,189000,0,189000
7799,14,18,8,-1,2,252000,15000,267000
7800,6,16,12,-1,2,252000,15000,267000
7801,12,7,17,-1,1,207000,0,207000
7802,12,7,17,11,2,360000,120000,480000
7803,15,8,10,-1,2,288000,15000,303000
7804,18,11,6,-1,1,207000,0,207000
7805,6,13,16,-1,2,252000,0,252000
7806,5,14,7,-1,2,243000,0,243000
7807,11,12,13,-1,2,207000,30000,237000
7808,11,20,10,-1,2,228000,15000,243000
7809,10,13,11,12,2,372000,210000,582000
7810,14,5,8,-1,2,300000,30000,330000
7811,8,7,10,-1,2,270000,30000,300000
7812,12,7,14,-1,2,207000,0,207000
7813,16,10,6,-1,1,198000,0,198000
7814,8,9,19,-1,2,246000,15000,261000
7815,12,11,9,-1,2,240000,15000,255000
7816,20,19,15,11,2,312000,30000,342000
7817,19,16,20,-1,2,201000,15000,216000
7818,8,13,15,-1,2,252000,0,252000
7819,9,20,14,-1,1,189000,0,189000
7820,15,19,13,-1,2,216000,0,216000
7821,18,17,9,-1,2,264000,15000,279000
7822,13,11,16,-1,2,216000,0,216000
7823,17,20,15,13,2,348000,60000,408000
7824,12,19,18,-1,2,219000,15000,234000
7825,7,8,15,-1,2,264000,15000,279000
7826,9,10,8,-1,2,252000,30000,282000
7827,13,12,17,-1,2,183000,15000,198000
7828,20,9,19,-1,2,246000,15000,261000
7829,6,11,12,-1,2,276000,30000,306000
7830,7,18,15,12,2,336000,30000,366000
7831,10,9,6,-1,2,300000,45000,345000
7832,12,10,8,-1,2,240000,0,240000
7833,7,20,13,-1,1,180000,0,180000
7834,18,12,15,-1,2,207000,0,207000
7835,16,12,14,-1,2,258000,0,258000
7836,11,20,19,-1,2,228000,15000,243000
7837,6,8,14,11,2,384000,225000,609000
7838,7,19,14,-1,1,216000,0,216000
7839,13,17,11,-1,2,243000,0,243000
7840,11,19,5,-1,1,216000,0,216000
7841,10,15,16,-1,2,246000,15000,261000
7842,6,17,18,-1,2,246000,15000,261000
7843,19,12,9,-1,2,225000,0,225000
7844,9,6,8,12,2,384000,300000,684000
7845,14,8,15,-1,2,264000,15000,279000
7846,6,10,7,-1,2,288000,15000,303000
7847,16,20,5,-1,1,153000,0,153000
7848,12,13,9,-1,2,267000,15000,282000
7849,19,18,7,-1,2,219000,15000,234000
7850,11,11,7,-1,1,207000,0,207000
7851,18,5,14,11,2,288000,0,288000
7852,14,11,20,-1,2,243000,0,243000
7853,15,8,13,-1,2,252000,0,252000
7854,5,14,18,-1,1,216000,0,216000
7855,20,11,13,-1,2,207000,0,207000
7856,8,17,19,-1,2,243000,0,243000
7857,8,17,20,-1,2,225000,0,225000
7858,13,5,15,12,2,360000,150000,510000
7859,17,5,16,-1,2,264000,15000,279000
7860,18,16,10,-1,2,234000,0,234000
7861,11,10,15,-1,2,237000,15000,252000
7862,17,6,9,-1,2,252000,0,252000
7863,5,15,13,-1,2,252000,0,252000
7864,18,19,12,-1,2,174000,15000,189000
7865,6,17,11,13,2,348000,315000,663000
7866,16,13,6,-1,2,252000,0,252000
7867,19,11,7,-1,1,189000,0,189000
7868,11,20,10,-1,2,237000,15000,252000
7869,14,9,17,-1,2,234000,0,234000
7870,5,6,7,-1,2,300000,45000,345000
7871,17,13,8,-1,1,153000,0,153000
7872,14,7,20,12,2,360000,75000,435000
7873,14,20,5,-1,1,216000,0,216000
7874,12,8,7,-1,2,324000,60000,384000
7875,6,12,7,-1,2,246000,15000,261000
7876,10,17,18,-1,2,201000,15000,216000
7877,7,19,9,-1,2,252000,0,252000
7878,8,6,9,-1,2,258000,15000,273000
7879,18,9,6,12,2,336000,15000,351000
7880,13,8,9,-1,2,264000,15000,279000
7881,13,11,9,-1,2,240000,0,240000
7882,9,16,10,-1,2,219000,15000,234000
7883,14,6,10,-1,1,216000,0,216000
7884,15,8,19,-1,1,198000,0,198000
7885,20,19,17,-1,2,195000,15000,210000
7886,17,10,8,11,2,384000,345000,729000
7887,14,17,19,-1,2,216000,0,216000
7888,20,6,17,-1,2,234000,0,234000
7889,8,20,12,-1,1,207000,0,207000
7890,5,19,8,-1,2,252000,0,252000
7891,19,8,10,-1,2,234000,0,234000
7892,13,10,20,-1,2,207000,0,207000
7893,19,20,14,12,2,336000,60000,396000
7894,17,13,20,-1,2,198000,0,198000
7895,12,19,11,-1,2,264000,15000,279000
7896,7,20,16,-1,1,216000,0,216000
7897,20,6,18,-1,2,234000,0,234000
7898,6,16,18,-1,2,243000,0,243000
7899,8,18,12,-1,1,189000,0,189000
7900,13,5,11,13,2,312000,240000,552000
7901,6,9,17,-1,2,252000,0,252000
7902,8,13,10,-1,2,234000,0,234000
7903,18,10,16,-1,2,207000,0,207000
7904,5,15,14,-1,2,264000,15000,279000
7905,16,9,11,-1,2,207000,0,207000
7906,13,10,12,-1,2,240000,15000,255000
7907,20,13,11,12,2,348000,105000,453000
7908,12,6,8,-1,2,312000,45000,357000
7909,16,18,20,-1,2,159000,0,159000
7910,18,12,15,-1,2,243000,0,243000
7911,10,13,11,-1,2,288000,30000,318000
7912,7,11,15,-1,1,198000,0,198000
7913,5,7,15,-1,2,252000,0,252000
7914,7,17,12,11,2,348000,75000,423000
7915,7,8,18,-1,2,264000,15000,279000
7916,11,15,18,-1,2,207000,0,207000
7917,13,17,15,-1,2,240000,0,240000
7918,20,19,18,-1,2,186000,30000,216000
7919,11,13,5,-1,2,252000,0,252000
7920,18,13,19,-1,2,174000,15000,189000
7921,8,20,16,13,2,348000,205000,553000
7922,14,10,13,-1,2,249000,15000,264000
7923,6,14,15,-1,2,264000,15000,279000
7924,10,20,13,-1,2,189000,0,189000
7925,10,18,7,-1,2,252000,0,252000
7926,17,7,16,-1,2,246000,15000,261000
7927,19,18,12,-1,2,201000,15000,216000
7928,14,9,16,13,2,348000,150000,498000
7929,6,12,18,-1,1,216000,0,216000
7930,8,12,13,-1,2,246000,15000,261000
7931,12,10,15,-1,2,207000,0,207000
7932,14,20,13,-1,2,210000,15000,225000
7933,6,12,9,-1,2,300000,30000,330000
7934,8,19,11,-1,2,216000,0,216000
7935,5,16,15,11,2,360000,120000,480000
7936,16,12,8,-1,2,252000,15000,267000
7937,16,10,6,-1,1,216000,0,216000
7938,12,20,11,-1,2,228000,15000,243000
7939,14,7,20,-1,1,216000,0,216000
7940,11,20,16,-1,1,189000,0,189000
7941,16,11,10,-1,2,264000,15000,279000
7942,10,8,18,11,2,372000,105000,477000
7943,6,14,13,-1,2,276000,30000,306000
7944,8,14,18,-1,1,207000,0,207000
7945,19,15,18,-1,2,213000,15000,228000
7946,12,9,17,-1,2,252000,0,252000
7947,19,5,9,-1,1,216000,0,216000
7948,19,16,5,-1,2,252000,0,252000
7949,19,6,15,12,2,360000,60000,420000
7950,16,20,13,-1,2,234000,0,234000
7951,8,12,7,-1,2,312000,45000,357000
7952,18,14,10,-1,1,162000,0,162000
7953,12,9,7,-1,2,300000,30000,330000
7954,13,11,16,-1,2,180000,0,180000
7955,12,20,5,-1,1,216000,0,216000
7956,20,13,7,11,2,372000,190000,562000
7957,16,9,10,-1,2,264000,15000,279000
7958,5,13,17,-1,1,216000,0,216000
7959,15,8,7,-1,2,264000,15000,279000
7960,18,20,6,-1,2,207000,0,207000
7961,17,7,20,-1,2,234000,0,234000
7962,20,17,14,-1,2,189000,0,189000
7963,20,17,12,11,2,372000,135000,507000
7964,18,8,20,-1,2,225000,0,225000
7965,18,13,15,-1,2,198000,0,198000
7966,7,5,15,-1,2,264000,15000,279000
7967,16,5,7,-1,2,252000,0,252000
7968,10,17,15,-1,2,189000,0,189000
7969,13,7,5,-1,2,252000,0,252000
7970,6,18,10,13,2,336000,215000,551000
7971,14,15,8,-1,2,276000,30000,306000
7972,17,10,16,-1,2,237000,15000,252000
7973,6,9,19,-1,2,252000,0,252000
7974,14,15,19,-1,2,183000,15000,198000
7975,7,17,14,-1,2,264000,15000,279000
7976,16,7,19,-1,2,252000,0,252000
7977,16,20,7,13,2,348000,45000,393000
7978,16,20,9,-1,1,216000,0,216000
7979,13,6,16,-1,2,264000,15000,279000
7980,18,11,16,-1,2,225000,0,225000
7981,18,16,10,-1,2,234000,0,234000
7982,7,15,9,-1,2,252000,0,252000
7983,6,11,16,-1,1,198000,0,198000
7984,19,9,17,11,2,336000,75000,411000
7985,10,20,14,-1,1,216000,0,216000
7986,9,6,17,-1,2,264000,15000,279000
7987,12,11,14,-1,2,270000,30000,300000
7988,19,20,13,-1,2,201000,15000,216000
7989,17,9,7,-1,2,252000,0,252000
7990,14,9,10,-1,2,246000,15000,261000
7991,6,16,8,11,2,372000,155000,527000
7992,16,14,9,-1,2,252000,0,252000
7993,13,10,11,-1,2,252000,30000,282000
7994,6,19,7,-1,2,255000,15000,270000
7995,20,7,15,-1,1,180000,0,180000
7996,14,15,7,-1,2,264000,15000,279000
7997,14,19,16,-1,2,162000,0,162000
7998,16,5,10,13,2,384000,305000,689000
7999,19,15,16,-1,2,198000,0,198000
8000,15,11,5,-1,2,252000,15000,267000
8001,19,15,7,-1,1,207000,0,207000
8002,11,17,12,-1,2,228000,15000,243000
8003,14,13,8,-1,2,264000,15000,279000
8004,12,18,13,-1,2,201000,15000,216000
8005,9,8,16,13,2,396000,240000,636000
8006,19,12,16,-1,2,243000,0,243000
8007,20,5,12,-1,1,216000,0,216000
8008,6,19,7,-1,2,264000,15000,279000
8009,17,16,10,-1,2,237000,15000,252000
8010,13,9,17,-1,1,198000,0,198000
8011,6,11,17,-1,1,216000,0,216000
8012,16,7,12,13,2,348000,320000,668000
8013,18,17,10,-1,2,237000,15000,252000
8014,12,10,8,-1,2,267000,0,267000
8015,11,20,15,-1,1,144000,0,144000
8016,9,5,16,-1,2,252000,15000,267000
8017,5,18,6,-1,2,264000,15000,279000
8018,7,18,5,-1,2,252000,0,252000
8019,20,11,16,13,2,291000,60000,351000
8020,5,20,5,-1,1,216000,0,216000
8021,15,9,6,-1,2,234000,0,234000
8022,15,8,12,-1,2,216000,0,216000
8023,13,18,19,-1,2,201000,15000,216000
8024,10,19,8,-1,2,252000,0,252000
8025,8,14,18,-1,1,207000,0,207000
8026,15,20,16,12,2,360000,45000,405000
8027,7,13,19,-1,2,252000,15000,267000
8028,19,16,11,-1,2,234000,0,234000
8029,5,18,16,-1,2,252000,0,252000
8030,19,11,17,-1,2,207000,0,207000
8031,9,11,10,-1,2,279000,30000,309000
8032,5,8,17,-1,2,243000,0,243000
8033,20,13,19,13,2,294000,15000,309000
8034,11,19,13,-1,2,207000,0,207000
8035,10,20,17,-1,2,234000,0,234000
8036,17,11,20,-1,2,225000,0,225000
8037,16,12,14,-1,2,249000,0,249000
8038,8,7,20,-1,2,264000,15000,279000
8039,9,11,7,-1,2,249000,0,249000
8040,9,19,16,13,2,324000,15000,339000
8041,8,18,13,-1,1,216000,0,216000
8042,12,8,6,-1,2,288000,15000,303000
8043,12,8,14,-1,2,207000,0,207000
8044,10,11,6,-1,2,255000,15000,270000
8045,17,15,14,-1,2,189000,30000,219000
8046,9,16,14,-1,2,252000,0,252000
8047,9,16,6,12,2,372000,170000,542000
8048,18,7,13,-1,1,216000,0,216000
8049,6,12,7,-1,2,312000,45000,357000
8050,18,15,14,-1,2,189000,15000,204000
8051,18,19,15,-1,2,222000,15000,237000
8052,16,14,13,-1,2,270000,30000,300000
8053,12,8,20,-1,1,216000,0,216000
8054,10,19,14,13,2,348000,150000,498000
8055,15,17,14,-1,2,240000,0,240000
8056,6,16,17,-1,2,246000,15000,261000
8057,14,13,19,-1,2,192000,15000,207000
8058,6,7,11,-1,2,312000,45000,357000
8059,12,5,15,-1,2,234000,0,234000
8060,12,18,16,-1,2,171000,0,171000
8061,7,6,12,12,2,348000,190000,538000
8062,9,16,5,-1,1,216000,0,216000
8063,13,16,11,-1,2,216000,0,216000
8064,13,16,15,-1,2,231000,15000,246000
8065,18,6,19,-1,2,246000,15000,261000
8066,10,5,15,-1,1,216000,0,216000
8067,17,13,19,-1,2,198000,0,198000
8068,18,15,14,13,2,348000,150000,498000
8069,15,6,8,-1,2,252000,0,252000
8070,12,14,19,-1,2,180000,0,180000
8071,7,17,18,-1,2,264000,15000,279000
8072,8,15,13,-1,2,234000,0,234000
8073,17,7,5,-1,2,252000,0,252000
8074,13,11,18,-1,2,171000,0,171000
8075,20,14,17,13,2,348000,75000,423000
8076,16,20,7,-1,1,189000,0,189000
8077,15,13,17,-1,2,231000,0,231000
8078,19,13,11,-1,2,225000,0,225000
8079,18,17,18,-1,2,183000,15000,198000
8080,18,20,13,-1,2,189000,0,189000
8081,12,11,6,-1,2,288000,45000,333000
8082,20,15,13,12,2,348000,75000,423000
8083,8,7,10,-1,2,312000,60000,372000
8084,10,8,12,-1,2,231000,0,231000
8085,6,20,11,-1,1,189000,0,189000
8086,16,15,14,-1,2,216000,30000,246000
8087,13,15,14,-1,2,252000,30000,282000
8088,9,18,16,-1,2,243000,0,243000
8089,5,10,14,12,2,348000,290000,638000
8090,9,12,16,-1,2,288000,15000,303000
8091,20,13,18,-1,2,189000,0,189000
8092,6,8,18,-1,2,252000,0,252000
8093,6,5,9,-1,2,300000,30000,330000
8094,17,5,7,-1,2,216000,0,216000
8095,10,18,15,-1,2,180000,0,180000
8096,18,13,12,11,2,372000,135000,507000
8097,7,8,11,-1,2,312000,45000,357000
8098,16,8,12,-1,1,180000,0,180000
8099,13,17,11,-1,2,225000,0,225000
8100,9,13,17,-1,1,207000,0,207000
8101,10,11,17,-1,2,255000,15000,270000
8102,13,11,6,-1,2,252000,0,252000
8103,6,16,11,12,2,348000,135000,483000
8104,5,16,20,-1,1,216000,0,216000
8105,6,12,6,-1,1,216000,0,216000
8106,12,15,20,-1,2,162000,0,162000
8107,13,6,19,-1,1,216000,0,216000
8108,11,19,9,-1,2,252000,0,252000
8109,10,14,9,-1,2,246000,15000,261000
8110,17,9,19,11,2,336000,75000,411000
8111,7,13,5,-1,2,312000,45000,357000
8112,12,20,11,-1,2,201000,15000,216000
8113,16,20,8,-1,1,216000,0,216000
8114,16,12,7,-1,1,216000,0,216000
8115,19,20,12,-1,2,228000,15000,243000
8116,9,19,10,-1,2,264000,15000,279000
8117,19,9,6,11,2,372000,230000,602000
8118,14,20,18,-1,2,216000,0,216000
8119,16,20,7,-1,1,216000,0,216000
8120,9,18,12,-1,2,252000,0,252000
8121,5,20,17,-1,2,252000,0,252000
8122,16,18,6,-1,2,243000,0,243000
8123,17,12,11,-1,2,210000,15000,225000
8124,15,18,10,13,2,348000,165000,513000
8125,20,6,18,-1,2,216000,0,216000
8126,16,11,18,-1,2,216000,0,216000
8127,15,5,6,-1,2,264000,15000,279000
8128,16,8,14,-1,2,225000,0,225000
8129,7,17,8,-1,2,246000,15000,261000
8130,19,11,18,-1,2,201000,15000,216000
8131,6,18,15,12,2,360000,90000,450000
8132,20,6,9,-1,2,264000,15000,279000
8133,14,7,13,-1,2,264000,15000,279000
8134,7,11,8,-1,2,279000,15000,294000
8135,14,20,9,-1,1,153000,0,153000
8136,11,17,16,-1,2,246000,15000,261000
8137,17,5,12,-1,1,216000,0,216000
8138,11,13,6,12,2,360000,310000,670000
8139,6,9,16,-1,1,216000,0,216000
8140,6,18,20,-1,2,207000,0,207000
8141,16,17,8,-1,2,255000,15000,270000
8142,6,18,17,-1,2,228000,15000,243000
8143,19,9,15,-1,1,189000,0,189000
8144,18,12,11,-1,2,246000,15000,261000
8145,14,20,5,11,2,372000,175000,547000
8146,14,16,8,-1,2,264000,15000,279000
8147,8,17,16,-1,2,255000,15000,270000
8148,16,7,20,-1,1,189000,0,189000
8149,10,6,18,-1,1,216000,0,216000
8150,20,16,11,-1,1,189000,0,189000
8151,13,17,15,-1,2,258000,0,258000
8152,6,5,8,11,2,408000,355000,763000
8153,13,20,16,-1,2,216000,0,216000
8154,9,15,17,-1,2,252000,0,252000
8155,19,12,6,-1,1,216000,0,216000
8156,6,9,13,-1,2,288000,15000,303000
8157,13,11,7,-1,2,216000,0,216000
8158,11,5,12,-1,2,255000,15000,270000
8159,11,12,7,13,2,336000,135000,471000
8160,17,8,9,-1,2,264000,15000,279000
8161,9,7,12,-1,2,243000,0,243000
8162,12,8,14,-1,2,216000,0,216000
8163,8,5,6,-1,2,288000,30000,318000
8164,8,18,12,-1,1,144000,0,144000
8165,18,9,15,-1,2,243000,0,243000
8166,15,7,6,12,2,384000,200000,584000
8167,5,13,12,-1,2,276000,30000,306000
8168,13,18,14,-1,2,201000,15000,216000
8169,9,11,7,-1,2,300000,30000,330000
8170,18,9,7,-1,2,216000,0,216000
8171,20,12,8,-1,1,180000,0,180000
8172,11,6,10,-1,2,276000,30000,306000
8173,12,11,6,13,2,348000,165000,513000
8174,15,11,6,-1,2,264000,30000,294000
8175,16,13,14,-1,2,225000,30000,255000
8176,15,16,13,-1,2,231000,15000,246000
8177,10,19,9,-1,2,255000,15000,270000
8178,10,9,12,-1,2,261000,30000,291000
8179,11,9,10,-1,2,243000,30000,273000
8180,16,6,20,11,2,312000,30000,342000
8181,11,5,19,-1,2,252000,15000,267000
8182,5,16,15,-1,2,264000,15000,279000
8183,8,20,5,-1,2,252000,0,252000
8184,11,10,19,-1,2,210000,15000,225000
8185,7,5,11,-1,2,288000,15000,303000
8186,11,6,15,-1,1,171000,0,171000
8187,14,11,5,12,2,360000,180000,540000
8188,16,5,12,-1,2,264000,30000,294000
8189,19,11,14,-1,2,216000,0,216000
8190,5,17,15,-1,2,252000,0,252000
8191,6,16,14,-1,2,252000,0,252000
8192,15,8,10,-1,2,207000,0,207000
8193,16,7,11,-1,1,198000,0,198000
8194,19,9,12,11,2,360000,120000,480000
8195,11,10,12,-1,2,300000,45000,345000
8196,15,13,14,-1,2,216000,30000,246000
8197,20,11,13,-1,2,225000,0,225000
8198,12,5,16,-1,1,216000,0,216000
8199,19,18,10,-1,2,246000,15000,261000
8200,13,18,12,-1,2,219000,15000,234000
8201,19,7,6,11,2,408000,245000,653000
8202,14,15,11,-1,2,267000,15000,282000
8203,13,17,11,-1,2,216000,0,216000
8204,6,7,20,-1,2,264000,15000,279000
8205,10,13,11,-1,2,243000,30000,273000
8206,15,5,19,-1,1,198000,0,198000
8207,12,16,14,-1,2,231000,0,231000
8208,13,20,11,12,2,360000,120000,480000
8209,14,6,15,-1,2,276000,30000,306000
8210,19,7,8,-1,2,264000,15000,279000
8211,7,14,19,-1,1,198000,0,198000
8212,8,17,19,-1,2,234000,0,234000
8213,10,12,17,-1,2,216000,0,216000
8214,9,17,14,-1,2,234000,0,234000
8215,20,16,5,11,2,360000,60000,420000
8216,15,12,9,-1,2,288000,15000,303000
8217,6,5,20,-1,2,255000,15000,270000
8218,16,18,11,-1,2,189000,0,189000
8219,13,16,7,-1,2,252000,0,252000
8220,7,14,8,-1,2,255000,15000,270000
8221,13,17,16,-1,2,195000,15000,210000
8222,11,20,19,13,2,336000,120000,456000
8223,15,13,14,-1,2,234000,30000,264000
8224,11,19,10,-1,2,246000,15000,261000
8225,14,5,9,-1,2,252000,15000,267000
8226,8,12,18,-1,1,180000,0,180000
8227,17,19,12,-1,2,216000,0,216000
8228,16,20,10,-1,1,207000,0,207000
8229,9,11,20,12,2,372000,245000,617000
8230,13,10,8,-1,2,252000,0,252000
8231,16,10,11,-1,2,201000,15000,216000
8232,5,16,20,-1,1,207000,0,207000
8233,9,19,10,-1,2,255000,15000,270000
8234,20,12,18,-1,2,198000,0,198000
8235,19,20,6,-1,2,246000,15000,261000
8236,16,5,12,13,2,348000,290000,638000
8237,6,8,17,-1,1,216000,0,216000
8238,20,12,13,-1,2,210000,15000,225000
8239,17,12,18,-1,2,237000,15000,252000
8240,17,15,14,-1,2,243000,30000,273000
8241,19,13,16,-1,2,216000,0,216000
8242,13,10,18,-1,2,252000,0,252000
8243,17,18,8,13,2,348000,120000,468000
8244,11,7,18,-1,1,216000,0,216000
8245,6,14,18,-1,1,216000,0,216000
8246,11,14,18,-1,2,207000,0,207000
8247,16,14,7,-1,2,252000,0,252000
8248,10,11,13,-1,2,252000,30000,282000
8249,19,19,10,-1,1,162000,0,162000
8250,11,7,12,13,2,336000,135000,471000
8251,13,5,11,-1,2,276000,30000,306000
8252,16,12,13,-1,2,225000,15000,240000
8253,17,10,6,-1,1,216000,0,216000
8254,20,7,12,-1,1,216000,0,216000
8255,20,13,18,-1,2,198000,0,198000
8256,14,15,16,-1,2,252000,30000,282000
8257,12,20,6,12,2,276000,125000,401000
8258,11,15,20,-1,1,216000,0,216000
8259,13,19,7,-1,2,252000,15000,267000
8260,17,20,6,-1,2,252000,0,252000
8261,7,20,10,-1,2,252000,0,252000
8262,10,18,7,-1,2,234000,0,234000
8263,12,8,16,-1,1,189000,0,189000
8264,20,6,5,11,2,384000,205000,589000
8265,16,15,18,-1,2,252000,30000,282000
8266,9,18,9,-1,1,216000,0,216000
8267,10,5,11,-1,2,237000,15000,252000
8268,17,10,18,-1,2,192000,15000,207000
8269,16,17,12,-1,2,219000,15000,234000
8270,9,12,6,-1,2,300000,30000,330000
8271,18,14,19,13,2,318000,45000,363000
8272,12,6,17,-1,2,252000,15000,267000
8273,10,18,14,-1,1,198000,0,198000
8274,13,6,17,-1,2,252000,15000,267000
8275,10,15,20,-1,1,189000,0,189000
8276,8,18,13,-1,1,216000,0,216000
8277,12,9,15,-1,2,288000,15000,303000
8278,9,5,11,13,2,348000,280000,628000
8279,5,16,17,-1,2,264000,15000,279000
8280,18,17,15,-1,2,204000,15000,219000
8281,11,18,11,-1,1,207000,0,207000
8282,7,8,18,-1,2,228000,15000,243000
8283,19,5,16,-1,2,216000,0,216000
8284,13,8,11,-1,2,258000,0,258000
8285,15,9,16,11,2,348000,90000,438000
8286,18,5,16,-1,2,252000,0,252000
8287,6,8,12,-1,2,252000,0,252000
8288,15,18,20,-1,2,168000,0,168000
8289,14,19,20,-1,2,237000,15000,252000
8290,16,20,15,-1,2,228000,15000,243000
8291,16,20,7,-1,1,216000,0,216000
8292,17,20,5,13,2,348000,245000,593000
8293,6,5,10,-1,2,312000,45000,357000
8294,12,5,19,-1,1,189000,0,189000
8295,18,19,15,-1,2,186000,15000,201000
8296,9,17,8,-1,2,264000,15000,279000
8297,12,8,6,-1,2,288000,15000,303000
8298,9,5,10,-1,2,237000,15000,252000
8299,11,13,15,12,2,327000,150000,477000
8300,20,10,8,-1,2,252000,0,252000
8301,10,5,19,-1,1,216000,0,216000
8302,12,7,11,-1,2,264000,15000,279000
8303,5,18,7,-1,2,243000,0,243000
8304,17,13,7,-1,1,171000,0,171000
8305,20,10,12,-1,2,225000,0,225000
8306,9,20,13,11,2,360000,120000,480000
8307,9,9,13,-1,1,216000,0,216000
8308,6,19,8,-1,2,225000,0,225000
8309,18,6,8,-1,2,225000,0,225000
8310,19,18,13,-1,2,174000,15000,189000
8311,20,11,8,-1,2,252000,0,252000
8312,9,16,13,-1,2,243000,0,243000
8313,7,6,12,11,2,396000,295000,691000
8314,15,12,17,-1,2,249000,0,249000
8315,16,13,7,-1,2,252000,0,252000
8316,16,11,9,-1,2,225000,0,225000
8317,20,11,18,-1,2,207000,0,207000
8318,18,11,5,-1,1,216000,0,216000
8319,7,17,10,-1,2,252000,0,252000
8320,14,18,5,12,2,348000,60000,408000
8321,6,19,17,-1,2,252000,0,252000
8322,7,13,10,-1,2,288000,15000,303000
8323,11,7,10,-1,2,240000,15000,255000
8324,9,13,18,-1,1,162000,0,162000
8325,8,12,5,-1,2,300000,30000,330000
8326,9,20,7,-1,2,216000,0,216000
8327,14,11,13,12,2,348000,150000,498000
8328,6,13,11,-1,2,276000,30000,306000
8329,6,19,17,-1,2,216000,0,216000
8330,9,17,14,-1,2,225000,0,225000
8331,13,20,14,-1,2,210000,15000,225000
8332,20,17,15,-1,2,207000,0,207000
8333,11,14,6,-1,2,300000,45000,345000
8334,5,13,10,11,2,360000,180000,540000
8335,11,8,13,-1,2,288000,15000,303000
8336,13,20,20,-1,1,144000,0,144000
8337,17,20,16,-1,2,189000,15000,204000
8338,7,6,17,-1,2,276000,30000,306000
8339,8,19,17,-1,2,234000,0,234000
8340,19,15,9,-1,1,189000,0,189000
8341,7,12,10,11,2,384000,310000,694000
8342,14,11,17,-1,2,288000,15000,303000
8343,5,14,9,-1,2,252000,15000,267000
8344,16,15,11,-1,2,201000,15000,216000
8345,6,15,14,-1,2,264000,15000,279000
8346,11,18,19,-1,2,210000,15000,225000
8347,5,9,20,-1,1,216000,0,216000
8348,14,17,7,12,2,360000,135000,495000
8349,10,19,20,-1,2,264000,15000,279000
8350,8,10,18,-1,2,252000,0,252000
8351,9,7,12,-1,2,243000,0,243000
8352,16,18,12,-1,2,180000,0,180000
8353,15,18,10,-1,2,243000,0,243000
8354,10,16,5,-1,1,216000,0,216000
8355,20,6,17,11,2,360000,170000,530000
8356,16,12,18,-1,2,252000,0,252000
8357,8,13,14,-1,2,264000,15000,279000
8358,8,14,9,-1,2,246000,15000,261000
8359,18,9,20,-1,2,207000,0,207000
8360,8,5,11,-1,2,288000,15000,303000
8361,7,19,16,-1,2,198000,0,198000
8362,8,17,13,11,2,360000,150000,510000
8363,9,5,13,-1,2,300000,45000,345000
8364,17,10,13,-1,2,198000,0,198000
8365,12,17,10,-1,2,234000,0,234000
8366,13,15,5,-1,2,252000,0,252000
8367,10,16,6,-1,1,198000,0,198000
8368,5,19,9,-1,1,216000,0,216000
8369,17,20,15,13,2,348000,45000,393000
8370,12,9,8,-1,2,312000,45000,357000
8371,14,10,12,-1,2,222000,0,222000
8372,14,7,9,-1,2,234000,0,234000
8373,14,9,6,-1,2,234000,0,234000
8374,20,8,18,-1,2,198000,0,198000
8375,7,5,20,-1,2,252000,0,252000
8376,19,13,12,13,2,288000,45000,333000
8377,8,6,10,-1,2,288000,15000,303000
8378,19,11,5,-1,1,180000,0,180000
8379,8,13,16,-1,2,225000,0,225000
8380,19,18,5,-1,2,228000,15000,243000
8381,7,14,12,-1,2,252000,0,252000
8382,11,6,20,-1,1,198000,0,198000
8383,20,7,6,13,2,360000,155000,515000
8384,8,7,10,-1,2,312000,60000,372000
8385,15,13,5,-1,2,243000,0,243000
8386,15,14,9,-1,2,201000,15000,216000
8387,13,10,8,-1,2,234000,0,234000
8388,17,9,7,-1,2,234000,0,234000
8389,7,18,6,-1,2,246000,15000,261000
8390,20,15,17,12,2,303000,0,303000
8391,12,13,7,-1,2,288000,45000,333000
8392,7,6,15,-1,2,264000,15000,279000
8393,14,18,12,-1,2,180000,0,180000
8394,9,7,12,-1,2,288000,15000,303000
8395,10,8,14,-1,2,207000,0,207000
8396,9,12,11,-1,2,240000,15000,255000
8397,6,7,8,11,2,372000,245000,617000
8398,15,13,11,-1,2,249000,0,249000
8399,7,20,17,-1,2,225000,0,225000
8400,16,15,7,-1,2,264000,15000,279000
8401,19,20,5,-1,2,201000,15000,216000
8402,9,6,13,-1,2,288000,15000,303000
8403,6,16,11,-1,1,189000,0,189000
8404,5,10,16,11,2,360000,275000,635000
8405,10,7,12,-1,2,300000,30000,330000
8406,13,14,18,-1,2,192000,15000,207000
8407,11,19,10,-1,2,264000,15000,279000
8408,15,20,12,-1,2,207000,0,207000
8409,11,18,20,-1,2,243000,0,243000
8410,5,12,14,-1,2,252000,0,252000
8411,8,9,10,12,2,372000,195000,567000
8412,13,10,20,-1,2,243000,0,243000
8413,18,14,5,-1,1,216000,0,216000
8414,14,7,20,-1,1,216000,0,216000
8415,17,14,10,-1,2,234000,0,234000
8416,12,20,19,-1,2,228000,15000,243000
8417,10,8,13,-1,2,288000,15000,303000
8418,7,8,16,12,2,360000,45000,405000
8419,15,14,5,-1,2,264000,15000,279000
8420,17,15,11,-1,2,198000,0,198000
8421,6,17,10,-1,1,216000,0,216000
8422,17,15,16,-1,2,225000,30000,255000
8423,19,15,13,-1,2,225000,0,225000
8424,9,20,17,-1,2,252000,0,252000
8425,15,8,5,11,2,396000,250000,646000
8426,20,9,15,-1,1,216000,0,216000
8427,20,15,17,-1,2,207000,0,207000
8428,12,18,10,-1,2,252000,0,252000
8429,16,20,13,-1,2,216000,0,216000
8430,15,16,20,-1,2,228000,15000,243000
8431,13,6,12,-1,2,288000,45000,333000
8432,13,18,13,11,2,288000,15000,303000
8433,10,8,17,-1,2,252000,0,252000
8434,14,12,17,-1,2,198000,0,198000
8435,8,14,18,-1,1,216000,0,216000
8436,6,8,20,-1,2,252000,0,252000
8437,12,14,15,-1,2,222000,15000,237000
8438,9,11,13,-1,2,258000,0,258000
8439,6,20,7,13,2,348000,30000,378000
8440,13,8,15,-1,2,264000,15000,279000
8441,17,8,9,-1,2,246000,15000,261000
8442,11,19,6,-1,1,207000,0,207000
8443,17,10,5,-1,1,216000,0,216000
8444,9,7,20,-1,2,243000,0,243000
8445,15,14,6,-1,2,246000,15000,261000
8446,17,13,6,12,2,336000,60000,396000
8447,5,14,17,-1,2,252000,0,252000
8448,9,7,17,-1,2,252000,0,252000
8449,7,5,10,-1,2,243000,0,243000
8450,20,13,6,-1,1,180000,0,180000
8451,20,5,7,-1,2,243000,0,243000
8452,12,7,20,-1,1,189000,0,189000
8453,11,7,14,12,2,360000,305000,665000
8454,5,14,7,-1,2,312000,45000,357000
8455,13,17,7,-1,1,189000,0,189000
8456,19,9,12,-1,2,234000,0,234000
8457,8,19,5,-1,2,252000,0,252000
8458,14,7,11,-1,2,234000,0,234000
8459,20,7,6,-1,2,246000,15000,261000
8460,7,6,13,12,2,372000,190000,562000
8461,5,15,7,-1,2,252000,0,252000
8462,15,14,16,-1,2,207000,30000,237000
8463,6,9,20,-1,2,252000,0,252000
8464,9,14,16,-1,2,234000,0,234000
8465,9,14,11,-1,2,225000,0,225000
8466,9,13,19,-1,1,189000,0,189000
8467,18,14,17,13,2,348000,90000,438000
8468,17,14,9,-1,2,252000,0,252000
8469,12,9,19,-1,2,207000,0,207000
8470,19,15,20,-1,2,192000,15000,207000
8471,16,8,10,-1,2,288000,15000,303000
8472,6,16,8,-1,2,252000,0,252000
8473,5,7,14,-1,2,234000,0,234000
8474,12,5,15,13,2,324000,105000,429000
8475,17,9,15,-1,2,252000,0,252000
8476,5,13,6,-1,2,264000,15000,279000
8477,20,10,9,-1,2,219000,15000,234000
8478,10,18,5,-1,1,216000,0,216000
8479,12,9,8,-1,2,270000,15000,285000
8480,20,6,5,-1,2,228000,15000,243000
8481,16,5,12,11,2,348000,105000,453000
8482,7,16,13,-1,2,252000,0,252000
8483,20,10,13,-1,2,225000,0,225000
8484,13,14,20,-1,2,219000,15000,234000
8485,16,8,19,-1,2,252000,0,252000
8486,6,13,18,-1,1,216000,0,216000
8487,10,8,12,-1,2,276000,0,276000
8488,8,7,12,11,2,360000,120000,480000
8489,19,13,5,-1,1,216000,0,216000
8490,5,6,14,-1,2,264000,15000,279000
8491,13,7,17,-1,1,198000,0,198000
8492,19,20,17,-1,2,186000,15000,201000
8493,20,13,6,-1,1,216000,0,216000
8494,14,11,5,-1,2,300000,45000,345000
8495,11,5,12,12,2,300000,60000,360000
8496,10,14,13,-1,2,249000,15000,264000
8497,14,11,17,-1,2,207000,0,207000
8498,6,15,5,-1,2,264000,15000,279000
8499,6,9,18,-1,2,252000,0,252000
8500,13,18,10,-1,2,198000,0,198000
8501,15,10,20,-1,1,198000,0,198000
8502,13,16,6,12,2,360000,265000,625000
8503,10,11,16,-1,2,252000,0,252000
8504,6,11,13,-1,2,234000,0,234000
8505,20,13,7,-1,1,180000,0,180000
8506,14,5,11,-1,2,252000,0,252000
8507,14,18,12,-1,2,189000,0,189000
8508,5,16,17,-1,2,264000,15000,279000
8509,13,5,7,11,2,372000,200000,572000
8510,14,6,5,-1,2,264000,15000,279000
8511,18,12,15,-1,2,198000,0,198000
8512,15,5,14,-1,2,264000,15000,279000
8513,14,10,5,-1,2,252000,15000,267000
8514,19,15,6,-1,1,189000,0,189000
8515,7,17,19,-1,2,234000,0,234000
8516,18,9,20,13,2,312000,30000,342000
8517,16,14,20,-1,1,180000,0,180000
8518,18,19,15,-1,2,231000,15000,246000
8519,14,16,20,-1,2,225000,0,225000
8520,15,20,18,-1,2,240000,0,240000
8521,6,16,15,-1,2,264000,15000,279000
8522,20,10,6,-1,1,216000,0,216000
8523,13,16,8,12,2,360000,150000,510000
8524,15,5,6,-1,2,288000,45000,333000
8525,17,10,20,-1,2,225000,0,225000
8526,9,14,16,-1,2,243000,0,243000
8527,14,18,19,-1,2,192000,15000,207000
8528,19,13,6,-1,1,216000,0,216000
8529,6,19,17,-1,2,252000,0,252000
8530,17,5,19,12,2,348000,90000,438000
8531,11,10,13,-1,2,267000,0,267000
8532,10,14,16,-1,2,180000,0,180000
8533,14,7,18,-1,1,216000,0,216000
8534,17,7,6,-1,2,264000,15000,279000
8535,5,8,16,-1,2,243000,0,243000
8536,9,19,14,-1,1,162000,0,162000
8537,11,14,10,13,2,372000,195000,567000
8538,12,19,9,-1,1,216000,0,216000
8539,9,17,13,-1,1,180000,0,180000
8540,16,7,11,-1,2,252000,15000,267000
8541,17,16,7,-1,2,246000,15000,261000
8542,8,12,16,-1,1,189000,0,189000
8543,7,6,19,-1,2,264000,15000,279000
8544,9,18,5,13,2,336000,155000,491000
8545,7,19,17,-1,2,252000,0,252000
8546,15,17,14,-1,2,234000,30000,264000
8547,5,11,13,-1,2,264000,15000,279000
8548,12,18,15,-1,2,189000,0,189000
8549,16,7,9,-1,2,252000,0,252000
8550,8,9,6,-1,2,288000,30000,318000
8551,16,8,19,13,2,288000,0,288000
8552,12,17,6,-1,2,252000,15000,267000
8553,6,17,18,-1,2,255000,15000,270000
8554,5,17,6,-1,2,264000,15000,279000
8555,19,11,13,-1,2,180000,0,180000
8556,8,14,12,-1,2,252000,0,252000
8557,8,18,14,-1,1,189000,0,189000
8558,9,12,16,13,2,360000,165000,525000
8559,11,20,18,-1,2,207000,0,207000
8560,17,8,18,-1,2,246000,15000,261000
8561,16,14,5,-1,2,252000,0,252000
8562,16,20,17,-1,2,171000,15000,186000
8563,18,16,8,-1,2,252000,0,252000
8564,5,9,7,-1,2,300000,30000,330000
8565,5,11,18,13,2,312000,60000,372000
8566,19,12,15,-1,2,225000,0,225000
8567,19,7,8,-1,2,264000,15000,279000
8568,16,8,12,-1,1,207000,0,207000
8569,11,9,10,-1,2,279000,30000,309000
8570,12,5,18,-1,1,207000,0,207000
8571,7,15,9,-1,2,234000,0,234000
8572,5,19,18,11,2,324000,30000,354000
8573,14,19,12,-1,2,252000,0,252000
8574,16,14,5,-1,2,252000,0,252000
8575,14,5,6,-1,2,264000,15000,279000
8576,14,20,19,-1,2,165000,15000,180000
8577,15,13,6,-1,2,264000,15000,279000
8578,18,5,13,-1,1,216000,0,216000
8579,14,7,16,11,2,360000,120000,480000
8580,12,18,9,-1,2,252000,0,252000
8581,15,5,17,-1,2,252000,0,252000
8582,10,20,18,-1,2,216000,0,216000
8583,14,8,17,-1,2,243000,0,243000
8584,17,6,19,-1,2,225000,0,225000
8585,16,20,12,-1,1,162000,0,162000
8586,11,18,15,12,2,360000,210000,570000
8587,7,16,6,-1,2,264000,15000,279000
8588,17,15,10,-1,2,216000,0,216000
8589,15,8,9,-1,2,255000,15000,270000
8590,13,16,7,-1,2,234000,0,234000
8591,19,13,11,-1,2,198000,0,198000
8592,18,5,14,-1,1,216000,0,216000
8593,6,16,9,12,2,384000,210000,594000
8594,18,7,13,-1,2,252000,15000,267000
8595,11,10,19,-1,2,246000,15000,261000
8596,6,7,14,-1,2,264000,15000,279000
8597,19,11,6,-1,1,198000,0,198000
8598,19,11,13,-1,2,207000,0,207000
8599,6,19,14,-1,1,216000,0,216000
8600,11,10,17,13,2,372000,150000,522000
8601,8,18,5,-1,2,276000,30000,306000
8602,12,16,15,-1,2,240000,15000,255000
8603,10,8,7,-1,2,300000,45000,345000
8604,17,6,9,-1,2,216000,0,216000
8605,16,19,18,-1,2,168000,15000,183000
8606,20,17,16,-1,2,243000,15000,258000
8607,8,20,19,13,2,336000,230000,566000
8608,8,10,6,-1,2,300000,30000,330000
8609,13,6,20,-1,1,180000,0,180000
8610,14,8,9,-1,2,246000,15000,261000
8611,9,18,14,-1,1,180000,0,180000
8612,7,8,10,-1,2,300000,45000,345000
8613,11,17,20,-1,2,180000,0,180000
8614,7,10,17,12,2,384000,300000,684000
8615,16,10,8,-1,2,288000,15000,303000
8616,13,6,12,-1,2,264000,15000,279000
8617,11,16,8,-1,2,207000,0,207000
8618,11,19,17,-1,2,207000,0,207000
8619,16,14,9,-1,2,243000,0,243000
8620,14,12,10,-1,2,240000,0,240000
8621,7,17,20,12,2,312000,30000,342000
8622,13,19,11,-1,1,207000,0,207000
8623,13,19,12,-1,2,219000,15000,234000
8624,19,14,20,-1,2,219000,15000,234000
8625,7,12,17,-1,2,252000,15000,267000
8626,8,20,15,-1,1,216000,0,216000
8627,19,7,9,-1,2,252000,0,252000
8628,17,13,8,11,2,360000,150000,510000
8629,12,14,16,-1,2,258000,0,258000
8630,10,6,20,-1,1,216000,0,216000
8631,9,13,18,-1,1,198000,0,198000
8632,11,7,10,-1,2,288000,30000,318000
8633,13,20,7,-1,1,189000,0,189000
8634,10,18,10,-1,1,189000,0,189000
8635,12,18,16,11,2,327000,30000,357000
8636,16,12,17,-1,2,237000,15000,252000
8637,16,6,14,-1,2,252000,0,252000
8638,8,7,15,-1,2,255000,15000,270000
8639,15,19,6,-1,1,189000,0,189000
8640,16,12,5,-1,1,216000,0,216000
8641,16,6,19,-1,2,243000,0,243000
8642,9,17,7,12,2,372000,155000,527000
8643,18,5,8,-1,2,252000,0,252000
8644,17,15,11,-1,2,216000,0,216000
8645,16,16,10,-1,1,198000,0,198000
8646,9,14,5,-1,1,189000,0,189000
8647,12,15,17,-1,2,213000,0,213000
8648,10,9,16,-1,2,255000,15000,270000
8649,17,8,14,13,2,348000,120000,468000
8650,13,20,6,-1,1,216000,0,216000
8651,16,12,15,-1,2,267000,15000,282000
8652,6,10,14,-1,2,252000,15000,267000
8653,7,12,15,-1,2,234000,0,234000
8654,14,7,18,-1,1,198000,0,198000
8655,5,10,16,-1,1,216000,0,216000
8656,17,5,15,11,2,360000,90000,450000
8657,16,14,15,-1,2,261000,30000,291000
8658,11,12,9,-1,2,276000,15000,291000
8659,19,16,11,-1,2,189000,0,189000
8660,8,14,7,-1,2,264000,15000,279000
8661,20,5,11,-1,1,216000,0,216000
8662,6,18,7,-1,2,264000,15000,279000
8663,10,6,18,13,2,336000,105000,441000
8664,11,19,14,-1,2,243000,0,243000
8665,7,15,6,-1,2,264000,15000,279000
8666,5,19,11,-1,1,216000,0,216000
8667,15,9,16,-1,2,237000,15000,252000
8668,9,19,10,-1,2,237000,15000,252000
8669,19,20,13,-1,2,201000,15000,216000
8670,18,12,14,13,2,348000,180000,528000
8671,14,12,18,-1,2,216000,0,216000
8672,12,20,7,-1,1,216000,0,216000
8673,11,18,10,-1,2,255000,15000,270000
8674,16,9,11,-1,2,234000,0,234000
8675,16,8,12,-1,1,198000,0,198000
8676,9,16,12,-1,2,243000,0,243000
8677,16,13,15,11,2,360000,75000,435000
8678,10,9,11,-1,2,300000,45000,345000
8679,10,5,20,-1,1,216000,0,216000
8680,7,15,10,-1,2,234000,0,234000
8681,13,16,10,-1,2,207000,0,207000
8682,12,15,8,-1,2,252000,0,252000
8683,19,13,7,-1,1,207000,0,207000
8684,14,5,8,13,2,372000,240000,612000
8685,6,10,14,-1,2,288000,30000,318000
8686,16,19,6,-1,2,225000,0,225000
8687,16,13,17,-1,2,213000,15000,228000
8688,18,8,6,-1,2,252000,0,252000
8689,19,6,10,-1,1,216000,0,216000
8690,13,9,12,-1,2,249000,15000,264000
8691,11,20,17,12,2,348000,60000,408000
8692,11,15,8,-1,2,288000,15000,303000
8693,6,13,12,-1,2,264000,15000,279000
8694,17,15,20,-1,2,144000,0,144000
8695,19,18,5,-1,2,264000,15000,279000
8696,19,20,18,-1,2,195000,30000,225000
8697,6,10,15,-1,1,216000,0,216000
8698,17,19,18,13,2,336000,45000,381000
8699,19,13,5,-1,1,216000,0,216000
8700,17,18,20,-1,2,180000,30000,210000
8701,14,20,8,-1,1,216000,0,216000
8702,6,14,7,-1,2,312000,45000,357000
8703,15,6,16,-1,2,246000,15000,261000
8704,7,10,8,-1,2,261000,30000,291000
8705,13,6,11,12,2,336000,120000,456000
8706,10,7,13,-1,2,288000,15000,303000
8707,11,12,15,-1,2,225000,15000,240000
8708,17,15,6,-1,2,243000,0,243000
8709,19,15,10,-1,1,162000,0,162000
8710,14,16,13,-1,2,261000,30000,291000
8711,17,15,18,-1,2,213000,15000,228000
8712,14,13,6,12,2,360000,255000,615000
8713,12,17,19,-1,2,225000,0,225000
8714,6,20,11,-1,1,216000,0,216000
8715,17,7,12,-1,1,207000,0,207000
8716,15,13,14,-1,2,234000,30000,264000
8717,20,10,8,-1,2,252000,0,252000
8718,10,20,13,-1,2,207000,0,207000
8719,15,11,17,13,2,348000,165000,513000
8720,9,13,6,-1,1,216000,0,216000
8721,5,10,15,-1,1,216000,0,216000
8722,15,19,6,-1,1,198000,0,198000
8723,19,20,8,-1,2,228000,15000,243000
8724,17,6,20,-1,2,243000,0,243000
8725,15,6,18,-1,2,252000,0,252000
8726,19,6,9,12,2,360000,165000,525000
8727,15,13,12,-1,2,270000,30000,300000
8728,11,7,17,-1,1,216000,0,216000
8729,19,8,16,-1,2,243000,0,243000
8730,5,6,19,-1,2,264000,15000,279000
8731,20,19,14,-1,2,165000,15000,180000
8732,6,20,15,-1,1,216000,0,216000
8733,16,13,14,12,2,360000,195000,555000
8734,14,11,9,-1,2,234000,0,234000
8735,13,5,9,-1,2,252000,15000,267000
8736,10,9,18,-1,2,210000,15000,225000
8737,14,10,13,-1,2,240000,15000,255000
8738,16,17,9,-1,2,237000,15000,252000
8739,15,6,8,-1,2,252000,0,252000
8740,18,7,19,11,2,324000,30000,354000
8741,11,19,8,-1,2,252000,0,252000
8742,11,10,16,-1,2,255000,15000,270000
8743,18,6,19,-1,2,237000,15000,252000
8744,12,13,20,-1,2,219000,15000,234000
8745,16,20,18,-1,2,213000,0,213000
8746,16,15,5,-1,2,264000,15000,279000
8747,14,10,7,13,2,384000,280000,664000
8748,6,12,14,-1,2,276000,30000,306000
8749,18,7,19,-1,2,228000,15000,243000
8750,13,9,7,-1,2,252000,0,252000
8751,14,16,17,-1,2,186000,15000,201000
8752,14,9,8,-1,2,264000,15000,279000
8753,15,12,19,-1,2,198000,0,198000
8754,10,13,18,11,2,372000,210000,582000
8755,20,6,11,-1,1,216000,0,216000
8756,14,13,17,-1,2,225000,15000,240000
8757,9,14,16,-1,2,243000,0,243000
8758,19,20,6,-1,2,219000,15000,234000
8759,10,14,8,-1,2,252000,0,252000
8760,11,14,10,-1,2,243000,15000,258000
8761,6,13,8,11,2,372000,200000,572000
8762,10,11,17,-1,2,246000,15000,261000
8763,16,20,7,-1,1,207000,0,207000
8764,14,8,20,-1,1,216000,0,216000
8765,5,13,12,-1,2,264000,15000,279000
8766,14,12,5,-1,2,252000,0,252000
8767,9,19,18,-1,2,192000,15000,207000
8768,13,14,18,11,2,360000,60000,420000
8769,5,11,6,-1,2,324000,60000,384000
8770,20,15,10,-1,1,153000,0,153000
8771,6,7,11,-1,2,312000,45000,357000
8772,10,20,6,-1,1,189000,0,189000
8773,16,20,18,-1,2,186000,0,186000
8774,7,9,8,-1,2,312000,60000,372000
8775,10,6,9,12,2,360000,230000,590000
8776,18,19,17,-1,2,216000,30000,246000
8777,19,13,14,-1,2,255000,15000,270000
8778,13,9,12,-1,2,288000,30000,318000
8779,14,7,9,-1,2,234000,0,234000
8780,6,9,16,-1,2,234000,0,234000
8781,13,8,9,-1,2,228000,15000,243000
8782,17,15,10,13,2,348000,135000,483000
8783,17,13,11,-1,2,252000,0,252000
8784,17,16,13,-1,2,231000,15000,246000
8785,9,13,15,-1,2,252000,0,252000
8786,9,14,15,-1,2,237000,15000,252000
8787,9,8,16,-1,2,246000,15000,261000
8788,15,8,12,-1,2,225000,0,225000
8789,16,20,17,11,2,348000,30000,378000
8790,9,7,12,-1,2,312000,45000,357000
8791,15,5,16,-1,2,237000,15000,252000
8792,10,13,14,-1,2,222000,15000,237000
8793,15,18,20,-1,2,195000,0,195000
8794,7,11,20,-1,1,216000,0,216000
8795,12,17,9,-1,2,252000,0,252000
8796,11,20,19,12,2,348000,120000,468000
8797,13,19,6,-1,1,216000,0,216000
8798,14,17,12,-1,2,207000,0,207000
8799,15,8,16,-1,2,264000,15000,279000
8800,9,8,5,-1,2,288000,30000,318000
8801,7,12,6,-1,2,219000,15000,234000
8802,6,11,9,-1,2,249000,0,249000
8803,13,11,10,12,2,336000,150000,486000
8804,7,6,10,-1,2,312000,45000,357000
8805,10,9,19,-1,2,201000,15000,216000
8806,13,15,17,-1,2,213000,0,213000
8807,14,18,7,-1,1,216000,0,216000
8808,18,15,16,-1,2,225000,30000,255000
8809,18,6,15,-1,2,252000,0,252000
8810,11,8,12,13,2,372000,320000,692000
8811,5,9,17,-1,2,264000,30000,294000
8812,12,14,6,-1,2,252000,0,252000
8813,18,6,15,-1,2,234000,0,234000
8814,8,5,14,-1,2,252000,0,252000
8815,13,10,7,-1,2,216000,0,216000
8816,16,11,8,-1,2,225000,0,225000
8817,17,5,9,13,2,348000,210000,558000
8818,13,7,14,-1,2,276000,30000,306000
8819,18,7,16,-1,2,243000,0,243000
8820,15,17,15,-1,2,162000,0,162000
8821,19,11,16,-1,2,189000,0,189000
8822,9,11,15,-1,2,252000,0,252000
8823,8,10,14,-1,2,234000,0,234000
8824,9,12,15,12,2,300000,60000,360000
8825,12,15,5,-1,2,252000,0,252000
8826,6,14,16,-1,2,243000,0,243000
8827,5,13,12,-1,2,246000,15000,261000
8828,17,6,14,-1,2,216000,0,216000
8829,14,13,12,-1,2,216000,30000,246000
8830,20,15,12,-1,2,207000,0,207000
8831,19,7,8,12,2,408000,220000,628000
8832,15,12,16,-1,2,267000,15000,282000
8833,14,19,6,-1,1,216000,0,216000
8834,13,12,20,-1,2,228000,15000,243000
8835,7,20,8,-1,2,264000,15000,279000
8836,10,14,9,-1,2,237000,15000,252000
8837,8,9,17,-1,2,246000,15000,261000
8838,5,19,17,12,2,324000,30000,354000
8839,6,17,19,-1,2,252000,0,252000
8840,20,20,16,-1,1,153000,0,153000
8841,20,16,14,-1,2,198000,0,198000
8842,13,5,15,-1,2,264000,15000,279000
8843,13,20,8,-1,1,207000,0,207000
8844,12,11,20,-1,2,237000,15000,252000
8845,5,17,16,12,2,360000,120000,480000
8846,6,14,17,-1,2,264000,15000,279000
8847,5,10,6,-1,2,312000,45000,357000
8848,10,11,19,-1,2,192000,15000,207000
8849,20,18,12,-1,2,207000,0,207000
8850,11,14,9,-1,2,252000,0,252000
8851,13,10,14,-1,2,240000,15000,255000
8852,18,10,8,11,2,360000,90000,450000
8853,19,20,18,-1,2,204000,30000,234000
8854,14,7,19,-1,1,216000,0,216000
8855,16,12,14,-1,2,222000,0,222000
8856,10,7,14,-1,2,252000,0,252000
8857,7,10,20,-1,2,234000,0,234000
8858,14,7,12,-1,2,234000,0,234000
8859,15,8,20,12,2,324000,15000,339000
8860,10,8,15,-1,2,288000,15000,303000
8861,17,15,20,-1,2,162000,0,162000
8862,11,6,8,-1,2,312000,45000,357000
8863,6,12,17,-1,1,198000,0,198000
8864,7,15,9,-1,2,243000,0,243000
8865,5,15,7,-1,2,243000,0,243000
8866,13,5,10,12,2,324000,105000,429000
8867,12,8,20,-1,1,216000,0,216000
8868,18,8,11,-1,2,252000,0,252000
8869,6,13,9,-1,2,252000,0,252000
8870,18,6,19,-1,2,219000,15000,234000
8871,20,11,10,-1,2,237000,15000,252000
8872,17,19,5,-1,2,234000,0,234000
8873,8,5,18,13,2,372000,155000,527000
8874,17,20,14,-1,2,216000,0,216000
8875,16,20,12,-1,1,216000,0,216000
8876,7,9,6,-1,2,324000,105000,429000
8877,6,13,9,-1,2,234000,0,234000
8878,13,5,18,-1,1,207000,0,207000
8879,6,8,6,-1,2,198000,0,198000
8880,12,16,7,13,2,312000,75000,387000
8881,7,12,10,-1,2,288000,15000,303000
8882,14,8,18,-1,1,180000,0,180000
8883,14,10,19,-1,1,198000,0,198000
8884,7,15,13,-1,2,264000,15000,279000
8885,8,13,14,-1,2,246000,15000,261000
8886,14,18,16,-1,2,195000,0,195000
8887,8,9,7,11,2,396000,405000,801000
8888,9,18,10,-1,2,264000,15000,279000
8889,16,14,10,-1,2,234000,0,234000
8890,11,19,17,-1,2,216000,0,216000
8891,16,11,13,-1,2,225000,0,225000
8892,9,13,12,-1,2,267000,15000,282000
8893,8,5,19,-1,2,252000,0,252000
8894,12,19,6,12,2,264000,0,264000
8895,14,6,9,-1,2,252000,0,252000
8896,13,20,11,-1,2,198000,0,198000
8897,16,19,11,-1,2,225000,0,225000
8898,6,9,5,-1,2,312000,45000,357000
8899,18,16,13,-1,2,177000,0,177000
8900,18,12,9,-1,2,252000,0,252000
8901,15,19,12,11,2,360000,75000,435000
8902,17,16,15,-1,2,252000,30000,282000
8903,20,11,8,-1,2,252000,0,252000
8904,10,6,17,-1,1,216000,0,216000
8905,13,14,15,-1,2,243000,30000,273000
8906,8,18,6,-1,2,252000,0,252000
8907,11,17,12,-1,2,210000,15000,225000
8908,11,16,10,12,2,372000,195000,567000
8909,13,9,19,-1,2,252000,15000,267000
8910,11,10,8,-1,2,288000,30000,318000
8911,16,12,8,-1,1,171000,0,171000
8912,11,19,13,-1,2,225000,0,225000
8913,6,19,13,-1,1,216000,0,216000
8914,16,8,17,-1,2,264000,15000,279000
8915,20,19,11,13,2,324000,75000,399000
8916,16,8,14,-1,2,243000,0,243000
8917,11,9,17,-1,2,198000,0,198000
8918,15,19,6,-1,1,207000,0,207000
8919,7,8,13,-1,2,264000,15000,279000
8920,16,17,16,-1,2,156000,15000,171000
8921,13,15,19,-1,2,180000,0,180000
8922,9,18,19,11,2,360000,135000,495000
8923,9,7,14,-1,1,216000,0,216000
8924,10,15,19,-1,1,180000,0,180000
8925,9,18,13,-1,1,216000,0,216000
8926,15,14,11,-1,2,267000,15000,282000
8927,12,7,14,-1,2,252000,0,252000
8928,6,14,11,-1,2,234000,0,234000
8929,11,6,8,12,2,360000,240000,600000
8930,9,17,13,-1,1,216000,0,216000
8931,10,9,18,-1,2,264000,15000,279000
8932,7,8,20,-1,2,255000,15000,270000
8933,15,12,7,-1,2,225000,0,225000
8934,17,13,7,-1,1,198000,0,198000
8935,5,17,14,-1,2,252000,0,252000
8936,11,18,6,13,2,336000,105000,441000
8937,7,20,15,-1,1,216000,0,216000
8938,19,17,20,-1,2,222000,15000,237000
8939,6,7,8,-1,2,324000,90000,414000
8940,13,17,19,-1,2,171000,0,171000
8941,11,19,14,-1,2,243000,0,243000
8942,19,18,17,-1,2,216000,30000,246000
8943,12,7,8,12,2,372000,310000,682000
8944,20,11,6,-1,1,216000,0,216000
8945,7,10,9,-1,2,288000,30000,318000
8946,11,9,18,-1,2,189000,0,189000
8947,6,5,8,-1,2,300000,45000,345000
8948,13,9,17,-1,1,135000,0,135000
8949,12,6,5,-1,2,300000,30000,330000
8950,20,10,5,12,2,324000,75000,399000
8951,17,13,12,-1,2,246000,15000,261000
8952,18,7,16,-1,2,252000,0,252000
8953,13,17,11,-1,2,207000,0,207000
8954,17,11,12,-1,2,237000,15000,252000
8955,7,5,6,-1,2,312000,60000,372000
8956,19,16,10,-1,2,171000,0,171000
8957,18,12,15,12,2,288000,0,288000
8958,8,20,17,-1,2,252000,0,252000
8959,7,12,10,-1,2,288000,15000,303000
8960,9,6,18,-1,2,225000,0,225000
8961,19,6,20,-1,2,201000,15000,216000
8962,17,9,7,-1,2,252000,0,252000
8963,5,14,12,-1,2,252000,0,252000
8964,12,18,13,12,2,270000,30000,300000
8965,10,8,16,-1,2,234000,0,234000
8966,8,17,16,-1,2,237000,15000,252000
8967,18,5,12,-1,1,216000,0,216000
8968,10,6,7,-1,2,279000,15000,294000
8969,9,20,11,-1,2,180000,0,180000
8970,16,15,6,-1,2,255000,15000,270000
8971,9,12,15,13,2,348000,120000,468000
8972,14,6,9,-1,2,288000,15000,303000
8973,15,7,8,-1,2,246000,15000,261000
8974,9,18,14,-1,1,171000,0,171000
8975,9,17,19,-1,2,252000,0,252000
8976,10,12,13,-1,2,240000,15000,255000
8977,6,8,12,-1,2,243000,0,243000
8978,12,20,5,13,2,324000,60000,384000
8979,6,9,18,-1,2,264000,15000,279000
8980,13,8,6,-1,2,252000,0,252000
8981,15,6,10,-1,1,207000,0,207000
8982,20,6,12,-1,1,216000,0,216000
8983,14,7,17,-1,2,243000,0,243000
8984,20,18,15,-1,2,186000,0,186000
8985,5,13,17,11,2,372000,290000,662000
8986,11,8,17,-1,1,216000,0,216000
8987,17,7,11,-1,1,207000,0,207000
8988,7,20,13,-1,1,216000,0,216000
8989,15,20,16,-1,2,192000,15000,207000
8990,6,10,19,-1,2,252000,15000,267000
8991,13,14,11,-1,2,258000,15000,273000
8992,14,11,15,11,2,312000,15000,327000
8993,9,17,5,-1,1,216000,0,216000
8994,13,14,17,-1,2,225000,15000,240000
8995,15,18,9,-1,2,243000,0,243000
8996,20,11,18,-1,2,216000,0,216000
8997,14,7,6,-1,2,264000,15000,279000
8998,13,8,12,-1,2,237000,15000,252000
8999,10,19,12,13,2,348000,75000,423000
9000,5,13,19,-1,1,216000,0,216000
9001,5,17,18,-1,2,264000,15000,279000
9002,5,15,10,-1,1,216000,0,216000
9003,13,8,5,-1,2,252000,0,252000
9004,9,19,11,-1,2,216000,0,216000
9005,10,20,17,-1,2,216000,0,216000
9006,20,8,17,13,2,348000,60000,408000
9007,12,13,20,-1,2,225000,0,225000
9008,16,9,6,-1,2,252000,0,252000
9009,8,18,7,-1,2,237000,15000,252000
9010,11,6,8,-1,2,234000,0,234000
9011,16,17,15,-1,2,180000,30000,210000
9012,13,12,16,-1,2,270000,15000,285000
9013,18,16,20,11,2,336000,30000,366000
9014,9,10,19,-1,2,252000,0,252000
9015,5,9,11,-1,2,234000,0,234000
9016,6,12,5,-1,2,237000,15000,252000
9017,15,6,9,-1,2,216000,0,216000
9018,16,7,19,-1,2,216000,0,216000
9019,5,19,10,-1,1,216000,0,216000
9020,11,10,19,13,2,360000,90000,450000
9021,7,8,11,-1,2,312000,45000,357000
9022,17,15,8,-1,2,216000,0,216000
9023,7,15,10,-1,2,234000,0,234000
9024,20,14,13,-1,2,192000,15000,207000
9025,17,11,19,-1,2,243000,0,243000
9026,16,15,5,-1,2,264000,15000,279000
9027,7,11,18,12,2,348000,90000,438000
9028,13,10,5,-1,2,300000,45000,345000
9029,17,9,15,-1,2,207000,0,207000
9030,20,10,6,-1,1,216000,0,216000
9031,6,16,7,-1,2,264000,15000,279000
9032,11,13,10,-1,2,225000,30000,255000
9033,19,9,10,-1,2,228000,15000,243000
9034,17,12,5,13,2,348000,135000,483000
9035,8,19,13,-1,2,252000,15000,267000
9036,18,7,5,-1,2,252000,0,252000
9037,9,5,8,-1,2,288000,30000,318000
9038,16,8,5,-1,2,216000,0,216000
9039,11,9,13,-1,2,222000,0,222000
9040,5,19,16,-1,2,216000,0,216000
9041,18,11,6,13,2,348000,260000,608000
9042,13,18,7,-1,2,252000,15000,267000
9043,11,14,15,-1,2,249000,15000,264000
9044,9,5,11,-1,2,264000,15000,279000
9045,17,13,14,-1,2,198000,15000,213000
9046,10,8,16,-1,2,252000,0,252000
9047,17,20,18,-1,2,180000,30000,210000
9048,13,7,11,12,2,372000,435000,807000
9049,7,8,19,-1,2,264000,15000,279000
9050,18,10,15,-1,2,198000,0,198000
9051,15,8,14,-1,2,264000,15000,279000
9052,20,17,11,-1,2,198000,0,198000
9053,18,10,8,-1,2,252000,0,252000
9054,5,10,14,-1,1,216000,0,216000
9055,17,15,7,11,2,360000,90000,450000
9056,7,16,17,-1,2,264000,15000,279000
9057,5,13,6,-1,2,264000,15000,279000
9058,16,6,7,-1,2,246000,15000,261000
9059,20,6,14,-1,1,189000,0,189000
9060,12,14,10,-1,2,240000,0,240000
9061,11,9,12,-1,2,240000,15000,255000
9062,10,5,8,11,2,372000,255000,627000
9063,13,5,9,-1,2,264000,30000,294000
9064,19,14,13,-1,2,183000,15000,198000
9065,12,15,8,-1,2,264000,15000,279000
9066,18,5,13,-1,1,216000,0,216000
9067,10,7,6,-1,2,300000,30000,330000
9068,13,19,20,-1,2,156000,15000,171000
9069,17,12,6,11,2,372000,330000,702000
9070,14,5,7,-1,1,216000,0,216000
9071,18,13,10,-1,2,207000,0,207000
9072,9,7,15,-1,2,252000,0,252000
9073,16,14,17,-1,2,195000,15000,210000
9074,18,7,17,-1,2,264000,15000,279000
9075,20,5,15,-1,1,207000,0,207000
9076,15,18,10,12,2,360000,135000,495000
9077,12,8,5,-1,2,312000,45000,357000
9078,10,8,14,-1,2,216000,0,216000
9079,9,16,17,-1,2,228000,15000,243000
9080,6,12,13,-1,2,264000,15000,279000
9081,7,20,10,-1,2,216000,0,216000
9082,19,6,13,-1,1,207000,0,207000
9083,10,15,12,11,2,360000,165000,525000
9084,6,18,19,-1,2,264000,15000,279000
9085,10,20,8,-1,2,252000,0,252000
9086,8,19,15,-1,1,189000,0,189000
9087,16,20,17,-1,2,216000,15000,231000
9088,12,17,11,-1,2,264000,15000,279000
9089,7,6,8,-1,2,300000,45000,345000
9090,20,17,19,12,2,306000,15000,321000
9091,13,6,11,-1,2,276000,30000,306000
9092,13,11,8,-1,2,258000,0,258000
9093,14,9,12,-1,2,231000,0,231000
9094,7,18,11,-1,1,198000,0,198000
9095,12,18,19,-1,2,219000,15000,234000
9096,13,12,9,-1,2,276000,15000,291000
9097,19,5,14,12,2,348000,60000,408000
9098,16,18,15,-1,2,243000,30000,273000
9099,16,20,11,-1,1,207000,0,207000
9100,8,15,10,-1,2,288000,15000,303000
9101,20,9,12,-1,2,216000,0,216000
9102,20,10,5,-1,1,216000,0,216000
9103,18,10,9,-1,2,246000,15000,261000
9104,17,8,15,12,2,348000,75000,423000
9105,16,20,12,-1,1,207000,0,207000
9106,20,11,6,-1,2,252000,15000,267000
9107,6,17,5,-1,2,264000,15000,279000
9108,13,9,15,-1,2,225000,0,225000
9109,10,8,18,-1,2,234000,0,234000
9110,12,13,11,-1,2,234000,30000,264000
9111,10,12,11,13,2,360000,150000,510000
9112,15,5,16,-1,2,264000,15000,279000
9113,16,7,13,-1,2,252000,0,252000
9114,10,12,8,-1,2,258000,0,258000
9115,9,13,18,-1,1,162000,0,162000
9116,8,6,15,-1,2,252000,0,252000
9117,7,16,13,-1,2,243000,0,243000
9118,20,13,19,13,2,312000,15000,327000
9119,8,11,10,-1,2,258000,15000,273000
9120,8,7,12,-1,2,228000,15000,243000
9121,7,9,10,-1,2,249000,15000,264000
9122,18,11,5,-1,1,189000,0,189000
9123,10,18,8,-1,2,225000,0,225000
9124,11,14,6,-1,2,243000,0,243000
9125,15,16,17,12,2,336000,30000,366000
9126,13,20,6,-1,1,216000,0,216000
9127,19,15,16,-1,2,243000,15000,258000
9128,5,13,15,-1,2,264000,15000,279000
9129,6,8,14,-1,2,252000,0,252000
9130,7,15,6,-1,2,237000,15000,252000
9131,6,16,19,-1,2,207000,0,207000
9132,10,17,13,11,2,360000,135000,495000
9133,8,15,10,-1,2,288000,15000,303000
9134,17,15,6,-1,2,234000,0,234000
9135,10,14,15,-1,2,210000,15000,225000
9136,12,8,14,-1,2,243000,0,243000
9137,20,13,9,-1,1,180000,0,180000
9138,5,9,17,-1,1,216000,0,216000
9139,18,12,13,11,2,372000,135000,507000
9140,9,7,20,-1,2,264000,15000,279000
9141,10,20,7,-1,2,252000,0,252000
9142,10,17,20,-1,2,216000,0,216000
9143,12,10,15,-1,2,234000,0,234000
9144,13,15,8,-1,2,243000,0,243000
9145,12,19,15,-1,2,189000,0,189000
9146,19,6,15,13,2,348000,250000,598000
9147,7,15,9,-1,2,252000,0,252000
9148,10,13,19,-1,2,198000,0,198000
9149,18,19,6,-1,2,246000,15000,261000
9150,10,16,9,-1,2,246000,15000,261000
9151,12,19,18,-1,2,210000,15000,225000
9152,6,10,14,-1,2,264000,30000,294000
9153,12,8,11,11,2,312000,90000,402000
9154,20,19,9,-1,2,219000,15000,234000
9155,12,13,6,-1,2,264000,15000,279000
9156,14,15,12,-1,2,213000,15000,228000
9157,5,18,15,-1,2,252000,0,252000
9158,10,8,17,-1,2,225000,0,225000
9159,6,20,11,-1,1,207000,0,207000
9160,12,5,7,12,2,324000,150000,474000
9161,17,15,18,-1,2,186000,15000,201000
9162,8,17,14,-1,2,252000,0,252000
9163,11,19,13,-1,2,225000,0,225000
9164,19,15,18,-1,2,213000,15000,228000
9165,13,15,20,-1,2,234000,0,234000
9166,18,16,5,-1,2,252000,0,252000
9167,7,8,6,13,2,396000,325000,721000
9168,10,20,9,-1,2,264000,15000,279000
9169,18,19,6,-1,2,228000,15000,243000
9170,11,20,7,-1,1,216000,0,216000
9171,17,13,18,-1,2,210000,15000,225000
9172,9,15,8,-1,2,264000,15000,279000
9173,16,11,8,-1,2,243000,0,243000
9174,12,6,9,11,2,372000,265000,637000
9175,14,5,13,-1,2,276000,30000,306000
9176,20,16,11,-1,1,171000,0,171000
9177,15,20,8,-1,1,216000,0,216000
9178,8,10,18,-1,2,252000,0,252000
9179,14,9,11,-1,2,243000,0,243000
9180,9,11,14,-1,2,225000,0,225000
9181,15,18,13,12,2,348000,90000,438000
9182,18,16,13,-1,2,258000,0,258000
9183,10,11,17,-1,2,255000,15000,270000
9184,6,19,20,-1,2,228000,15000,243000
9185,20,17,19,-1,2,195000,15000,210000
9186,6,8,16,-1,2,264000,15000,279000
9187,20,9,8,-1,2,264000,15000,279000
9188,14,9,7,12,2,360000,160000,520000
9189,8,9,18,-1,2,264000,15000,279000
9190,13,6,19,-1,1,216000,0,216000
9191,16,13,14,-1,2,225000,30000,255000
9192,9,6,15,-1,2,252000,0,252000
9193,7,8,20,-1,2,255000,15000,270000
9194,7,15,17,-1,2,225000,0,225000
9195,16,17,6,13,2,336000,45000,381000
9196,11,19,13,-1,2,243000,0,243000
9197,16,17,9,-1,2,255000,15000,270000
9198,15,13,20,-1,2,189000,0,189000
9199,7,5,8,-1,2,312000,90000,402000
9200,7,13,19,-1,1,171000,0,171000
9201,6,20,10,-1,1,216000,0,216000
9202,10,12,7,11,2,372000,180000,552000
9203,13,15,11,-1,2,276000,0,276000
9204,16,20,9,-1,1,189000,0,189000
9205,6,10,8,-1,2,300000,30000,330000
9206,17,12,10,-1,2,180000,0,180000
9207,18,11,6,-1,1,216000,0,216000
9208,17,12,10,-1,2,225000,0,225000
9209,15,10,11,12,2,372000,210000,582000
9210,11,7,11,-1,1,216000,0,216000
9211,14,12,5,-1,2,234000,0,234000
9212,15,10,19,-1,1,144000,0,144000
9213,12,16,17,-1,2,246000,15000,261000
9214,12,15,7,-1,2,264000,15000,279000
9215,18,10,19,-1,2,228000,15000,243000
9216,16,12,6,11,2,360000,150000,510000
9217,14,12,15,-1,2,267000,15000,282000
9218,10,20,19,-1,2,228000,15000,243000
9219,19,8,7,-1,2,264000,15000,279000
9220,13,14,5,-1,2,264000,15000,279000
9221,12,19,9,-1,2,189000,0,189000
9222,7,17,16,-1,2,255000,15000,270000
9223,13,15,6,12,2,348000,120000,468000
9224,20,12,9,-1,2,252000,0,252000
9225,17,11,14,-1,2,225000,0,225000
9226,7,10,12,-1,2,288000,15000,303000
9227,12,17,16,-1,2,192000,15000,207000
9228,5,18,6,-1,2,264000,15000,279000
9229,19,13,12,-1,2,210000,15000,225000
9230,13,12,6,11,2,372000,255000,627000
9231,5,16,17,-1,2,264000,15000,279000
9232,9,5,19,-1,1,216000,0,216000
9233,18,15,20,-1,2,222000,0,222000
9234,10,6,14,-1,2,288000,30000,318000
9235,10,9,18,-1,2,228000,15000,243000
9236,14,16,18,-1,2,204000,0,204000
9237,14,7,15,13,2,348000,150000,498000
9238,10,14,8,-1,1,216000,0,216000
9239,9,7,20,-1,2,243000,0,243000
9240,5,16,14,-1,2,234000,0,234000
9241,13,11,12,-1,2,216000,30000,246000
9242,8,11,8,-1,2,216000,0,216000
9243,15,9,13,-1,2,171000,0,171000
9244,16,15,10,12,2,348000,120000,468000
9245,18,17,8,-1,2,264000,15000,279000
9246,12,7,11,-1,2,276000,30000,306000
9247,12,5,7,-1,2,243000,0,243000
9248,12,6,5,-1,2,237000,15000,252000
9249,10,16,17,-1,2,192000,15000,207000
9250,13,8,18,-1,1,207000,0,207000
9251,20,9,19,11,2,324000,90000,414000
9252,6,16,14,-1,2,252000,0,252000
9253,6,10,5,-1,2,264000,15000,279000
9254,14,11,19,-1,2,171000,0,171000
9255,8,17,10,-1,2,252000,0,252000
9256,16,8,10,-1,2,234000,0,234000
9257,19,15,6,-1,1,198000,0,198000
9258,17,18,5,11,2,348000,75000,423000
9259,10,19,14,-1,2,252000,15000,267000
9260,5,17,13,-1,1,216000,0,216000
9261,7,13,15,-1,2,252000,0,252000
9262,8,9,6,-1,2,276000,15000,291000
9263,15,20,19,-1,2,138000,15000,153000
9264,17,13,9,-1,2,264000,30000,294000
9265,20,18,10,11,2,360000,90000,450000
9266,20,6,5,-1,2,243000,0,243000
9267,7,20,16,-1,1,180000,0,180000
9268,6,12,16,-1,1,216000,0,216000
9269,6,9,15,-1,2,252000,0,252000
9270,8,13,6,-1,2,252000,0,252000
9271,14,5,15,-1,2,237000,15000,252000
9272,19,5,11,12,2,336000,75000,411000
9273,20,6,14,-1,1,216000,0,216000
9274,10,7,19,-1,2,252000,0,252000
9275,7,9,15,-1,2,252000,0,252000
9276,20,9,14,-1,1,180000,0,180000
9277,10,7,12,-1,2,288000,15000,303000
9278,14,16,6,-1,2,234000,0,234000
9279,14,15,16,11,2,336000,30000,366000
9280,15,8,14,-1,2,264000,15000,279000
9281,16,11,15,-1,2,219000,15000,234000
9282,6,15,20,-1,1,216000,0,216000
9283,5,16,11,-1,1,216000,0,216000
9284,11,5,16,-1,1,216000,0,216000
9285,19,16,11,-1,2,225000,0,225000
9286,8,20,18,13,2,336000,90000,426000
9287,19,9,18,-1,2,237000,15000,252000
9288,6,9,18,-1,2,252000,0,252000
9289,5,19,7,-1,2,243000,0,243000
9290,9,5,18,-1,1,198000,0,198000
9291,16,6,7,-1,2,255000,15000,270000
9292,7,9,20,-1,2,216000,0,216000
9293,6,9,14,12,2,360000,160000,520000
9294,17,18,6,-1,2,264000,15000,279000
9295,13,6,15,-1,2,252000,0,252000
9296,20,18,9,-1,2,189000,0,189000
9297,6,18,9,-1,2,252000,0,252000
9298,19,17,12,-1,2,189000,0,189000
9299,14,20,17,-1,2,207000,0,207000
9300,9,14,13,12,2,360000,345000,705000
9301,10,12,9,-1,2,288000,30000,318000
9302,13,19,15,-1,2,171000,0,171000
9303,12,10,19,-1,2,252000,0,252000
9304,13,7,20,-1,1,216000,0,216000
9305,7,17,16,-1,2,255000,15000,270000
9306,15,17,12,-1,2,213000,0,213000
9307,15,12,14,11,2,372000,165000,537000
9308,20,16,18,-1,2,231000,0,231000
9309,10,15,19,-1,1,216000,0,216000
9310,18,11,19,-1,2,264000,15000,279000
9311,12,19,10,-1,2,234000,0,234000
9312,14,9,13,-1,2,246000,15000,261000
9313,11,7,12,-1,2,255000,15000,270000
9314,16,20,13,12,2,312000,45000,357000
9315,15,14,9,-1,2,276000,30000,306000
9316,20,18,19,-1,2,186000,30000,216000
9317,7,5,12,-1,2,252000,15000,267000
9318,16,19,12,-1,2,171000,0,171000
9319,20,14,7,-1,1,216000,0,216000
9320,10,14,7,-1,2,288000,15000,303000
9321,7,5,6,13,2,384000,230000,614000
9322,7,17,20,-1,2,243000,0,243000
9323,11,17,19,-1,2,216000,0,216000
9324,17,7,19,-1,2,243000,0,243000
9325,18,8,10,-1,2,234000,0,234000
9326,6,17,15,-1,2,234000,0,234000
9327,19,5,10,-1,1,207000,0,207000
9328,5,17,12,13,2,348000,135000,483000
9329,15,20,14,-1,2,237000,15000,252000
9330,18,10,7,-1,2,252000,0,252000
9331,6,20,9,-1,2,252000,0,252000
9332,18,14,10,-1,1,189000,0,189000
9333,14,5,19,-1,1,216000,0,216000
9334,12,17,19,-1,2,234000,0,234000
9335,20,15,14,11,2,372000,60000,432000
9336,13,8,7,-1,2,324000,60000,384000
9337,20,11,19,-1,2,201000,15000,216000
9338,13,10,20,-1,2,234000,0,234000
9339,11,7,17,-1,1,216000,0,216000
9340,16,20,6,-1,1,216000,0,216000
9341,11,17,20,-1,2,225000,0,225000
9342,9,10,19,11,2,384000,165000,549000
9343,10,6,18,-1,2,252000,15000,267000
9344,10,19,13,-1,2,243000,0,243000
9345,15,5,19,-1,1,216000,0,216000
9346,5,15,16,-1,2,264000,15000,279000
9347,18,5,8,-1,2,252000,0,252000
9348,7,12,13,-1,2,228000,15000,243000
9349,13,10,9,12,2,360000,135000,495000
9350,7,5,11,-1,2,300000,30000,330000
9351,19,7,19,-1,1,135000,0,135000
9352,5,20,11,-1,1,198000,0,198000
9353,6,13,19,-1,1,207000,0,207000
9354,6,18,14,-1,1,216000,0,216000
9355,19,20,16,-1,2,186000,15000,201000
9356,10,7,8,12,2,408000,505000,913000
9357,19,13,5,-1,1,216000,0,216000
9358,12,7,6,-1,2,255000,15000,270000
9359,17,5,15,-1,2,216000,0,216000
9360,16,12,17,-1,2,192000,15000,207000
9361,6,15,7,-1,2,264000,15000,279000
9362,20,7,17,-1,2,225000,0,225000
9363,7,19,11,12,2,360000,230000,590000
9364,11,18,16,-1,2,252000,0,252000
9365,5,18,9,-1,1,216000,0,216000
9366,14,18,11,-1,2,234000,0,234000
9367,19,14,16,-1,2,207000,0,207000
9368,15,19,13,-1,2,234000,0,234000
9369,18,13,6,-1,1,216000,0,216000
9370,5,20,9,11,2,396000,325000,721000
9371,5,10,11,-1,2,300000,75000,375000
9372,13,8,14,-1,2,228000,15000,243000
9373,15,13,9,-1,2,216000,0,216000
9374,17,20,11,-1,2,207000,0,207000
9375,13,7,17,-1,1,216000,0,216000
9376,16,9,18,-1,2,252000,0,252000
9377,19,16,5,12,2,348000,45000,393000
9378,20,10,7,-1,2,252000,0,252000
9379,9,10,13,-1,2,288000,15000,303000
9380,13,9,11,-1,2,231000,0,231000
9381,12,18,9,-1,2,207000,0,207000
9382,19,6,18,-1,2,237000,15000,252000
9383,10,6,8,-1,2,288000,15000,303000
9384,18,5,14,11,2,324000,15000,339000
9385,7,18,15,-1,2,252000,0,252000
9386,20,12,10,-1,2,216000,0,216000
9387,8,19,10,-1,2,243000,0,243000
9388,10,18,15,-1,2,207000,0,207000
9389,6,16,19,-1,2,252000,0,252000
9390,16,13,9,-1,2,225000,0,225000
9391,9,13,6,12,2,384000,280000,664000
9392,9,17,19,-1,2,252000,0,252000
9393,8,7,19,-1,2,264000,15000,279000
9394,18,17,10,-1,2,210000,15000,225000
9395,17,9,12,-1,2,234000,0,234000
9396,14,5,12,-1,2,252000,0,252000
9397,19,20,14,-1,2,174000,15000,189000
9398,5,19,9,13,2,384000,235000,619000
9399,8,19,14,-1,1,207000,0,207000
9400,13,5,8,-1,2,252000,0,252000
9401,15,13,16,-1,2,195000,15000,210000
9402,20,16,17,-1,2,216000,15000,231000
9403,7,9,12,-1,2,300000,30000,330000
9404,14,5,10,-1,1,207000,0,207000
9405,6,12,19,13,2,348000,90000,438000
9406,9,13,11,-1,2,288000,15000,303000
9407,20,12,8,-1,1,189000,0,189000
9408,14,17,13,-1,2,243000,15000,258000
9409,7,16,13,-1,2,252000,0,252000
9410,16,6,8,-1,2,252000,0,252000
9411,12,16,17,-1,2,183000,15000,198000
9412,8,12,7,11,2,396000,360000,756000
9413,7,12,17,-1,2,252000,15000,267000
9414,6,13,18,-1,1,216000,0,216000
9415,9,6,14,-1,2,252000,0,252000
9416,8,10,19,-1,2,234000,0,234000
9417,20,14,19,-1,2,183000,15000,198000
9418,5,7,15,-1,2,264000,15000,279000
9419,16,19,9,13,2,348000,45000,393000
9420,8,12,6,-1,2,312000,45000,357000
9421,13,12,20,-1,2,192000,15000,207000
9422,19,12,11,-1,2,246000,15000,261000
9423,8,15,17,-1,2,252000,0,252000
9424,19,10,12,-1,2,207000,0,207000
9425,11,9,19,-1,2,234000,0,234000
9426,12,14,7,12,2,300000,30000,330000
9427,18,6,14,-1,1,216000,0,216000
9428,10,15,7,-1,2,252000,0,252000
9429,16,7,15,-1,2,246000,15000,261000
9430,9,15,20,-1,1,171000,0,171000
9431,6,18,12,-1,1,216000,0,216000
9432,8,5,9,-1,2,300000,45000,345000
9433,10,13,12,12,2,300000,75000,375000
9434,10,12,9,-1,2,243000,30000,273000
9435,13,19,11,-1,2,189000,0,189000
9436,11,8,19,-1,2,252000,0,252000
9437,14,9,5,-1,1,216000,0,216000
9438,13,10,17,-1,2,216000,0,216000
9439,9,20,16,-1,1,207000,0,207000
9440,20,15,11,12,2,360000,120000,480000
9441,14,6,7,-1,2,252000,0,252000
9442,11,13,6,-1,2,234000,0,234000
9443,14,18,12,-1,2,171000,0,171000
9444,5,16,6,-1,2,264000,15000,279000
9445,14,7,8,-1,2,255000,15000,270000
9446,20,19,17,-1,2,159000,15000,174000
9447,13,16,8,12,2,360000,345000,705000
9448,20,14,18,-1,2,198000,0,198000
9449,20,16,17,-1,2,243000,15000,258000
9450,18,8,7,-1,2,264000,15000,279000
9451,12,15,5,-1,2,252000,0,252000
9452,16,12,19,-1,2,198000,0,198000
9453,18,9,5,-1,2,252000,15000,267000
9454,19,14,18,11,2,348000,45000,393000
9455,11,13,17,-1,1,198000,0,198000
9456,5,8,10,-1,2,288000,15000,303000
9457,12,7,11,-1,2,219000,15000,234000
9458,18,8,14,-1,1,180000,0,180000
9459,10,9,20,-1,2,255000,15000,270000
9460,13,16,7,-1,2,243000,0,243000
9461,20,19,8,11,2,324000,75000,399000
9462,5,10,16,-1,1,216000,0,216000
9463,20,8,11,-1,2,234000,0,234000
9464,14,8,6,-1,2,252000,0,252000
9465,16,17,11,-1,2,192000,15000,207000
9466,12,7,5,-1,2,288000,15000,303000
9467,8,16,10,-1,2,198000,0,198000
9468,19,8,14,12,2,348000,60000,408000
9469,14,6,19,-1,1,216000,0,216000
9470,12,7,17,-1,2,252000,15000,267000
9471,12,10,9,-1,2,270000,30000,300000
9472,20,15,14,-1,2,174000,15000,189000
9473,5,11,7,-1,2,312000,45000,357000
9474,17,13,20,-1,2,162000,0,162000
9475,14,15,16,11,2,372000,120000,492000
9476,15,11,20,-1,1,207000,0,207000
9477,10,18,16,-1,2,225000,0,225000
9478,6,19,14,-1,1,216000,0,216000
9479,10,5,8,-1,2,288000,15000,303000
9480,12,16,5,-1,1,189000,0,189000
9481,11,14,7,-1,2,234000,0,234000
9482,5,9,16,12,2,348000,285000,633000
9483,17,7,12,-1,2,252000,15000,267000
9484,14,11,7,-1,2,264000,15000,279000
9485,10,18,17,-1,2,219000,15000,234000
9486,5,19,16,-1,2,243000,0,243000
9487,6,16,14,-1,2,252000,0,252000
9488,15,12,17,-1,2,195000,0,195000
9489,6,7,9,11,2,396000,325000,721000
9490,5,8,11,-1,2,312000,45000,357000
9491,10,13,19,-1,2,189000,0,189000
9492,15,14,10,-1,2,246000,15000,261000
9493,10,13,8,-1,2,243000,0,243000
9494,20,16,19,-1,2,177000,15000,192000
9495,13,18,14,-1,2,255000,15000,270000
9496,7,11,20,12,2,360000,315000,675000
9497,19,12,13,-1,2,219000,15000,234000
9498,5,9,16,-1,2,252000,15000,267000
9499,15,13,20,-1,2,189000,0,189000
9500,10,14,15,-1,2,264000,15000,279000
9501,18,13,16,-1,2,222000,0,222000
9502,20,19,10,-1,2,246000,15000,261000
9503,14,10,6,11,2,372000,345000,717000
9504,15,11,16,-1,2,276000,30000,306000
9505,13,6,9,-1,2,288000,15000,303000
9506,10,18,5,-1,1,198000,0,198000
9507,14,16,6,-1,2,243000,0,243000
9508,19,11,5,-1,1,198000,0,198000
9509,14,5,7,-1,2,252000,0,252000
9510,14,17,11,11,2,279000,0,279000
9511,7,9,20,-1,2,234000,0,234000
9512,18,8,12,-1,1,180000,0,180000
9513,20,11,19,-1,2,237000,15000,252000
9514,18,7,9,-1,2,252000,0,252000
9515,6,15,7,-1,2,255000,15000,270000
9516,9,18,7,-1,2,216000,0,216000
9517,18,14,12,13,2,336000,120000,456000
9518,6,7,13,-1,2,312000,45000,357000
9519,17,8,10,-1,2,216000,0,216000
9520,5,7,6,-1,2,288000,30000,318000
9521,18,11,8,-1,2,180000,0,180000
9522,10,15,5,-1,1,216000,0,216000
9523,7,10,20,-1,2,243000,0,243000
9524,12,10,6,11,2,360000,180000,540000
9525,11,16,7,-1,2,252000,15000,267000
9526,5,14,11,-1,2,252000,0,252000
9527,15,17,9,-1,2,216000,0,216000
9528,20,5,17,-1,2,225000,0,225000
9529,6,18,17,-1,2,246000,15000,261000
9530,14,6,13,-1,2,264000,15000,279000
9531,20,14,10,13,2,336000,90000,426000
9532,13,20,9,-1,1,216000,0,216000
9533,5,13,17,-1,2,252000,15000,267000
9534,13,8,6,-1,2,252000,0,252000
9535,14,9,12,-1,2,231000,0,231000
9536,9,12,16,-1,2,216000,0,216000
9537,12,6,11,-1,2,264000,15000,279000
9538,17,10,11,12,2,348000,135000,483000
9539,7,20,14,-1,1,216000,0,216000
9540,12,16,18,-1,2,234000,0,234000
9541,15,7,9,-1,2,252000,0,252000
9542,10,6,17,-1,1,216000,0,216000
9543,9,5,16,-1,1,216000,0,216000
9544,12,12,6,-1,1,198000,0,198000
9545,18,20,9,11,2,303000,45000,348000
9546,11,13,19,-1,2,234000,0,234000
9547,8,7,8,-1,2,237000,15000,252000
9548,18,17,19,-1,2,135000,30000,165000
9549,5,11,18,-1,2,252000,15000,267000
9550,20,17,5,-1,2,252000,0,252000
9551,13,7,8,-1,2,264000,15000,279000
9552,20,5,10,13,2,336000,215000,551000
9553,6,20,8,-1,2,264000,15000,279000
9554,10,9,6,-1,2,288000,30000,318000
9555,18,12,15,-1,2,162000,0,162000
9556,18,7,11,-1,1,216000,0,216000
9557,14,20,10,-1,1,216000,0,216000
9558,5,16,13,-1,2,264000,15000,279000
9559,6,18,8,13,2,372000,155000,527000
9560,15,18,19,-1,2,231000,15000,246000
9561,20,7,10,-1,2,252000,0,252000
9562,6,8,18,-1,2,252000,0,252000
9563,15,17,11,-1,2,207000,0,207000
9564,19,10,20,-1,2,237000,15000,252000
9565,9,12,8,-1,2,288000,15000,303000
9566,19,13,12,11,2,312000,60000,372000
9567,17,6,10,-1,2,252000,15000,267000
9568,16,5,11,-1,1,216000,0,216000
9569,19,8,17,-1,2,243000,0,243000
9570,13,12,9,-1,2,249000,15000,264000
9571,14,8,20,-1,1,189000,0,189000
9572,19,9,8,-1,2,264000,15000,279000
9573,9,20,16,12,2,348000,75000,423000
9574,12,16,11,-1,2,264000,15000,279000
9575,12,17,8,-1,1,216000,0,216000
9576,17,11,7,-1,1,216000,0,216000
9577,17,20,11,-1,2,225000,0,225000
9578,17,12,9,-1,2,252000,0,252000
9579,7,11,6,-1,2,300000,30000,330000
9580,15,5,20,11,2,300000,15000,315000
9581,13,19,15,-1,2,225000,0,225000
9582,20,10,9,-1,2,264000,15000,279000
9583,17,19,13,-1,2,198000,0,198000
9584,15,14,19,-1,2,228000,15000,243000
9585,13,7,5,-1,2,300000,30000,330000
9586,16,18,14,-1,2,186000,0,186000
9587,13,10,5,12,2,360000,400000,760000
9588,6,5,15,-1,2,252000,0,252000
9589,13,14,5,-1,2,246000,15000,261000
9590,8,20,12,-1,1,162000,0,162000
9591,15,7,9,-1,2,252000,0,252000
9592,12,20,15,-1,2,189000,0,189000
9593,14,11,13,-1,2,267000,15000,282000
9594,12,9,13,11,2,360000,165000,525000
9595,9,11,13,-1,2,288000,15000,303000
9596,13,8,9,-1,2,228000,15000,243000
9597,14,18,14,-1,1,135000,0,135000
9598,16,6,11,-1,1,216000,0,216000
9599,13,7,14,-1,2,255000,15000,270000
9600,13,12,20,-1,2,192000,15000,207000
9601,6,13,12,13,2,324000,215000,539000
9602,18,17,20,-1,2,216000,30000,246000
9603,13,10,7,-1,2,312000,45000,357000
9604,13,8,16,-1,2,225000,0,225000
9605,12,9,20,-1,2,225000,0,225000
9606,9,17,12,-1,2,234000,0,234000
9607,18,12,17,-1,2,219000,15000,234000
9608,8,20,7,11,2,396000,285000,681000
9609,9,8,13,-1,2,312000,45000,357000
9610,18,16,15,-1,2,189000,30000,219000
9611,17,16,7,-1,2,264000,15000,279000
9612,7,8,12,-1,2,264000,15000,279000
9613,20,16,8,-1,1,180000,0,180000
9614,20,15,19,-1,2,201000,15000,216000
9615,20,19,6,13,2,348000,255000,603000
9616,9,11,16,-1,2,252000,0,252000
9617,8,17,13,-1,1,198000,0,198000
9618,18,5,6,-1,2,264000,15000,279000
9619,19,18,6,-1,2,219000,15000,234000
9620,17,20,9,-1,2,234000,0,234000
9621,6,16,7,-1,2,264000,15000,279000
9622,14,10,8,12,2,348000,105000,453000
9623,12,9,11,-1,2,276000,15000,291000
9624,12,6,14,-1,2,234000,0,234000
9625,17,20,13,-1,2,162000,0,162000
9626,13,12,11,-1,2,288000,30000,318000
9627,19,8,10,-1,2,234000,0,234000
9628,5,6,10,-1,2,264000,15000,279000
9629,17,16,10,13,2,324000,90000,414000
9630,9,13,20,-1,1,216000,0,216000
9631,8,11,16,-1,2,252000,0,252000
9632,18,19,13,-1,2,219000,15000,234000
9633,18,11,10,-1,2,264000,15000,279000
9634,12,16,8,-1,1,207000,0,207000
9635,17,9,19,-1,2,243000,0,243000
9636,15,19,9,11,2,360000,90000,450000
9637,10,14,5,-1,2,264000,30000,294000
9638,11,10,17,-1,2,228000,15000,243000
9639,12,9,17,-1,2,234000,0,234000
9640,6,10,12,-1,2,264000,15000,279000
9641,13,9,19,-1,1,162000,0,162000
9642,19,8,9,-1,2,264000,15000,279000
9643,9,8,13,12,2,372000,150000,522000
9644,10,19,18,-1,2,264000,15000,279000
9645,11,18,12,-1,2,228000,15000,243000
9646,13,11,19,-1,2,225000,0,225000
9647,13,9,12,-1,2,267000,15000,282000
9648,5,16,12,-1,1,216000,0,216000
9649,11,10,17,-1,2,219000,15000,234000
9650,17,6,9,12,2,384000,195000,579000
9651,18,13,17,-1,2,237000,15000,252000
9652,14,12,6,-1,2,264000,15000,279000
9653,11,20,12,-1,2,219000,15000,234000
9654,14,6,9,-1,2,252000,0,252000
9655,19,20,14,-1,2,192000,15000,207000
9656,15,10,17,-1,2,252000,0,252000
9657,19,11,9,13,2,372000,245000,617000
9658,12,20,20,-1,1,207000,0,207000
9659,15,14,13,-1,2,207000,30000,237000
9660,9,20,7,-1,2,252000,0,252000
9661,18,16,6,-1,2,225000,0,225000
9662,11,15,8,-1,2,225000,0,225000
9663,17,15,8,-1,2,234000,0,234000
9664,9,7,9,12,2,312000,125000,437000
9665,7,8,17,-1,2,246000,15000,261000
9666,17,20,13,-1,2,171000,0,171000
9667,5,6,14,-1,2,312000,45000,357000
9668,20,19,18,-1,2,150000,30000,180000
9669,14,15,7,-1,2,264000,15000,279000
9670,9,14,20,-1,1,162000,0,162000
9671,5,17,9,12,2,360000,380000,740000
9672,20,10,17,-1,2,225000,0,225000
9673,16,12,13,-1,2,243000,15000,258000
9674,17,18,8,-1,2,246000,15000,261000
9675,9,10,13,-1,2,261000,15000,276000
9676,13,18,9,-1,1,171000,0,171000
9677,11,8,10,-1,2,288000,30000,318000
9678,20,11,5,12,2,324000,60000,384000
9679,20,11,12,-1,2,264000,15000,279000
9680,5,17,6,-1,2,264000,15000,279000
9681,14,8,18,-1,1,189000,0,189000
9682,11,6,12,-1,2,276000,30000,306000
9683,11,6,19,-1,1,198000,0,198000
9684,13,12,7,-1,2,255000,15000,270000
9685,16,14,20,12,2,312000,30000,342000
9686,10,20,12,-1,2,252000,0,252000
9687,10,5,20,-1,1,216000,0,216000
9688,5,11,14,-1,2,264000,15000,279000
9689,20,17,9,-1,2,225000,0,225000
9690,12,17,19,-1,2,207000,0,207000
9691,10,6,19,-1,1,216000,0,216000
9692,10,20,6,12,2,360000,325000,685000
9693,19,5,13,-1,1,216000,0,216000
9694,12,17,10,-1,2,207000,0,207000
9695,17,10,20,-1,2,225000,0,225000
9696,20,9,6,-1,2,252000,0,252000
9697,9,19,18,-1,2,228000,15000,243000
9698,7,6,20,-1,2,264000,15000,279000
9699,12,10,18,11,2,348000,105000,453000
9700,5,8,11,-1,2,312000,45000,357000
9701,11,8,10,-1,2,231000,15000,246000
9702,9,10,12,-1,2,234000,30000,264000
9703,9,12,15,-1,2,207000,0,207000
9704,7,18,5,-1,2,252000,0,252000
9705,13,16,9,-1,2,207000,0,207000
9706,8,15,7,12,2,384000,200000,584000
9707,9,12,14,-1,2,288000,15000,303000
9708,5,12,13,-1,2,264000,15000,279000
9709,8,16,13,-1,2,198000,0,198000
9710,18,13,12,-1,2,210000,15000,225000
9711,11,12,15,-1,2,270000,15000,285000
9712,20,9,10,-1,2,237000,15000,252000
9713,20,16,14,12,2,348000,45000,393000
9714,19,17,13,-1,2,234000,0,234000
9715,14,11,8,-1,2,288000,15000,303000
9716,14,15,8,-1,2,237000,15000,252000
9717,16,18,9,-1,2,216000,0,216000
9718,10,9,16,-1,2,237000,15000,252000
9719,8,19,10,-1,2,234000,0,234000
9720,13,20,6,11,2,336000,45000,381000
9721,11,7,16,-1,2,264000,30000,294000
9722,11,10,16,-1,2,237000,15000,252000
9723,18,8,6,-1,2,252000,0,252000
9724,17,16,15,-1,2,189000,30000,219000
9725,17,8,13,-1,2,252000,15000,267000
9726,8,10,12,-1,2,267000,0,267000
9727,11,8,7,12,2,360000,90000,450000
9728,11,19,12,-1,2,237000,15000,252000
9729,6,18,5,-1,2,264000,15000,279000
9730,18,17,10,-1,2,219000,15000,234000
9731,15,6,7,-1,2,264000,15000,279000
9732,11,16,13,-1,2,189000,0,189000
9733,18,8,7,-1,2,264000,15000,279000
9734,6,18,20,12,2,312000,30000,342000
9735,5,13,12,-1,2,264000,15000,279000
9736,9,13,12,-1,2,213000,15000,228000
9737,6,7,8,-1,2,279000,30000,309000
9738,9,12,5,-1,2,216000,0,216000
9739,16,15,8,-1,2,219000,15000,234000
9740,15,9,12,-1,2,216000,0,216000
9741,16,5,11,11,2,312000,30000,342000
9742,11,10,19,-1,2,237000,15000,252000
9743,15,12,10,-1,2,225000,0,225000
9744,8,11,17,-1,2,243000,0,243000
9745,19,12,20,-1,2,210000,15000,225000
9746,6,10,9,-1,2,300000,45000,345000
9747,5,19,16,-1,2,207000,0,207000
9748,14,5,7,11,2,372000,185000,557000
9749,19,5,18,-1,2,255000,15000,270000
9750,19,8,16,-1,2,243000,0,243000
9751,14,10,5,-1,1,216000,0,216000
9752,10,8,19,-1,2,234000,0,234000
9753,19,15,7,-1,1,198000,0,198000
9754,17,20,11,-1,2,216000,0,216000
9755,6,8,12,11,2,396000,320000,716000
9756,10,6,17,-1,2,252000,15000,267000
9757,14,16,15,-1,2,225000,30000,255000
9758,19,18,9,-1,2,255000,15000,270000
9759,8,7,18,-1,2,264000,15000,279000
9760,14,17,19,-1,2,186000,0,186000
9761,18,14,5,-1,1,216000,0,216000
9762,6,15,9,12,2,396000,290000,686000
9763,9,13,16,-1,2,276000,30000,306000
9764,15,16,6,-1,2,264000,15000,279000
9765,19,12,6,-1,1,207000,0,207000
9766,9,7,13,-1,2,243000,0,243000
9767,8,14,11,-1,2,216000,0,216000
9768,15,5,9,-1,1,216000,0,216000
9769,15,11,12,12,2,312000,75000,387000
9770,7,9,19,-1,2,252000,0,252000
9771,20,18,19,-1,2,150000,30000,180000
9772,8,18,13,-1,1,216000,0,216000
9773,7,19,13,-1,1,207000,0,207000
9774,20,13,11,-1,2,216000,0,216000
9775,20,9,6,-1,2,252000,0,252000
9776,6,14,8,12,2,372000,200000,572000
9777,7,9,19,-1,2,252000,0,252000
9778,8,19,10,-1,2,234000,0,234000
9779,14,19,17,-1,2,195000,0,195000
9780,18,5,14,-1,1,216000,0,216000
9781,8,14,12,-1,2,264000,15000,279000
9782,18,12,13,-1,2,210000,15000,225000
9783,20,16,7,13,2,348000,60000,408000
9784,7,14,8,-1,2,252000,0,252000
9785,5,13,8,-1,2,243000,0,243000
9786,19,5,7,-1,2,225000,0,225000
9787,15,20,11,-1,1,144000,0,144000
9788,14,8,11,-1,2,300000,30000,330000
9789,5,9,13,-1,1,216000,0,216000
9790,5,18,11,13,2,336000,105000,441000
9791,7,8,13,-1,2,312000,45000,357000
9792,19,11,15,-1,1,153000,0,153000
9793,9,11,13,-1,2,288000,15000,303000
9794,8,14,10,-1,2,225000,0,225000
9795,6,20,10,-1,1,207000,0,207000
9796,12,5,7,-1,2,252000,0,252000
9797,16,6,7,12,2,360000,45000,405000
9798,17,15,13,-1,2,231000,0,231000
9799,11,7,8,-1,2,300000,30000,330000
9800,13,7,9,-1,2,207000,0,207000
9801,7,18,13,-1,1,189000,0,189000
9802,8,20,16,-1,1,207000,0,207000
9803,17,19,12,-1,2,216000,0,216000
9804,11,13,12,12,2,324000,105000,429000
9805,16,15,12,-1,2,249000,15000,264000
9806,10,5,6,-1,2,312000,45000,357000
9807,12,16,13,-1,2,189000,15000,204000
9808,8,17,11,-1,2,243000,0,243000
9809,15,9,14,-1,2,237000,15000,252000
9810,18,10,12,-1,2,216000,0,216000
9811,15,17,9,11,2,360000,120000,480000
9812,14,7,19,-1,1,216000,0,216000
9813,7,16,6,-1,2,276000,30000,306000
9814,18,9,20,-1,2,225000,0,225000
9815,6,5,11,-1,2,300000,30000,330000
9816,16,9,10,-1,2,192000,15000,207000
9817,8,14,10,-1,2,234000,0,234000
9818,11,18,12,13,2,348000,135000,483000
9819,15,18,7,-1,2,252000,0,252000
9820,6,15,8,-1,2,252000,0,252000
9821,6,14,11,-1,2,252000,0,252000
9822,11,5,7,-1,2,243000,0,243000
9823,6,19,18,-1,2,192000,15000,207000
9824,5,13,19,-1,1,216000,0,216000
9825,11,8,12,12,2,324000,75000,399000
9826,19,18,17,-1,2,198000,30000,228000
9827,13,6,17,-1,2,264000,30000,294000
9828,6,12,17,-1,1,216000,0,216000
9829,19,20,14,-1,2,210000,15000,225000
9830,18,7,8,-1,2,264000,15000,279000
9831,8,14,6,-1,2,252000,0,252000
9832,20,18,14,11,2,336000,15000,351000
9833,11,6,9,-1,2,312000,75000,387000
9834,7,15,17,-1,2,225000,0,225000
9835,20,11,12,-1,2,201000,15000,216000
9836,11,18,15,-1,2,225000,0,225000
9837,13,9,11,-1,2,276000,0,276000
9838,12,16,8,-1,1,180000,0,180000
9839,17,7,18,13,2,348000,120000,468000
9840,12,10,8,-1,2,252000,0,252000
9841,17,18,12,-1,2,174000,15000,189000
9842,12,13,6,-1,2,276000,30000,306000
9843,10,12,17,-1,2,207000,0,207000
9844,18,12,17,-1,2,219000,15000,234000
9845,12,11,13,-1,2,270000,30000,300000
9846,19,9,8,12,2,372000,105000,477000
9847,13,10,7,-1,2,300000,30000,330000
9848,20,19,8,-1,2,201000,15000,216000
9849,15,6,10,-1,2,252000,15000,267000
9850,11,8,12,-1,2,249000,15000,264000
9851,5,16,15,-1,2,237000,15000,252000
9852,5,7,6,-1,2,279000,30000,309000
9853,5,20,13,11,2,288000,15000,303000
9854,6,19,11,-1,1,216000,0,216000
9855,7,5,12,-1,2,300000,30000,330000
9856,11,16,7,-1,1,180000,0,180000
9857,16,18,11,-1,2,216000,0,216000
9858,14,6,9,-1,2,252000,0,252000
9859,19,11,17,-1,2,207000,0,207000
9860,6,9,12,11,2,384000,345000,729000
9861,18,16,19,-1,2,231000,15000,246000
9862,11,19,17,-1,2,252000,0,252000
9863,15,6,18,-1,2,252000,0,252000
9864,7,10,15,-1,2,243000,0,243000
9865,20,18,8,-1,2,207000,0,207000
9866,5,9,14,-1,2,252000,15000,267000
9867,12,15,5,11,2,348000,120000,468000
9868,12,11,17,-1,2,246000,15000,261000
9869,12,11,6,-1,2,276000,30000,306000
9870,11,5,10,-1,2,255000,15000,270000
9871,20,10,9,-1,2,201000,15000,216000
9872,13,5,8,-1,2,252000,0,252000
9873,19,16,10,-1,2,198000,0,198000
9874,9,7,19,12,2,384000,205000,589000
9875,9,12,15,-1,2,288000,15000,303000
9876,13,5,12,-1,2,264000,15000,279000
9877,10,9,14,-1,2,201000,15000,216000
9878,13,6,15,-1,2,252000,0,252000
9879,9,13,8,-1,2,219000,15000,234000
9880,5,7,8,-1,2,276000,15000,291000
9881,9,19,8,11,2,312000,60000,372000
9882,13,6,18,-1,1,216000,0,216000
9883,19,5,8,-1,2,252000,0,252000
9884,10,16,11,-1,2,237000,15000,252000
9885,20,7,14,-1,1,216000,0,216000
9886,7,15,6,-1,2,264000,15000,279000
9887,15,6,16,-1,2,237000,15000,252000
9888,18,15,11,12,2,348000,105000,453000
9889,20,16,10,-1,1,216000,0,216000
9890,8,14,15,-1,2,264000,15000,279000
9891,8,18,13,-1,1,207000,0,207000
9892,10,6,18,-1,1,216000,0,216000
9893,12,11,19,-1,2,237000,15000,252000
9894,10,18,15,-1,2,234000,0,234000
9895,9,8,5,13,2,396000,315000,711000
9896,10,19,16,-1,2,252000,0,252000
9897,12,13,18,-1,2,228000,15000,243000
9898,8,15,17,-1,2,252000,0,252000
9899,13,6,8,-1,2,252000,0,252000
9900,12,14,11,-1,2,216000,30000,246000
9901,18,17,8,-1,2,237000,15000,252000
9902,9,8,18,11,2,372000,105000,477000
9903,10,7,11,-1,2,300000,45000,345000
9904,14,17,15,-1,2,198000,30000,228000
9905,10,5,7,-1,2,300000,30000,330000
9906,18,10,8,-1,2,198000,0,198000
9907,11,16,6,-1,1,207000,0,207000
9908,19,16,14,-1,2,180000,0,180000
9909,12,11,5,13,2,360000,455000,815000
9910,11,5,9,-1,2,276000,30000,306000
9911,11,8,16,-1,2,207000,0,207000
9912,17,16,13,-1,2,213000,15000,228000
9913,17,18,6,-1,2,264000,15000,279000
9914,5,16,6,-1,2,264000,15000,279000
9915,20,8,18,-1,2,189000,0,189000
9916,17,9,20,11,2,360000,90000,450000
9917,18,15,19,-1,2,240000,15000,255000
9918,13,19,16,-1,2,234000,0,234000
9919,19,5,15,-1,1,216000,0,216000
9920,17,6,13,-1,2,252000,15000,267000
9921,18,15,19,-1,2,213000,15000,228000
9922,13,18,19,-1,2,246000,15000,261000
9923,15,13,6,12,2,360000,280000,640000
9924,20,12,10,-1,1,216000,0,216000
9925,16,10,20,-1,1,180000,0,180000
9926,9,15,13,-1,2,264000,15000,279000
9927,8,17,10,-1,2,234000,0,234000
9928,6,14,12,-1,2,243000,0,243000
9929,17,18,15,-1,2,168000,15000,183000
9930,5,19,12,11,2,372000,300000,672000
9931,14,17,5,-1,2,243000,0,243000
9932,10,20,18,-1,2,198000,0,198000
9933,17,10,6,-1,1,216000,0,216000
9934,15,13,6,-1,2,252000,0,252000
9935,19,5,16,-1,2,216000,0,216000
9936,8,13,18,-1,1,198000,0,198000
9937,20,8,13,12,2,360000,90000,450000
9938,9,12,7,-1,2,312000,45000,357000
9939,16,12,17,-1,2,192000,15000,207000
9940,18,7,17,-1,2,264000,15000,279000
9941,11,6,15,-1,1,216000,0,216000
9942,11,14,20,-1,2,207000,0,207000
9943,7,6,13,-1,2,300000,30000,330000
9944,5,14,12,11,2,336000,90000,426000
9945,11,8,17,-1,2,252000,0,252000
9946,11,15,16,-1,2,228000,15000,243000
9947,10,7,11,-1,2,288000,30000,318000
9948,11,10,12,-1,2,225000,30000,255000
9949,9,5,16,-1,1,216000,0,216000
9950,10,14,9,-1,2,228000,15000,243000
9951,19,10,20,11,2,336000,75000,411000
9952,18,6,20,-1,2,216000,0,216000
9953,13,9,5,-1,2,252000,15000,267000
9954,13,16,10,-1,2,198000,0,198000
9955,17,14,18,-1,2,222000,15000,237000
9956,5,7,20,-1,2,264000,15000,279000
9957,9,5,6,-1,2,300000,30000,330000
9958,9,12,11,12,2,291000,45000,336000
9959,5,13,8,-1,2,225000,0,225000
9960,14,20,16,-1,2,153000,0,153000
9961,6,20,9,-1,2,264000,15000,279000
9962,19,14,7,-1,1,216000,0,216000
9963,10,5,16,-1,1,216000,0,216000
9964,10,9,17,-1,2,255000,15000,270000
9965,20,8,6,13,2,348000,140000,488000
9966,14,12,7,-1,2,276000,30000,306000
9967,14,16,20,-1,2,180000,0,180000
9968,18,13,16,-1,2,258000,0,258000
9969,9,18,14,-1,1,216000,0,216000
9970,12,8,19,-1,1,216000,0,216000
9971,13,8,12,-1,2,276000,30000,306000
9972,11,5,20,12,2,348000,90000,438000
9973,5,19,15,-1,1,216000,0,216000
9974,10,11,9,-1,2,300000,45000,345000
9975,6,16,18,-1,2,225000,0,225000
9976,17,16,9,-1,2,228000,15000,243000
9977,14,15,5,-1,2,264000,15000,279000
9978,15,9,7,-1,2,216000,0,216000
9979,13,7,19,11,2,336000,45000,381000
9980,8,15,10,-1,2,252000,0,252000
9981,7,15,17,-1,2,252000,0,252000
9982,13,14,7,-1,2,237000,15000,252000
9983,5,15,12,-1,2,243000,0,243000
9984,17,7,10,-1,2,216000,0,216000
9985,13,5,15,-1,2,252000,0,252000
9986,19,6,8,11,2,300000,0,300000
9987,9,16,14,-1,2,264000,15000,279000
9988,9,18,6,-1,2,252000,0,252000
9989,6,14,8,-1,2,243000,0,243000
9990,7,20,15,-1,1,180000,0,180000
9991,19,7,18,-1,2,237000,15000,252000
9992,8,5,19,-1,2,252000,0,252000
9993,9,11,12,11,2,300000,75000,375000
9994,20,14,11,-1,2,207000,0,207000
9995,14,6,19,-1,1,216000,0,216000
9996,5,10,16,-1,2,252000,15000,267000
9997,11,5,12,-1,2,264000,15000,279000
9998,12,5,10,-1,2,234000,0,234000
9999,19,20,11,-1,2,183000,15000,198000
